//MAP CONVERTED BY dmm2tgm.py THIS HEADER COMMENT PREVENTS RECONVERSION, DO NOT REMOVE
"a" = (
/turf/open/space/basic,
/area/space)
"c" = (
/obj/structure/table,
/turf/open/floor/plating/is12/surface,
/area/violence)
"e" = (
/obj/structure/closet{
	anchored = 1
	},
/turf/open/floor/plating/is12/trenchcenter,
/area/violence)
"f" = (
/obj/effect/baseturf_helper/asteroid,
/turf/closed/indestructible/necropolis,
/area/violence)
"g" = (
/obj/machinery/door/poddoor,
/turf/open/indestructible/boss/air,
/area/violence)
"h" = (
/obj/structure/bed/maint,
/turf/open/floor/plating/is12/wood,
/area/violence)
"n" = (
/turf/open/floor/plating/is12/wood,
/area/violence)
"s" = (
/turf/closed/indestructible/necropolis,
/area/violence)
"w" = (
/turf/closed/indestructible/riveted/boss,
/area/violence)
"y" = (
/obj/effect/landmark/start/combatant/blue,
/turf/open/floor/plating/is12/wood,
/area/violence)
"A" = (
/obj/machinery/door/poddoor,
/turf/open/floor/plating/is12/rock,
/area/violence)
"E" = (
/turf/closed/indestructible/riveted/dirtystone,
/area/violence)
"G" = (
/obj/effect/landmark/start/combatant/red,
/turf/open/floor/plating/is12/wood,
/area/violence)
"L" = (
/obj/structure/table,
/turf/open/floor/plating/is12/trenchcenter,
/area/violence)
"M" = (
/turf/open/floor/plating/is12/surface,
/area/violence)
"V" = (
/obj/structure/table,
/turf/open/floor/plating/is12/wood,
/area/violence)
"W" = (
/turf/open/floor/plating/is12/trenchcenter,
/area/violence)
"Z" = (
/turf/open/floor/plating/is12/rock,
/area/violence)

(1,1,1) = {"
a
a
a
a
a
a
a
a
a
a
a
a
a
a
a
a
a
a
a
a
a
a
a
a
a
a
a
a
a
a
a
a
a
a
a
a
a
a
a
a
a
a
a
a
a
a
a
a
a
a
"}
(2,1,1) = {"
a
a
a
a
a
a
a
a
a
a
a
a
a
a
a
a
a
a
a
a
a
a
a
a
a
a
a
a
a
a
a
a
a
a
a
a
a
a
a
a
a
a
a
a
a
a
a
a
a
a
"}
(3,1,1) = {"
a
a
a
a
a
a
a
a
a
a
a
a
a
a
a
a
a
a
a
a
a
a
a
a
a
a
a
a
a
a
a
a
a
a
a
a
a
a
a
a
a
a
a
a
a
a
a
a
a
a
"}
(4,1,1) = {"
a
a
a
a
a
a
a
a
a
a
s
s
s
s
s
s
s
s
s
s
s
s
s
s
s
s
s
s
s
s
s
s
s
s
s
s
s
s
s
s
s
s
s
s
s
f
a
a
a
a
"}
(5,1,1) = {"
a
a
a
a
a
a
a
a
a
a
s
M
M
M
M
M
M
M
M
M
M
M
M
M
M
M
M
M
M
M
M
M
M
M
M
M
M
M
M
M
M
M
M
M
M
s
a
a
a
a
"}
(6,1,1) = {"
a
a
a
a
a
a
a
a
a
a
s
M
M
M
c
M
M
M
M
M
M
M
M
M
M
M
M
M
M
M
M
M
M
M
M
M
M
M
M
M
M
c
M
M
M
s
a
a
a
a
"}
(7,1,1) = {"
a
a
a
a
a
a
a
a
a
a
s
M
M
M
c
M
M
M
M
M
M
M
M
M
M
c
c
c
c
c
c
M
M
M
M
M
M
M
M
M
M
c
M
M
M
s
a
a
a
a
"}
(8,1,1) = {"
a
a
a
a
a
a
a
a
a
a
s
M
M
M
c
M
M
M
M
M
M
M
M
M
M
M
M
M
M
M
M
M
M
M
M
M
M
M
M
M
M
c
M
M
M
s
a
a
a
a
"}
(9,1,1) = {"
a
a
a
a
a
a
a
a
a
a
s
M
M
M
M
M
M
M
M
M
M
M
M
M
M
M
M
M
M
M
M
M
M
M
M
M
M
M
M
M
M
M
M
M
M
s
a
a
a
a
"}
(10,1,1) = {"
a
a
a
a
a
a
a
a
a
a
s
s
M
M
s
s
s
s
s
s
s
s
s
s
s
s
s
M
M
s
s
s
s
s
s
s
s
s
s
s
s
s
M
M
s
s
a
a
a
a
"}
(11,1,1) = {"
a
a
a
a
a
a
a
a
a
w
w
w
g
g
w
w
w
w
w
w
w
w
w
w
w
w
w
A
A
w
w
w
w
w
w
w
w
w
w
w
w
w
g
g
w
w
w
a
a
a
"}
(12,1,1) = {"
a
a
a
a
a
a
a
a
a
w
V
n
n
n
n
w
Z
Z
Z
Z
Z
Z
Z
Z
Z
Z
Z
Z
Z
Z
Z
Z
Z
Z
Z
Z
Z
Z
Z
Z
w
n
n
n
n
V
w
a
a
a
"}
(13,1,1) = {"
a
a
a
a
a
a
a
a
a
w
h
G
n
n
n
w
Z
Z
Z
Z
Z
Z
Z
Z
Z
Z
Z
Z
Z
Z
Z
Z
Z
Z
Z
Z
Z
Z
Z
Z
w
n
n
n
y
h
w
a
a
a
"}
(14,1,1) = {"
a
a
a
a
a
a
a
a
a
w
V
n
n
n
n
w
Z
Z
E
E
E
E
E
E
E
E
E
L
L
E
E
E
E
E
E
E
E
E
Z
Z
w
n
n
n
n
V
w
a
a
a
"}
(15,1,1) = {"
a
a
a
a
a
a
a
a
a
w
n
n
n
n
n
w
Z
Z
E
W
W
W
W
W
W
W
W
W
W
W
W
W
W
W
W
W
W
E
Z
Z
w
n
n
n
n
n
w
a
a
a
"}
(16,1,1) = {"
a
a
a
a
a
a
a
a
a
w
n
G
n
n
n
w
Z
Z
L
W
L
L
e
e
e
e
e
e
e
e
e
e
e
e
L
L
W
L
Z
Z
w
n
n
n
y
n
w
a
a
a
"}
(17,1,1) = {"
a
a
a
a
a
a
a
a
a
w
V
n
n
n
n
A
Z
Z
E
W
L
W
W
W
W
W
W
W
W
W
W
W
W
W
W
L
W
E
Z
Z
A
n
n
n
n
V
w
a
a
a
"}
(18,1,1) = {"
a
a
a
a
a
a
a
a
a
w
h
n
n
n
n
A
Z
Z
E
W
e
W
e
e
e
e
e
e
e
e
e
e
e
e
W
e
W
E
Z
Z
A
n
n
n
n
h
w
a
a
a
"}
(19,1,1) = {"
a
a
a
a
a
a
a
a
a
w
V
n
n
n
n
A
Z
Z
E
W
L
W
W
W
W
W
W
W
W
W
W
W
W
W
W
L
W
E
Z
Z
A
n
n
n
n
V
w
a
a
a
"}
(20,1,1) = {"
a
a
a
a
a
a
a
a
a
w
n
G
n
n
n
w
Z
Z
L
W
L
L
e
e
e
e
e
e
e
e
e
e
e
e
L
L
W
L
Z
Z
w
n
n
n
y
n
w
a
a
a
"}
(21,1,1) = {"
a
a
a
a
a
a
a
a
a
w
n
n
n
n
n
w
Z
Z
E
W
W
W
W
W
W
W
W
W
W
W
W
W
W
W
W
W
W
E
Z
Z
w
n
n
n
n
n
w
a
a
a
"}
(22,1,1) = {"
a
a
a
a
a
a
a
a
a
w
V
n
n
n
n
w
Z
Z
E
E
E
E
E
E
E
E
E
L
L
E
E
E
E
E
E
E
E
E
Z
Z
w
n
n
n
n
V
w
a
a
a
"}
(23,1,1) = {"
a
a
a
a
a
a
a
a
a
w
h
G
n
n
n
w
Z
Z
Z
Z
Z
Z
Z
Z
Z
Z
Z
Z
Z
Z
Z
Z
Z
Z
Z
Z
Z
Z
Z
Z
w
n
n
n
y
h
w
a
a
a
"}
(24,1,1) = {"
a
a
a
a
a
a
a
a
a
w
V
n
n
n
n
w
Z
Z
Z
Z
Z
Z
Z
Z
Z
Z
Z
Z
Z
Z
Z
Z
Z
Z
Z
Z
Z
Z
Z
Z
w
n
n
n
n
V
w
a
a
a
"}
(25,1,1) = {"
a
a
a
a
a
a
a
a
a
w
w
w
g
g
w
w
w
w
w
w
w
w
w
w
w
w
w
A
A
w
w
w
w
w
w
w
w
w
w
w
w
w
g
g
w
w
w
a
a
a
"}
(26,1,1) = {"
a
a
a
a
a
a
a
a
a
a
s
s
M
M
s
s
s
s
s
s
s
s
s
s
s
s
s
M
M
s
s
s
s
s
s
s
s
s
s
s
s
s
M
M
s
s
a
a
a
a
"}
(27,1,1) = {"
a
a
a
a
a
a
a
a
a
a
s
M
M
M
M
M
M
M
M
M
M
M
M
M
M
M
M
M
M
M
M
M
M
M
M
M
M
M
M
M
M
M
M
M
M
s
a
a
a
a
"}
(28,1,1) = {"
a
a
a
a
a
a
a
a
a
a
s
M
M
M
c
M
M
M
M
M
M
M
M
M
M
M
M
M
M
M
M
M
M
M
M
M
M
M
M
M
M
c
M
M
M
s
a
a
a
a
"}
(29,1,1) = {"
a
a
a
a
a
a
a
a
a
a
s
M
M
M
c
M
M
M
M
M
M
M
M
M
M
c
c
c
c
c
c
M
M
M
M
M
M
M
M
M
M
c
M
M
M
s
a
a
a
a
"}
(30,1,1) = {"
a
a
a
a
a
a
a
a
a
a
s
M
M
M
c
M
M
M
M
M
M
M
M
M
M
M
M
M
M
M
M
M
M
M
M
M
M
M
M
M
M
c
M
M
M
s
a
a
a
a
"}
(31,1,1) = {"
a
a
a
a
a
a
a
a
a
a
s
M
M
M
M
M
M
M
M
M
M
M
M
M
M
M
M
M
M
M
M
M
M
M
M
M
M
M
M
M
M
M
M
M
M
s
a
a
a
a
"}
(32,1,1) = {"
a
a
a
a
a
a
a
a
a
a
s
s
s
s
s
s
s
s
s
s
s
s
s
s
s
s
s
s
s
s
s
s
s
s
s
s
s
s
s
s
s
s
s
s
s
s
a
a
a
a
"}
(33,1,1) = {"
a
a
a
a
a
a
a
a
a
a
a
a
a
a
a
a
a
a
a
a
a
a
a
a
a
a
a
a
a
a
a
a
a
a
a
a
a
a
a
a
a
a
a
a
a
a
a
a
a
a
"}
(34,1,1) = {"
a
a
a
a
a
a
a
a
a
a
a
a
a
a
a
a
a
a
a
a
a
a
a
a
a
a
a
a
a
a
a
a
a
a
a
a
a
a
a
a
a
a
a
a
a
a
a
a
a
a
"}
(35,1,1) = {"
a
a
a
a
a
a
a
a
a
a
a
a
a
a
a
a
a
a
a
a
a
a
a
a
a
a
a
a
a
a
a
a
a
a
a
a
a
a
a
a
a
a
a
a
a
a
a
a
a
a
"}
(36,1,1) = {"
a
a
a
a
a
a
a
a
a
a
a
a
a
a
a
a
a
a
a
a
a
a
a
a
a
a
a
a
a
a
a
a
a
a
a
a
a
a
a
a
a
a
a
a
a
a
a
a
a
a
"}
(37,1,1) = {"
a
a
a
a
a
a
a
a
a
a
a
a
a
a
a
a
a
a
a
a
a
a
a
a
a
a
a
a
a
a
a
a
a
a
a
a
a
a
a
a
a
a
a
a
a
a
a
a
a
a
"}
(38,1,1) = {"
a
a
a
a
a
a
a
a
a
a
a
a
a
a
a
a
a
a
a
a
a
a
a
a
a
a
a
a
a
a
a
a
a
a
a
a
a
a
a
a
a
a
a
a
a
a
a
a
a
a
"}
(39,1,1) = {"
a
a
a
a
a
a
a
a
a
a
a
a
a
a
a
a
a
a
a
a
a
a
a
a
a
a
a
a
a
a
a
a
a
a
a
a
a
a
a
a
a
a
a
a
a
a
a
a
a
a
"}
(40,1,1) = {"
a
a
a
a
a
a
a
a
a
a
a
a
a
a
a
a
a
a
a
a
a
a
a
a
a
a
a
a
a
a
a
a
a
a
a
a
a
a
a
a
a
a
a
a
a
a
a
a
a
a
"}
(41,1,1) = {"
a
a
a
a
a
a
a
a
a
a
a
a
a
a
a
a
a
a
a
a
a
a
a
a
a
a
a
a
a
a
a
a
a
a
a
a
a
a
a
a
a
a
a
a
a
a
a
a
a
a
"}
(42,1,1) = {"
a
a
a
a
a
a
a
a
a
a
a
a
a
a
a
a
a
a
a
a
a
a
a
a
a
a
a
a
a
a
a
a
a
a
a
a
a
a
a
a
a
a
a
a
a
a
a
a
a
a
"}
(43,1,1) = {"
a
a
a
a
a
a
a
a
a
a
a
a
a
a
a
a
a
a
a
a
a
a
a
a
a
a
a
a
a
a
a
a
a
a
a
a
a
a
a
a
a
a
a
a
a
a
a
a
a
a
"}
(44,1,1) = {"
a
a
a
a
a
a
a
a
a
a
a
a
a
a
a
a
a
a
a
a
a
a
a
a
a
a
a
a
a
a
a
a
a
a
a
a
a
a
a
a
a
a
a
a
a
a
a
a
a
a
"}
(45,1,1) = {"
a
a
a
a
a
a
a
a
a
a
a
a
a
a
a
a
a
a
a
a
a
a
a
a
a
a
a
a
a
a
a
a
a
a
a
a
a
a
a
a
a
a
a
a
a
a
a
a
a
a
"}
(46,1,1) = {"
a
a
a
a
a
a
a
a
a
a
a
a
a
a
a
a
a
a
a
a
a
a
a
a
a
a
a
a
a
a
a
a
a
a
a
a
a
a
a
a
a
a
a
a
a
a
a
a
a
a
"}
(47,1,1) = {"
a
a
a
a
a
a
a
a
a
a
a
a
a
a
a
a
a
a
a
a
a
a
a
a
a
a
a
a
a
a
a
a
a
a
a
a
a
a
a
a
a
a
a
a
a
a
a
a
a
a
"}
(48,1,1) = {"
a
a
a
a
a
a
a
a
a
a
a
a
a
a
a
a
a
a
a
a
a
a
a
a
a
a
a
a
a
a
a
a
a
a
a
a
a
a
a
a
a
a
a
a
a
a
a
a
a
a
"}
(49,1,1) = {"
a
a
a
a
a
a
a
a
a
a
a
a
a
a
a
a
a
a
a
a
a
a
a
a
a
a
a
a
a
a
a
a
a
a
a
a
a
a
a
a
a
a
a
a
a
a
a
a
a
a
"}
(50,1,1) = {"
a
a
a
a
a
a
a
a
a
a
a
a
a
a
a
a
a
a
a
a
a
a
a
a
a
a
a
a
a
a
a
a
a
a
a
a
a
a
a
a
a
a
a
a
a
a
a
a
a
a
"}
