//MAP CONVERTED BY dmm2tgm.py THIS HEADER COMMENT PREVENTS RECONVERSION, DO NOT REMOVE
"cC" = (
/turf/closed/dz/normal/cyber/ice,
/area/violence)
"dr" = (
/obj/effect/turf_decal/box/red/corners{
	dir = 1
	},
/turf/open/floor/dz/cyber,
/area/violence)
"ff" = (
/obj/structure/sign/poster/random,
/turf/closed/dz/normal,
/area/violence)
"hy" = (
/obj/structure/sign/dz/middle,
/turf/closed/dz/normal,
/area/violence)
"hY" = (
/obj/effect/landmark/start/combatant/red,
/turf/open/floor/light{
	currentcolor = "#FA8282"
	},
/area/violence)
"jk" = (
/obj/effect/turf_decal/box/red/corners,
/turf/open/floor/dz/cyber,
/area/violence)
"jo" = (
/obj/structure/sign/dz/end,
/turf/closed/dz/normal/cyber,
/area/violence)
"lY" = (
/obj/structure/sign/dz/end,
/turf/closed/dz/normal,
/area/violence)
"mj" = (
/obj/machinery/door/poddoor/multi_tile/three_tile_hor{
	resistance_flags = 115
	},
/turf/open/floor/dz/cyber,
/area/violence)
"mp" = (
/obj/effect/baseturf_helper/dune,
/turf/closed/dz/normal,
/area/violence)
"mT" = (
/obj/structure/sign/dz,
/turf/closed/dz/normal,
/area/violence)
"oE" = (
/obj/effect/landmark/bomb_plant_location,
/obj/effect/turf_decal/box/red,
/turf/open/floor/dz/cyber,
/area/violence)
"sR" = (
/obj/structure/sign/dz,
/turf/closed/dz/normal/cyber,
/area/violence)
"xw" = (
/turf/open/floor/dz/cyber,
/area/violence)
"zB" = (
/obj/effect/landmark/start/combatant/blue,
/turf/open/floor/light{
	currentcolor = "#3375F8"
	},
/area/violence)
"CQ" = (
/turf/closed/dz/normal/cyber,
/area/violence)
"Hy" = (
/turf/closed/dz/normal,
/area/violence)
"IU" = (
/obj/effect/turf_decal/box/red/corners{
	dir = 4
	},
/turf/open/floor/dz/cyber,
/area/violence)
"Js" = (
/turf/open/floor/rospilovo/cyber{
	icon_state = "bfloor-3"
	},
/area/violence)
"JA" = (
/obj/structure/sign/poster/random,
/turf/closed/dz/normal/cyber,
/area/violence)
"Kt" = (
/turf/template_noop,
/area/template_noop)
"Li" = (
/obj/effect/landmark/start/combatant/blue,
/turf/open/floor/dz/cyber,
/area/violence)
"Nb" = (
/obj/effect/turf_decal/box/red/corners{
	dir = 8
	},
/turf/open/floor/dz/cyber,
/area/violence)
"PD" = (
/obj/effect/landmark/start/combatant/red,
/turf/open/floor/rospilovo/cyber{
	icon_state = "bfloor-3"
	},
/area/violence)
"QI" = (
/obj/machinery/door/poddoor/multi_tile/three_tile_hor{
	resistance_flags = 115
	},
/turf/open/floor/rospilovo/cyber{
	icon_state = "bfloor-3"
	},
/area/violence)
"VO" = (
/obj/structure/sign/dz/middle,
/turf/closed/dz/normal/cyber,
/area/violence)

(1,1,1) = {"
Kt
Kt
Kt
Kt
Kt
Kt
mp
Hy
Hy
Hy
Hy
Hy
Hy
Hy
Hy
Hy
Hy
Hy
Hy
CQ
CQ
CQ
CQ
CQ
CQ
CQ
CQ
CQ
CQ
CQ
CQ
CQ
CQ
Kt
Kt
Kt
Kt
Kt
Kt
"}
(2,1,1) = {"
Kt
Kt
Kt
Kt
Kt
Kt
Hy
cC
cC
cC
cC
cC
cC
cC
cC
cC
cC
cC
cC
cC
cC
cC
cC
cC
cC
cC
cC
cC
cC
cC
cC
cC
CQ
Kt
Kt
Kt
Kt
Kt
Kt
"}
(3,1,1) = {"
Kt
Kt
Kt
Kt
Kt
Kt
Hy
cC
cC
cC
cC
cC
cC
cC
cC
cC
cC
cC
cC
cC
cC
cC
cC
cC
cC
cC
cC
cC
cC
cC
cC
cC
CQ
Kt
Kt
Kt
Kt
Kt
Kt
"}
(4,1,1) = {"
Kt
Kt
Kt
Kt
Kt
Kt
Hy
cC
cC
cC
cC
cC
cC
cC
cC
cC
cC
cC
cC
cC
cC
cC
cC
cC
cC
cC
cC
cC
cC
cC
cC
cC
CQ
Kt
Kt
Kt
Kt
Kt
Kt
"}
(5,1,1) = {"
Kt
Kt
Kt
Kt
Kt
Kt
Hy
cC
cC
cC
cC
cC
cC
cC
cC
cC
cC
cC
cC
cC
cC
cC
cC
cC
cC
cC
cC
cC
cC
cC
cC
cC
CQ
Kt
Kt
Kt
Kt
Kt
Kt
"}
(6,1,1) = {"
Kt
Kt
Kt
Kt
Kt
Kt
Hy
cC
cC
cC
cC
cC
cC
cC
cC
cC
cC
cC
cC
cC
cC
cC
cC
cC
cC
cC
cC
cC
cC
cC
cC
cC
CQ
Kt
Kt
Kt
Kt
Kt
Kt
"}
(7,1,1) = {"
Kt
Kt
Kt
Kt
Kt
Kt
Hy
cC
cC
cC
cC
cC
cC
cC
cC
cC
cC
cC
cC
cC
JA
cC
cC
cC
cC
cC
cC
cC
cC
cC
cC
cC
CQ
Kt
Kt
Kt
Kt
Kt
Kt
"}
(8,1,1) = {"
Kt
Kt
Kt
Kt
Kt
Kt
Hy
cC
cC
cC
cC
cC
cC
cC
cC
cC
cC
cC
cC
cC
cC
cC
cC
cC
cC
cC
cC
cC
cC
cC
cC
cC
CQ
Kt
Kt
Kt
Kt
Kt
Kt
"}
(9,1,1) = {"
Kt
Kt
Kt
Kt
Kt
Kt
Hy
cC
cC
cC
cC
cC
cC
cC
cC
cC
cC
cC
cC
cC
cC
cC
cC
cC
cC
cC
cC
cC
cC
cC
cC
cC
CQ
Kt
Kt
Kt
Kt
Kt
Kt
"}
(10,1,1) = {"
Kt
Kt
Kt
Kt
Kt
Kt
Hy
cC
cC
cC
cC
cC
cC
cC
cC
cC
cC
cC
cC
cC
cC
cC
cC
cC
cC
cC
cC
cC
cC
cC
cC
cC
CQ
Kt
Kt
Kt
Kt
Kt
Kt
"}
(11,1,1) = {"
Kt
Kt
Kt
Kt
Kt
Kt
Hy
cC
cC
cC
cC
cC
cC
cC
cC
cC
cC
cC
cC
cC
cC
cC
cC
cC
cC
cC
cC
cC
cC
cC
cC
cC
CQ
Kt
Kt
Kt
Kt
Kt
Kt
"}
(12,1,1) = {"
Kt
Kt
Kt
Kt
Kt
Kt
Hy
cC
cC
cC
cC
cC
cC
cC
cC
cC
cC
cC
cC
cC
cC
cC
cC
cC
cC
cC
cC
cC
cC
cC
cC
cC
CQ
Kt
Kt
Kt
Kt
Kt
Kt
"}
(13,1,1) = {"
Hy
Hy
Hy
Hy
Hy
Hy
Hy
cC
cC
cC
cC
cC
cC
cC
cC
cC
cC
cC
cC
cC
cC
cC
cC
cC
cC
cC
cC
cC
cC
cC
cC
cC
CQ
CQ
CQ
CQ
CQ
CQ
CQ
"}
(14,1,1) = {"
Hy
hY
PD
PD
PD
hY
Hy
cC
cC
cC
cC
cC
cC
cC
cC
cC
cC
cC
ff
cC
JA
cC
cC
cC
cC
cC
cC
cC
cC
cC
cC
cC
CQ
zB
Li
Li
Li
zB
CQ
"}
(15,1,1) = {"
mT
PD
PD
PD
PD
PD
QI
cC
cC
cC
cC
cC
cC
cC
cC
cC
cC
cC
jk
xw
IU
cC
cC
cC
cC
cC
cC
cC
cC
cC
cC
cC
mj
Li
Li
Li
Li
Li
sR
"}
(16,1,1) = {"
hy
PD
PD
PD
PD
PD
Js
cC
cC
cC
cC
cC
cC
cC
cC
cC
cC
cC
xw
oE
xw
cC
cC
cC
cC
cC
cC
cC
cC
cC
cC
cC
xw
Li
Li
Li
Li
Li
VO
"}
(17,1,1) = {"
lY
PD
PD
PD
PD
PD
Js
cC
cC
cC
cC
cC
cC
cC
cC
cC
cC
cC
Nb
xw
dr
cC
cC
cC
cC
cC
cC
cC
cC
cC
cC
cC
xw
Li
Li
Li
Li
Li
jo
"}
(18,1,1) = {"
Hy
hY
PD
PD
PD
hY
Hy
cC
cC
cC
cC
cC
cC
cC
cC
cC
cC
cC
ff
cC
JA
cC
cC
cC
cC
cC
cC
cC
cC
cC
cC
cC
CQ
zB
Li
Li
Li
zB
CQ
"}
(19,1,1) = {"
Hy
Hy
Hy
Hy
Hy
Hy
Hy
cC
cC
cC
cC
cC
cC
cC
cC
cC
cC
cC
cC
cC
cC
cC
cC
cC
cC
cC
cC
cC
cC
cC
cC
cC
CQ
CQ
CQ
CQ
CQ
CQ
CQ
"}
(20,1,1) = {"
Kt
Kt
Kt
Kt
Kt
Kt
Hy
cC
cC
cC
cC
cC
cC
cC
cC
cC
cC
cC
cC
cC
cC
cC
cC
cC
cC
cC
cC
cC
cC
cC
cC
cC
CQ
Kt
Kt
Kt
Kt
Kt
Kt
"}
(21,1,1) = {"
Kt
Kt
Kt
Kt
Kt
Kt
Hy
cC
cC
cC
cC
cC
cC
cC
cC
cC
cC
cC
cC
cC
cC
cC
cC
cC
cC
cC
cC
cC
cC
cC
cC
cC
CQ
Kt
Kt
Kt
Kt
Kt
Kt
"}
(22,1,1) = {"
Kt
Kt
Kt
Kt
Kt
Kt
Hy
cC
cC
cC
cC
cC
cC
cC
cC
cC
cC
cC
cC
cC
cC
cC
cC
cC
cC
cC
cC
cC
cC
cC
cC
cC
CQ
Kt
Kt
Kt
Kt
Kt
Kt
"}
(23,1,1) = {"
Kt
Kt
Kt
Kt
Kt
Kt
Hy
cC
cC
cC
cC
cC
cC
cC
cC
cC
cC
cC
cC
cC
cC
cC
cC
cC
cC
cC
cC
cC
cC
cC
cC
cC
CQ
Kt
Kt
Kt
Kt
Kt
Kt
"}
(24,1,1) = {"
Kt
Kt
Kt
Kt
Kt
Kt
Hy
cC
cC
cC
cC
cC
cC
cC
cC
cC
cC
cC
ff
cC
cC
cC
cC
cC
cC
cC
cC
cC
cC
cC
cC
cC
CQ
Kt
Kt
Kt
Kt
Kt
Kt
"}
(25,1,1) = {"
Kt
Kt
Kt
Kt
Kt
Kt
Hy
cC
cC
cC
cC
cC
cC
cC
cC
cC
cC
cC
cC
cC
cC
cC
cC
cC
cC
cC
cC
cC
cC
cC
cC
cC
CQ
Kt
Kt
Kt
Kt
Kt
Kt
"}
(26,1,1) = {"
Kt
Kt
Kt
Kt
Kt
Kt
Hy
cC
cC
cC
cC
cC
cC
cC
cC
cC
cC
cC
cC
cC
cC
cC
cC
cC
cC
cC
cC
cC
cC
cC
cC
cC
CQ
Kt
Kt
Kt
Kt
Kt
Kt
"}
(27,1,1) = {"
Kt
Kt
Kt
Kt
Kt
Kt
Hy
cC
cC
cC
cC
cC
cC
cC
cC
cC
cC
cC
cC
cC
cC
cC
cC
cC
cC
cC
cC
cC
cC
cC
cC
cC
CQ
Kt
Kt
Kt
Kt
Kt
Kt
"}
(28,1,1) = {"
Kt
Kt
Kt
Kt
Kt
Kt
Hy
cC
cC
cC
cC
cC
cC
cC
cC
cC
cC
cC
cC
cC
cC
cC
cC
cC
cC
cC
cC
cC
cC
cC
cC
cC
CQ
Kt
Kt
Kt
Kt
Kt
Kt
"}
(29,1,1) = {"
Kt
Kt
Kt
Kt
Kt
Kt
Hy
cC
cC
cC
cC
cC
cC
cC
cC
cC
cC
cC
cC
cC
cC
cC
cC
cC
cC
cC
cC
cC
cC
cC
cC
cC
CQ
Kt
Kt
Kt
Kt
Kt
Kt
"}
(30,1,1) = {"
Kt
Kt
Kt
Kt
Kt
Kt
Hy
cC
cC
cC
cC
cC
cC
cC
cC
cC
cC
cC
cC
cC
cC
cC
cC
cC
cC
cC
cC
cC
cC
cC
cC
cC
CQ
Kt
Kt
Kt
Kt
Kt
Kt
"}
(31,1,1) = {"
Kt
Kt
Kt
Kt
Kt
Kt
Hy
Hy
Hy
Hy
Hy
Hy
Hy
Hy
Hy
Hy
Hy
Hy
Hy
Hy
CQ
CQ
CQ
CQ
CQ
CQ
CQ
CQ
CQ
CQ
CQ
CQ
CQ
Kt
Kt
Kt
Kt
Kt
Kt
"}
