//MAP CONVERTED BY dmm2tgm.py THIS HEADER COMMENT PREVENTS RECONVERSION, DO NOT REMOVE
"a" = (
/turf/open/floor/bamboo,
/area/violence)
"e" = (
/obj/structure/chair/stool/bamboo,
/obj/effect/landmark/start/combatant/blue,
/turf/open/floor/bamboo,
/area/violence)
"i" = (
/obj/machinery/door/poddoor/multi_tile/three_tile_ver{
	resistance_flags = 115
	},
/turf/open/floor/carpet/blue,
/area/violence)
"j" = (
/turf/open/floor/carpet/green,
/area/violence)
"n" = (
/obj/structure/bed/prison/bed,
/turf/open/floor/bamboo,
/area/violence)
"p" = (
/obj/structure/table/wood,
/turf/open/floor/bamboo,
/area/violence)
"t" = (
/turf/closed/indestructible/necropolis,
/area/violence)
"x" = (
/obj/structure/table/wood,
/obj/item/spear/bamboospear,
/turf/open/floor/bamboo,
/area/violence)
"z" = (
/obj/machinery/door/poddoor/multi_tile/three_tile_ver{
	resistance_flags = 115
	},
/turf/open/floor/carpet/red,
/area/violence)
"A" = (
/turf/closed/wall/mineral/bamboo,
/area/violence)
"C" = (
/obj/structure/chair/stool/bamboo,
/obj/effect/landmark/start/combatant/red,
/turf/open/floor/bamboo,
/area/violence)
"D" = (
/turf/open/floor/carpet/blue,
/area/violence)
"E" = (
/turf/template_noop,
/area/template_noop)
"I" = (
/obj/structure/mineral_door/paperframe,
/turf/open/floor/bamboo,
/area/violence)
"N" = (
/turf/closed/indestructible/black,
/area/violence)
"Q" = (
/obj/structure/window/paperframe,
/turf/open/floor/bamboo,
/area/violence)
"U" = (
/turf/open/floor/carpet/red,
/area/violence)
"X" = (
/obj/effect/landmark/observer_start,
/turf/open/floor/carpet/green,
/area/violence)
"Y" = (
/obj/structure/chair/stool/bamboo,
/turf/open/floor/bamboo,
/area/violence)

(1,1,1) = {"
E
E
E
E
E
N
N
N
N
N
N
N
N
N
N
N
N
N
E
E
E
E
E
"}
(2,1,1) = {"
E
E
E
E
E
N
A
A
A
A
A
A
A
A
A
A
A
N
E
E
E
E
E
"}
(3,1,1) = {"
E
E
E
E
E
N
N
A
p
C
C
C
C
C
p
A
N
N
E
E
E
E
E
"}
(4,1,1) = {"
E
E
E
E
E
E
N
A
n
a
a
a
a
a
n
A
N
E
E
E
E
E
E
"}
(5,1,1) = {"
E
E
E
E
E
E
N
A
p
C
C
C
C
C
p
A
N
E
E
E
E
E
E
"}
(6,1,1) = {"
E
E
E
E
E
E
N
A
a
a
a
a
a
a
a
A
N
E
E
E
E
E
E
"}
(7,1,1) = {"
E
E
E
E
E
N
N
A
a
a
a
a
a
a
a
A
N
N
E
E
E
E
E
"}
(8,1,1) = {"
E
E
E
E
E
N
A
A
A
A
U
U
U
A
A
A
A
N
E
E
E
E
E
"}
(9,1,1) = {"
E
E
E
E
N
N
N
N
N
t
U
U
z
t
N
N
N
N
N
E
E
E
E
"}
(10,1,1) = {"
N
N
N
N
N
A
A
A
A
A
U
U
U
A
A
A
A
A
N
N
N
N
N
"}
(11,1,1) = {"
N
A
A
A
A
A
a
a
a
a
a
a
a
a
a
a
a
A
A
A
A
A
N
"}
(12,1,1) = {"
N
A
a
a
a
a
a
a
a
a
a
a
a
a
a
a
a
a
a
a
a
A
N
"}
(13,1,1) = {"
N
A
a
a
a
a
a
a
a
p
p
a
p
p
a
a
a
a
a
a
a
A
N
"}
(14,1,1) = {"
N
A
a
a
A
Q
Q
Q
A
Q
Q
I
Q
Q
A
Q
Q
Q
A
a
a
A
N
"}
(15,1,1) = {"
N
A
a
a
Q
a
a
a
a
a
a
a
a
a
a
a
a
a
Q
a
a
A
N
"}
(16,1,1) = {"
N
A
a
a
Q
a
a
a
a
a
a
a
a
a
a
a
a
a
Q
a
a
A
N
"}
(17,1,1) = {"
N
A
a
a
Q
a
a
A
A
A
A
I
A
A
A
A
a
a
Q
a
a
A
N
"}
(18,1,1) = {"
N
A
a
a
Q
a
a
I
a
a
a
a
a
a
a
I
a
a
Q
a
a
A
N
"}
(19,1,1) = {"
N
A
a
a
Q
a
a
A
A
a
Y
p
Y
a
A
A
a
a
Q
a
a
A
N
"}
(20,1,1) = {"
N
A
a
a
Q
a
a
a
A
a
Y
x
Y
a
A
a
a
a
Q
a
a
A
N
"}
(21,1,1) = {"
N
A
a
a
Q
a
a
a
A
a
Y
p
Y
a
A
a
a
a
Q
a
a
A
N
"}
(22,1,1) = {"
N
A
a
a
A
A
a
a
A
a
a
a
a
a
A
a
a
A
A
a
a
A
N
"}
(23,1,1) = {"
N
A
a
Y
p
A
a
a
A
a
j
j
j
a
A
a
a
A
p
Y
a
A
N
"}
(24,1,1) = {"
N
A
a
a
a
I
a
a
I
a
j
X
j
a
I
a
a
I
a
a
a
A
N
"}
(25,1,1) = {"
N
A
a
a
a
I
a
a
I
a
j
j
j
a
I
a
a
I
a
a
a
A
N
"}
(26,1,1) = {"
N
A
a
Y
p
A
a
a
A
a
j
j
j
a
A
a
a
A
p
Y
a
A
N
"}
(27,1,1) = {"
N
A
a
a
A
A
a
a
A
a
a
a
a
a
A
a
a
A
A
a
a
A
N
"}
(28,1,1) = {"
N
A
a
a
Q
a
a
a
A
a
Y
p
Y
a
A
a
a
a
Q
a
a
A
N
"}
(29,1,1) = {"
N
A
a
a
Q
a
a
a
A
a
Y
x
Y
a
A
a
a
a
Q
a
a
A
N
"}
(30,1,1) = {"
N
A
a
a
Q
a
a
A
A
a
Y
p
Y
a
A
A
a
a
Q
a
a
A
N
"}
(31,1,1) = {"
N
A
a
a
Q
a
a
I
a
a
a
a
a
a
a
I
a
a
Q
a
a
A
N
"}
(32,1,1) = {"
N
A
a
a
Q
a
a
A
A
A
A
I
A
A
A
A
a
a
Q
a
a
A
N
"}
(33,1,1) = {"
N
A
a
a
Q
a
a
a
a
a
a
a
a
a
a
a
a
a
Q
a
a
A
N
"}
(34,1,1) = {"
N
A
a
a
Q
a
a
a
a
a
a
a
a
a
a
a
a
a
Q
a
a
A
N
"}
(35,1,1) = {"
N
A
a
a
A
Q
Q
Q
A
Q
Q
I
Q
Q
A
Q
Q
Q
A
a
a
A
N
"}
(36,1,1) = {"
N
A
a
a
a
a
a
a
a
p
p
a
p
p
a
a
a
a
a
a
a
A
N
"}
(37,1,1) = {"
N
A
a
a
a
a
a
a
a
a
a
a
a
a
a
a
a
a
a
a
a
A
N
"}
(38,1,1) = {"
N
A
A
A
A
A
a
a
a
a
a
a
a
a
a
a
a
A
A
A
A
A
N
"}
(39,1,1) = {"
N
N
N
N
N
A
A
A
A
A
D
D
D
A
A
A
A
A
N
N
N
N
N
"}
(40,1,1) = {"
E
E
E
E
N
N
N
N
N
t
D
D
i
t
N
N
N
N
N
E
E
E
E
"}
(41,1,1) = {"
E
E
E
E
E
N
A
A
A
A
D
D
D
A
A
A
A
N
E
E
E
E
E
"}
(42,1,1) = {"
E
E
E
E
E
N
N
A
a
a
a
a
a
a
a
A
N
N
E
E
E
E
E
"}
(43,1,1) = {"
E
E
E
E
E
E
N
A
a
a
a
a
a
a
a
A
N
E
E
E
E
E
E
"}
(44,1,1) = {"
E
E
E
E
E
E
N
A
p
e
e
e
e
e
p
A
N
E
E
E
E
E
E
"}
(45,1,1) = {"
E
E
E
E
E
E
N
A
n
a
a
a
a
a
n
A
N
E
E
E
E
E
E
"}
(46,1,1) = {"
E
E
E
E
E
N
N
A
p
e
e
e
e
e
p
A
N
N
E
E
E
E
E
"}
(47,1,1) = {"
E
E
E
E
E
N
A
A
A
A
A
A
A
A
A
A
A
N
E
E
E
E
E
"}
(48,1,1) = {"
E
E
E
E
E
N
N
N
N
N
N
N
N
N
N
N
N
N
E
E
E
E
E
"}
