//MAP CONVERTED BY dmm2tgm.py THIS HEADER COMMENT PREVENTS RECONVERSION, DO NOT REMOVE
"aq" = (
/obj/structure/table,
/obj/effect/turf_decal/stripes/line{
	dir = 10
	},
/turf/open/floor/plating/is12/wood,
/area/violence)
"aK" = (
/obj/structure/table,
/obj/effect/turf_decal/stripes/line{
	dir = 9
	},
/turf/open/floor/plating/is12/wood,
/area/violence)
"aZ" = (
/obj/effect/turf_decal/stripes/line{
	dir = 5
	},
/obj/effect/turf_decal/is12{
	icon_state = "wwi"
	},
/turf/open/floor/plating/is12/rock,
/area/violence)
"bv" = (
/obj/effect/turf_decal/is12{
	icon_state = "dirtcornerleft"
	},
/obj/effect/turf_decal/is12{
	icon_state = "wwi"
	},
/turf/open/floor/plating/is12/rock,
/area/violence)
"bC" = (
/turf/closed/indestructible/riveted/boss,
/area/violence)
"bP" = (
/obj/effect/turf_decal/stripes/line{
	dir = 4
	},
/obj/effect/turf_decal/is12{
	icon_state = "wwi"
	},
/turf/open/floor/plating/is12/rock,
/area/violence)
"fc" = (
/obj/structure/bed/maint,
/obj/effect/turf_decal/stripes/line{
	dir = 1
	},
/turf/open/floor/plating/is12/wood,
/area/violence)
"fi" = (
/obj/effect/turf_decal/is12{
	icon_state = "dirtcornercenter"
	},
/obj/effect/turf_decal/is12{
	icon_state = "wwi"
	},
/turf/open/floor/plating/is12/rock,
/area/violence)
"ft" = (
/obj/effect/turf_decal/stripes/line{
	dir = 5
	},
/turf/open/floor/plating/is12/wood,
/area/violence)
"fx" = (
/obj/structure/table,
/obj/effect/turf_decal/stripes/line{
	dir = 1
	},
/turf/open/floor/plating/is12/wood,
/area/violence)
"fM" = (
/obj/effect/turf_decal/stripes/line,
/turf/open/floor/plating/is12/surface,
/area/violence)
"fQ" = (
/obj/effect/turf_decal/stripes/line{
	dir = 6
	},
/turf/open/floor/plating/is12/wood,
/area/violence)
"fV" = (
/obj/effect/turf_decal/is12{
	icon_state = "wwi"
	},
/turf/open/floor/plating/is12/rock,
/area/violence)
"iB" = (
/obj/effect/turf_decal/stripes/line{
	dir = 10
	},
/obj/effect/turf_decal/is12{
	icon_state = "wwi"
	},
/turf/open/floor/plating/is12/rock,
/area/violence)
"kq" = (
/obj/structure/table,
/obj/effect/turf_decal/stripes/line{
	dir = 6
	},
/turf/open/floor/plating/is12/wood,
/area/violence)
"oj" = (
/obj/structure/bed/maint,
/obj/effect/turf_decal/stripes/line,
/turf/open/floor/plating/is12/wood,
/area/violence)
"pJ" = (
/obj/effect/turf_decal/is12{
	icon_state = "dirtcornerright"
	},
/obj/effect/turf_decal/is12{
	icon_state = "wwi"
	},
/turf/open/floor/plating/is12/rock,
/area/violence)
"qa" = (
/obj/effect/turf_decal/stripes/full,
/obj/machinery/door/poddoor/multi_tile/three_tile_hor{
	resistance_flags = 115
	},
/turf/open/floor/plating/is12/rock,
/area/violence)
"rk" = (
/obj/effect/landmark/start/combatant/blue,
/turf/open/floor/plating/is12/wood,
/area/violence)
"sl" = (
/obj/effect/turf_decal/stripes/line{
	dir = 9
	},
/obj/effect/turf_decal/is12{
	icon_state = "wwi"
	},
/turf/open/floor/plating/is12/rock,
/area/violence)
"sN" = (
/obj/effect/turf_decal/stripes/line{
	dir = 6
	},
/turf/open/floor/plating/is12/surface,
/area/violence)
"tu" = (
/obj/structure/closet{
	anchored = 1
	},
/obj/effect/turf_decal/box,
/obj/effect/turf_decal/is12{
	icon_state = "wwi"
	},
/turf/open/floor/plating/is12/trenchcenter,
/area/violence)
"tw" = (
/obj/effect/turf_decal/stripes/line{
	dir = 8
	},
/turf/open/floor/plating/is12/surface,
/area/violence)
"vy" = (
/obj/effect/turf_decal/stripes/line{
	dir = 8
	},
/obj/effect/turf_decal/is12{
	icon_state = "m4"
	},
/turf/open/floor/plating/is12/surface,
/area/violence)
"vR" = (
/obj/effect/turf_decal/stripes/line{
	dir = 4
	},
/turf/open/floor/plating/is12/surface,
/area/violence)
"xw" = (
/obj/effect/turf_decal/stripes/line{
	dir = 10
	},
/turf/open/floor/plating/is12/wood,
/area/violence)
"zg" = (
/obj/effect/turf_decal/stripes/full,
/obj/machinery/door/poddoor/multi_tile/two_tile_ver{
	resistance_flags = 115
	},
/turf/open/indestructible/boss/air,
/area/violence)
"AK" = (
/obj/effect/turf_decal/stripes/line{
	dir = 1
	},
/turf/open/floor/plating/is12/wood,
/area/violence)
"AT" = (
/obj/effect/turf_decal/is12{
	icon_state = "wwi"
	},
/turf/open/floor/plating/is12/trenchcenter,
/area/violence)
"Bd" = (
/obj/effect/turf_decal/stripes/line,
/turf/open/floor/plating/is12/wood,
/area/violence)
"Fq" = (
/obj/effect/turf_decal/stripes/full,
/turf/open/floor/plating/is12/rock,
/area/violence)
"Fs" = (
/obj/effect/turf_decal/is12{
	icon_state = "grass"
	},
/turf/open/floor/plating/is12/surface,
/area/violence)
"HM" = (
/obj/structure/table,
/obj/effect/turf_decal/stripes/line{
	dir = 5
	},
/turf/open/floor/plating/is12/wood,
/area/violence)
"Iu" = (
/obj/effect/turf_decal/is12{
	icon_state = "m1"
	},
/turf/open/floor/plating/is12/surface,
/area/violence)
"IR" = (
/turf/closed/indestructible/riveted/boss/see_through,
/area/violence)
"Jz" = (
/obj/effect/turf_decal/stripes/line{
	dir = 9
	},
/turf/open/floor/plating/is12/surface,
/area/violence)
"JX" = (
/obj/structure/closet{
	anchored = 1
	},
/obj/effect/turf_decal/box,
/obj/effect/turf_decal/is12{
	icon_state = "wwi"
	},
/obj/effect/landmark/observer_start,
/turf/open/floor/plating/is12/trenchcenter,
/area/violence)
"KS" = (
/obj/effect/turf_decal/stripes/line{
	dir = 8
	},
/obj/effect/turf_decal/is12{
	icon_state = "m3"
	},
/turf/open/floor/plating/is12/surface,
/area/violence)
"LJ" = (
/obj/effect/turf_decal/stripes/line{
	dir = 10
	},
/turf/open/floor/plating/is12/surface,
/area/violence)
"LW" = (
/obj/effect/turf_decal/is12,
/obj/effect/turf_decal/is12{
	icon_state = "wwi"
	},
/turf/open/floor/plating/is12/rock,
/area/violence)
"MO" = (
/obj/effect/turf_decal/stripes/line{
	dir = 1
	},
/turf/open/floor/plating/is12/surface,
/area/violence)
"NV" = (
/obj/effect/turf_decal/is12{
	icon_state = "m2"
	},
/turf/open/floor/plating/is12/surface,
/area/violence)
"OU" = (
/obj/effect/turf_decal/stripes/line{
	dir = 5
	},
/turf/open/floor/plating/is12/surface,
/area/violence)
"Qg" = (
/turf/open/floor/plating/is12/surface,
/area/violence)
"QE" = (
/obj/structure/table,
/turf/open/floor/plating/is12/surface,
/area/violence)
"QR" = (
/obj/effect/baseturf_helper/asteroid,
/turf/closed/indestructible/necropolis,
/area/violence)
"Rh" = (
/obj/effect/turf_decal/stripes/line,
/obj/effect/turf_decal/is12{
	icon_state = "wwi"
	},
/turf/open/floor/plating/is12/rock,
/area/violence)
"Rm" = (
/turf/open/floor/plating/is12/wood,
/area/violence)
"Rw" = (
/obj/effect/turf_decal/is12{
	icon_state = "wwi"
	},
/turf/closed/indestructible/riveted/dirtystone,
/area/violence)
"Sa" = (
/turf/template_noop,
/area/template_noop)
"Tc" = (
/obj/effect/turf_decal/stripes/line{
	dir = 8
	},
/obj/effect/turf_decal/is12{
	icon_state = "wwi"
	},
/turf/open/floor/plating/is12/rock,
/area/violence)
"TX" = (
/obj/effect/turf_decal/stripes/line{
	dir = 4
	},
/turf/open/floor/plating/is12/wood,
/area/violence)
"Ue" = (
/obj/effect/turf_decal/stripes/line{
	dir = 6
	},
/obj/effect/turf_decal/is12{
	icon_state = "wwi"
	},
/turf/open/floor/plating/is12/rock,
/area/violence)
"UH" = (
/obj/effect/turf_decal/stripes/line{
	dir = 8
	},
/turf/open/floor/plating/is12/wood,
/area/violence)
"UV" = (
/obj/effect/turf_decal/stripes/full,
/obj/machinery/door/poddoor/multi_tile/two_tile_ver{
	resistance_flags = 115
	},
/turf/open/floor/plating/is12/rock,
/area/violence)
"Vc" = (
/obj/effect/turf_decal/stripes/full,
/turf/open/indestructible/boss/air,
/area/violence)
"VV" = (
/obj/effect/turf_decal/stripes/line{
	dir = 9
	},
/turf/open/floor/plating/is12/wood,
/area/violence)
"Wa" = (
/obj/effect/landmark/start/combatant/red,
/turf/open/floor/plating/is12/wood,
/area/violence)
"Xm" = (
/obj/structure/table,
/obj/effect/turf_decal/is12{
	icon_state = "wwi"
	},
/turf/open/floor/plating/is12/trenchcenter,
/area/violence)
"YA" = (
/turf/open/floor/plating/sandy_dirt,
/area/violence)
"YT" = (
/obj/structure/table,
/obj/effect/turf_decal/stripes/line,
/turf/open/floor/plating/is12/wood,
/area/violence)
"YX" = (
/obj/effect/turf_decal/stripes/full,
/turf/open/floor/plating/is12/surface,
/area/violence)
"Zg" = (
/obj/effect/turf_decal/stripes/line{
	dir = 1
	},
/obj/effect/turf_decal/is12{
	icon_state = "wwi"
	},
/turf/open/floor/plating/is12/rock,
/area/violence)
"ZD" = (
/turf/closed/indestructible/necropolis,
/area/violence)

(1,1,1) = {"
Sa
Sa
ZD
ZD
ZD
ZD
ZD
ZD
ZD
ZD
ZD
ZD
ZD
ZD
ZD
ZD
ZD
ZD
ZD
ZD
ZD
ZD
ZD
ZD
ZD
ZD
ZD
ZD
ZD
ZD
ZD
ZD
ZD
ZD
ZD
ZD
ZD
ZD
Sa
Sa
"}
(2,1,1) = {"
Sa
Sa
ZD
YA
YA
YA
YA
YA
YA
YA
YA
YA
YA
YA
YA
YA
YA
YA
YA
YA
YA
YA
YA
YA
YA
YA
YA
YA
YA
YA
YA
YA
YA
YA
YA
YA
YA
ZD
Sa
Sa
"}
(3,1,1) = {"
Sa
Sa
ZD
YA
YA
YA
YA
YA
YA
YA
YA
YA
YA
YA
YA
YA
YA
YA
YA
YA
YA
YA
YA
YA
YA
YA
YA
YA
YA
YA
YA
YA
YA
YA
YA
YA
YA
ZD
Sa
Sa
"}
(4,1,1) = {"
Sa
Sa
ZD
IR
IR
IR
IR
IR
IR
IR
IR
IR
IR
IR
IR
IR
IR
IR
IR
IR
IR
IR
IR
IR
IR
IR
IR
IR
IR
IR
IR
IR
IR
IR
IR
IR
IR
QR
Sa
Sa
"}
(5,1,1) = {"
Sa
Sa
ZD
Jz
tw
tw
tw
tw
tw
tw
tw
tw
tw
tw
vy
KS
tw
tw
tw
tw
tw
tw
tw
tw
tw
tw
tw
tw
tw
tw
tw
tw
tw
tw
tw
tw
LJ
ZD
Sa
Sa
"}
(6,1,1) = {"
Sa
Sa
ZD
MO
Qg
Qg
QE
Qg
Qg
Qg
Qg
Fs
Qg
Qg
NV
Iu
Qg
QE
QE
QE
QE
QE
QE
Qg
Qg
Qg
Qg
Qg
Qg
Fs
Qg
Qg
Qg
QE
Qg
Qg
fM
ZD
Sa
Sa
"}
(7,1,1) = {"
Sa
Sa
ZD
OU
vR
vR
vR
vR
vR
vR
vR
vR
vR
vR
vR
vR
vR
vR
vR
vR
vR
vR
vR
vR
vR
vR
vR
vR
vR
vR
vR
vR
vR
vR
vR
vR
sN
ZD
Sa
Sa
"}
(8,1,1) = {"
Sa
Sa
ZD
ZD
YX
YX
ZD
ZD
ZD
ZD
ZD
ZD
ZD
ZD
ZD
ZD
ZD
ZD
ZD
YX
YX
ZD
ZD
ZD
ZD
ZD
ZD
ZD
ZD
ZD
ZD
ZD
ZD
ZD
YX
YX
ZD
ZD
Sa
Sa
"}
(9,1,1) = {"
Sa
bC
bC
bC
Vc
zg
bC
bC
bC
bC
bC
bC
bC
bC
bC
bC
bC
bC
bC
Fq
UV
bC
bC
bC
bC
bC
bC
bC
bC
bC
bC
bC
bC
bC
Vc
zg
bC
bC
bC
Sa
"}
(10,1,1) = {"
Sa
bC
aK
UH
UH
UH
xw
bC
sl
Tc
Tc
Tc
Tc
Tc
Tc
Tc
Tc
Tc
Tc
Tc
Tc
Tc
Tc
Tc
Tc
Tc
Tc
Tc
Tc
Tc
Tc
iB
bC
VV
UH
UH
UH
aq
bC
Sa
"}
(11,1,1) = {"
Sa
bC
fc
Wa
Rm
Rm
Bd
bC
Zg
fV
fV
fV
fV
fV
fV
fV
fV
fV
fV
fV
fV
fV
fV
fV
fV
fV
fV
fV
LW
fV
fV
Rh
bC
AK
Rm
Rm
rk
oj
bC
Sa
"}
(12,1,1) = {"
Sa
bC
fx
Rm
Rm
Rm
Bd
bC
Zg
bv
Rw
Rw
Rw
Rw
Rw
Rw
Rw
Rw
Rw
Xm
Xm
Rw
Rw
Rw
Rw
Rw
Rw
Rw
Rw
Rw
fV
Rh
bC
AK
Rm
Rm
Rm
YT
bC
Sa
"}
(13,1,1) = {"
Sa
bC
AK
Rm
Rm
Rm
Bd
bC
Zg
fi
Rw
AT
AT
AT
AT
AT
AT
AT
AT
AT
AT
AT
AT
AT
AT
AT
AT
AT
AT
Rw
fV
Rh
bC
AK
Rm
Rm
Rm
Bd
bC
Sa
"}
(14,1,1) = {"
Sa
bC
AK
Wa
Rm
Rm
Bd
bC
Zg
fi
Xm
AT
Xm
Xm
tu
tu
tu
tu
tu
tu
tu
tu
tu
tu
tu
tu
Xm
Xm
AT
Xm
fV
Rh
bC
AK
Rm
Rm
rk
Bd
bC
Sa
"}
(15,1,1) = {"
Sa
bC
fx
Rm
Rm
Rm
Bd
qa
Zg
fi
Rw
AT
Xm
AT
AT
AT
AT
AT
AT
AT
AT
AT
AT
AT
AT
AT
AT
Xm
AT
Rw
fV
Rh
qa
AK
Rm
Rm
Rm
YT
bC
Sa
"}
(16,1,1) = {"
Sa
bC
fc
Rm
Rm
Rm
Bd
Fq
Zg
fi
Rw
AT
tu
AT
tu
tu
tu
tu
tu
JX
tu
tu
tu
tu
tu
tu
AT
tu
AT
Rw
fV
Rh
Fq
AK
Rm
Rm
Rm
oj
bC
Sa
"}
(17,1,1) = {"
Sa
bC
fx
Rm
Rm
Rm
Bd
Fq
Zg
fi
Rw
AT
Xm
AT
AT
AT
AT
AT
AT
AT
AT
AT
AT
AT
AT
AT
AT
Xm
AT
Rw
fV
Rh
Fq
AK
Rm
Rm
Rm
YT
bC
Sa
"}
(18,1,1) = {"
Sa
bC
AK
Wa
Rm
Rm
Bd
bC
Zg
fi
Xm
AT
Xm
Xm
tu
tu
tu
tu
tu
tu
tu
tu
tu
tu
tu
tu
Xm
Xm
AT
Xm
fV
Rh
bC
AK
Rm
Rm
rk
Bd
bC
Sa
"}
(19,1,1) = {"
Sa
bC
AK
Rm
Rm
Rm
Bd
bC
Zg
fi
Rw
AT
AT
AT
AT
AT
AT
AT
AT
AT
AT
AT
AT
AT
AT
AT
AT
AT
AT
Rw
fV
Rh
bC
AK
Rm
Rm
Rm
Bd
bC
Sa
"}
(20,1,1) = {"
Sa
bC
fx
Rm
Rm
Rm
Bd
bC
Zg
pJ
Rw
Rw
Rw
Rw
Rw
Rw
Rw
Rw
Rw
Xm
Xm
Rw
Rw
Rw
Rw
Rw
Rw
Rw
Rw
Rw
fV
Rh
bC
AK
Rm
Rm
Rm
YT
bC
Sa
"}
(21,1,1) = {"
Sa
bC
fc
Wa
Rm
Rm
Bd
bC
Zg
fV
fV
fV
fV
fV
fV
fV
fV
fV
fV
fV
fV
fV
fV
fV
fV
fV
fV
fV
fV
fV
fV
Rh
bC
AK
Rm
Rm
rk
oj
bC
Sa
"}
(22,1,1) = {"
Sa
bC
HM
TX
TX
TX
fQ
bC
aZ
bP
bP
bP
bP
bP
bP
bP
bP
bP
bP
bP
bP
bP
bP
bP
bP
bP
bP
bP
bP
bP
bP
Ue
bC
ft
TX
TX
TX
kq
bC
Sa
"}
(23,1,1) = {"
Sa
bC
bC
bC
Vc
zg
bC
bC
bC
bC
bC
bC
bC
bC
bC
bC
bC
bC
bC
Fq
UV
bC
bC
bC
bC
bC
bC
bC
bC
bC
bC
bC
bC
bC
Vc
zg
bC
bC
bC
Sa
"}
(24,1,1) = {"
Sa
Sa
ZD
ZD
YX
YX
ZD
ZD
ZD
ZD
ZD
ZD
ZD
ZD
ZD
ZD
ZD
ZD
ZD
YX
YX
ZD
ZD
ZD
ZD
ZD
ZD
ZD
ZD
ZD
ZD
ZD
ZD
ZD
YX
YX
ZD
ZD
Sa
Sa
"}
(25,1,1) = {"
Sa
Sa
ZD
Jz
tw
tw
tw
tw
tw
tw
tw
tw
tw
tw
tw
tw
tw
tw
tw
tw
tw
tw
tw
tw
tw
tw
tw
tw
tw
tw
vy
KS
tw
tw
tw
tw
LJ
ZD
Sa
Sa
"}
(26,1,1) = {"
Sa
Sa
ZD
MO
Qg
Qg
QE
Qg
Qg
Qg
Qg
Qg
Fs
Qg
Qg
Qg
Qg
Qg
Qg
Qg
Qg
Qg
Qg
Qg
Fs
Qg
Qg
Qg
Qg
Qg
NV
Iu
Qg
QE
Qg
Qg
fM
ZD
Sa
Sa
"}
(27,1,1) = {"
Sa
Sa
ZD
OU
vR
vR
vR
vR
vR
vR
vR
vR
vR
vR
vR
vR
vR
vR
vR
vR
vR
vR
vR
vR
vR
vR
vR
vR
vR
vR
vR
vR
vR
vR
vR
vR
sN
ZD
Sa
Sa
"}
(28,1,1) = {"
Sa
Sa
ZD
IR
IR
IR
IR
IR
IR
IR
IR
IR
IR
IR
IR
IR
IR
IR
IR
IR
IR
IR
IR
IR
IR
IR
IR
IR
IR
IR
IR
IR
IR
IR
IR
IR
IR
ZD
Sa
Sa
"}
(29,1,1) = {"
Sa
Sa
ZD
YA
YA
YA
YA
YA
YA
YA
YA
YA
YA
YA
YA
YA
YA
YA
YA
YA
YA
YA
YA
YA
YA
YA
YA
YA
YA
YA
YA
YA
YA
YA
YA
YA
YA
ZD
Sa
Sa
"}
(30,1,1) = {"
Sa
Sa
ZD
YA
YA
YA
YA
YA
YA
YA
YA
YA
YA
YA
YA
YA
YA
YA
YA
YA
YA
YA
YA
YA
YA
YA
YA
YA
YA
YA
YA
YA
YA
YA
YA
YA
YA
ZD
Sa
Sa
"}
(31,1,1) = {"
Sa
Sa
ZD
ZD
ZD
ZD
ZD
ZD
ZD
ZD
ZD
ZD
ZD
ZD
ZD
ZD
ZD
ZD
ZD
ZD
ZD
ZD
ZD
ZD
ZD
ZD
ZD
ZD
ZD
ZD
ZD
ZD
ZD
ZD
ZD
ZD
ZD
ZD
Sa
Sa
"}
