//MAP CONVERTED BY dmm2tgm.py THIS HEADER COMMENT PREVENTS RECONVERSION, DO NOT REMOVE
"a" = (
/obj/effect/baseturf_helper/asteroid,
/turf/closed/dz/normal/cyber,
/area/violence)
"b" = (
/obj/machinery/door/poddoor/multi_tile/two_tile_ver{
	resistance_flags = 115
	},
/turf/open/floor/dz/cyber{
	icon_state = "hot_plates1"
	},
/area/violence)
"c" = (
/obj/effect/turf_decal/box/red/corners{
	dir = 4
	},
/turf/open/floor/dz/cyber,
/area/violence)
"e" = (
/turf/open/floor/rospilovo/cyber,
/area/violence)
"f" = (
/obj/machinery/door/poddoor/multi_tile/three_tile_hor{
	resistance_flags = 115
	},
/turf/open/floor/rospilovo/cyber{
	icon_state = "bfloor-3"
	},
/area/violence)
"g" = (
/obj/structure/deployable_barricade/metal,
/turf/open/floor/light{
	currentcolor = "#FA8282"
	},
/area/violence)
"i" = (
/obj/effect/landmark/start/combatant/red,
/turf/open/floor/rospilovo/cyber{
	icon_state = "bfloor-3"
	},
/area/violence)
"j" = (
/obj/effect/landmark/start/combatant/blue,
/turf/open/floor/light{
	currentcolor = "#3375F8"
	},
/area/violence)
"k" = (
/turf/open/floor/dz/cyber{
	icon_state = "hot_plates2"
	},
/area/violence)
"m" = (
/obj/effect/landmark/bomb_plant_location,
/obj/effect/turf_decal/box/red,
/turf/open/floor/dz/cyber,
/area/violence)
"n" = (
/turf/open/floor/dz/cyber{
	icon_state = "hot_plates3"
	},
/area/violence)
"o" = (
/turf/open/floor/dz/corruption,
/area/violence)
"p" = (
/turf/closed/dz/normal,
/area/violence)
"q" = (
/obj/effect/landmark/start/combatant/blue,
/turf/open/floor/dz/cyber,
/area/violence)
"s" = (
/obj/structure/sign/dz/middle,
/turf/closed/dz/normal/cyber,
/area/violence)
"t" = (
/obj/structure/deployable_barricade/metal{
	dir = 8
	},
/turf/open/floor/light{
	currentcolor = "#3375F8"
	},
/area/violence)
"u" = (
/turf/closed/dz/normal/cyber,
/area/violence)
"v" = (
/obj/structure/sign/dz/end,
/turf/closed/dz/normal,
/area/violence)
"w" = (
/turf/open/floor/dz/cyber{
	icon_state = "hot_plates1"
	},
/area/violence)
"x" = (
/obj/structure/mineral_door/wood{
	color = "#aa22aa";
	name = "кибердверь"
	},
/turf/open/floor/rospilovo/cyber{
	icon_state = "bfloor-3"
	},
/area/violence)
"y" = (
/obj/structure/sign/poster/random,
/turf/closed/dz/normal/cyber,
/area/violence)
"z" = (
/obj/effect/turf_decal/box/red/corners{
	dir = 1
	},
/turf/open/floor/dz/cyber,
/area/violence)
"A" = (
/obj/structure/deployable_barricade/metal{
	dir = 1
	},
/turf/open/floor/dz/cyber,
/area/violence)
"B" = (
/turf/open/floor/light{
	currentcolor = "#3375F8"
	},
/area/violence)
"C" = (
/obj/structure/sign/dz/middle,
/turf/closed/dz/normal,
/area/violence)
"D" = (
/turf/open/floor/light{
	currentcolor = "#FA8282"
	},
/area/violence)
"E" = (
/obj/effect/turf_decal/box/red/corners,
/turf/open/floor/dz/cyber,
/area/violence)
"F" = (
/obj/effect/turf_decal/box/red/corners{
	dir = 8
	},
/turf/open/floor/dz/cyber,
/area/violence)
"G" = (
/obj/structure/mineral_door/wood{
	color = "#aa22aa";
	name = "кибердверь"
	},
/turf/open/floor/dz/cyber,
/area/violence)
"H" = (
/obj/structure/deployable_barricade/metal{
	dir = 4
	},
/turf/open/floor/light{
	currentcolor = "#3375F8"
	},
/area/violence)
"I" = (
/obj/machinery/door/poddoor/multi_tile/three_tile_hor{
	resistance_flags = 115
	},
/turf/open/floor/dz/cyber,
/area/violence)
"J" = (
/obj/machinery/door/poddoor/multi_tile/four_tile_hor{
	resistance_flags = 115
	},
/turf/open/floor/dz/corruption,
/area/violence)
"L" = (
/obj/structure/deployable_barricade/metal{
	dir = 1
	},
/turf/open/floor/light{
	currentcolor = "#3375F8"
	},
/area/violence)
"M" = (
/obj/machinery/door/poddoor/multi_tile/four_tile_hor{
	resistance_flags = 115
	},
/turf/open/floor/rospilovo/cyber,
/area/violence)
"N" = (
/obj/effect/landmark/start/combatant/red,
/turf/open/floor/light{
	currentcolor = "#FA8282"
	},
/area/violence)
"O" = (
/turf/open/floor/rospilovo/cyber{
	icon_state = "bfloor-3"
	},
/area/violence)
"P" = (
/obj/structure/sign/poster/random,
/turf/closed/dz/normal,
/area/violence)
"Q" = (
/obj/structure/sign/dz,
/turf/closed/dz/normal,
/area/violence)
"S" = (
/obj/structure/sign/dz,
/turf/closed/dz/normal/cyber,
/area/violence)
"T" = (
/turf/template_noop,
/area/template_noop)
"U" = (
/obj/structure/deployable_barricade/metal,
/turf/open/floor/rospilovo/cyber{
	icon_state = "bfloor-3"
	},
/area/violence)
"V" = (
/obj/structure/deployable_barricade/metal{
	dir = 8
	},
/turf/open/floor/light{
	currentcolor = "#FA8282"
	},
/area/violence)
"W" = (
/turf/open/floor/dz/cyber,
/area/violence)
"X" = (
/obj/structure/deployable_barricade/metal{
	dir = 4
	},
/turf/open/floor/light{
	currentcolor = "#FA8282"
	},
/area/violence)
"Y" = (
/obj/structure/sign/dz/end,
/turf/closed/dz/normal/cyber,
/area/violence)
"Z" = (
/obj/machinery/door/poddoor/multi_tile/two_tile_ver{
	resistance_flags = 115
	},
/turf/open/floor/dz/cyber{
	icon_state = "hot_plates3"
	},
/area/violence)

(1,1,1) = {"
T
T
T
T
T
T
p
p
p
p
p
p
p
p
p
p
p
p
p
p
u
u
u
u
u
u
u
u
u
u
u
u
u
u
u
u
u
u
u
a
"}
(2,1,1) = {"
T
T
T
T
T
T
p
D
O
O
O
O
O
O
O
O
D
p
e
w
k
o
B
W
W
W
W
W
W
W
W
W
B
u
j
q
q
q
j
u
"}
(3,1,1) = {"
T
T
T
T
T
T
p
O
e
e
e
e
e
e
O
p
O
p
e
w
n
o
W
W
W
W
A
W
W
W
W
W
W
I
q
q
q
q
q
S
"}
(4,1,1) = {"
T
T
T
T
T
T
p
O
e
e
e
e
e
e
O
p
O
p
e
n
w
o
W
W
W
W
A
W
W
W
W
W
W
W
q
q
q
q
q
s
"}
(5,1,1) = {"
T
T
T
T
T
T
p
O
e
e
e
e
e
e
O
p
O
p
e
w
k
o
W
W
W
W
A
W
W
W
W
W
W
W
q
q
q
q
q
Y
"}
(6,1,1) = {"
T
T
T
T
T
T
p
O
e
e
e
e
e
e
O
p
O
f
e
n
w
o
B
W
W
W
W
W
W
W
W
W
B
u
j
q
q
q
j
u
"}
(7,1,1) = {"
T
T
T
T
T
T
p
O
e
e
e
e
e
e
O
p
O
O
e
w
y
u
u
u
u
u
u
u
u
u
u
G
u
u
u
u
u
u
u
u
"}
(8,1,1) = {"
T
T
T
T
T
T
p
O
e
e
e
e
e
e
O
p
O
O
e
w
w
o
B
W
W
W
B
u
B
B
G
B
B
u
T
T
T
T
T
T
"}
(9,1,1) = {"
T
T
T
T
T
T
p
O
e
e
e
e
e
e
O
p
O
p
e
k
k
o
W
E
W
c
W
u
W
W
G
W
W
u
T
T
T
T
T
T
"}
(10,1,1) = {"
T
T
T
T
T
T
p
O
e
e
e
e
e
e
O
p
O
p
e
n
k
o
W
W
m
W
W
u
W
W
u
W
W
u
T
T
T
T
T
T
"}
(11,1,1) = {"
T
T
T
T
T
T
p
O
e
e
e
e
e
e
O
p
O
p
e
n
w
o
W
F
W
z
W
G
W
W
u
W
W
u
T
T
T
T
T
T
"}
(12,1,1) = {"
T
T
T
T
T
T
p
D
O
O
O
O
O
O
O
O
D
p
e
w
n
o
B
W
W
W
B
G
B
B
u
W
W
u
T
T
T
T
T
T
"}
(13,1,1) = {"
T
T
T
T
T
T
p
p
x
p
p
p
p
p
p
p
p
p
P
w
b
y
u
u
u
u
u
u
u
u
u
B
B
u
T
T
T
T
T
T
"}
(14,1,1) = {"
T
T
T
T
T
T
p
D
O
X
p
g
O
O
O
O
O
D
M
k
n
J
B
W
W
W
W
W
L
u
H
W
B
u
T
T
T
T
T
T
"}
(15,1,1) = {"
T
T
T
T
T
T
p
O
O
O
x
O
O
O
O
O
O
O
e
w
n
o
W
W
W
W
W
W
W
G
W
W
W
u
T
T
T
T
T
T
"}
(16,1,1) = {"
T
T
T
T
T
T
p
O
O
O
x
O
O
O
O
O
O
O
e
w
w
o
W
W
W
W
W
W
W
G
W
W
W
u
T
T
T
T
T
T
"}
(17,1,1) = {"
T
T
T
T
T
T
p
D
O
V
p
g
O
O
O
O
O
D
e
n
n
o
B
W
W
W
W
W
L
u
t
W
B
u
T
T
T
T
T
T
"}
(18,1,1) = {"
T
T
T
T
T
T
p
D
D
p
p
p
p
p
p
p
p
p
P
n
Z
y
u
u
u
u
u
u
u
u
u
G
u
u
T
T
T
T
T
T
"}
(19,1,1) = {"
T
T
T
T
T
T
p
O
O
p
D
D
x
D
O
O
O
D
e
k
w
o
u
B
W
W
W
W
W
W
W
W
B
u
T
T
T
T
T
T
"}
(20,1,1) = {"
T
T
T
T
T
T
p
O
O
p
O
O
x
O
O
O
O
O
e
n
w
o
u
W
u
W
o
o
o
o
o
o
W
u
T
T
T
T
T
T
"}
(21,1,1) = {"
T
T
T
T
T
T
p
O
O
p
O
O
p
O
O
O
O
O
e
n
k
o
u
W
u
W
o
o
o
o
o
o
W
u
T
T
T
T
T
T
"}
(22,1,1) = {"
T
T
T
T
T
T
p
O
O
x
O
O
p
O
O
O
O
O
e
w
k
o
u
W
u
W
o
o
o
o
o
o
W
u
T
T
T
T
T
T
"}
(23,1,1) = {"
T
T
T
T
T
T
p
D
D
x
D
D
p
D
O
O
O
D
e
w
w
o
I
W
u
W
o
o
o
o
o
o
W
u
T
T
T
T
T
T
"}
(24,1,1) = {"
p
p
p
p
p
p
p
p
x
p
p
p
p
p
p
p
p
p
p
P
w
o
W
W
u
W
o
o
o
o
o
o
W
u
T
T
T
T
T
T
"}
(25,1,1) = {"
p
N
i
i
i
N
p
D
O
O
O
O
O
O
O
O
O
D
e
w
n
o
W
W
u
W
o
o
o
o
o
o
W
u
T
T
T
T
T
T
"}
(26,1,1) = {"
Q
i
i
i
i
i
f
O
O
O
O
O
O
U
O
O
O
O
e
n
n
o
u
W
u
W
o
o
o
o
o
o
W
u
T
T
T
T
T
T
"}
(27,1,1) = {"
C
i
i
i
i
i
O
O
O
O
O
O
O
U
O
O
O
O
e
n
k
o
u
W
u
W
o
o
o
o
o
o
W
u
T
T
T
T
T
T
"}
(28,1,1) = {"
v
i
i
i
i
i
O
O
O
O
O
O
O
U
O
O
O
O
e
n
k
o
u
W
u
W
o
o
o
o
o
o
W
u
T
T
T
T
T
T
"}
(29,1,1) = {"
p
N
i
i
i
N
p
D
O
O
O
O
O
O
O
O
O
D
e
n
k
o
u
B
W
W
W
W
W
W
W
W
B
u
T
T
T
T
T
T
"}
(30,1,1) = {"
p
p
p
p
p
p
p
p
p
p
p
p
p
p
p
p
p
p
p
p
u
u
u
u
u
u
u
u
u
u
u
u
u
u
T
T
T
T
T
T
"}
