//MAP CONVERTED BY dmm2tgm.py THIS HEADER COMMENT PREVENTS RECONVERSION, DO NOT REMOVE
"ae" = (
/obj/effect/turf_decal/is12{
	icon_state = "m4"
	},
/turf/open/floor/plating/is12/surface,
/area/violence)
"aK" = (
/obj/effect/landmark/start/combatant/red,
/turf/open/floor/plating/is12/wood,
/area/violence)
"bC" = (
/turf/closed/indestructible/riveted/boss,
/area/violence)
"dc" = (
/obj/effect/turf_decal/stripes/line{
	dir = 10
	},
/obj/effect/turf_decal/is12{
	icon_state = "wwi"
	},
/turf/open/floor/plating/is12/rock,
/area/violence)
"ek" = (
/obj/effect/turf_decal/stripes/line{
	dir = 4
	},
/obj/effect/turf_decal/is12{
	icon_state = "wwi"
	},
/turf/open/floor/plating/is12/rock,
/area/violence)
"fc" = (
/obj/structure/table,
/obj/effect/turf_decal/stripes/line{
	dir = 10
	},
/turf/open/floor/plating/is12/wood,
/area/violence)
"fi" = (
/obj/effect/turf_decal/is12{
	icon_state = "m2"
	},
/turf/open/floor/plating/is12/surface,
/area/violence)
"fx" = (
/obj/structure/table,
/obj/effect/turf_decal/stripes/line{
	dir = 5
	},
/turf/open/floor/plating/is12/wood,
/area/violence)
"fQ" = (
/obj/effect/turf_decal/is12{
	icon_state = "wwi"
	},
/turf/open/floor/plating/is12/trenchcenter,
/area/violence)
"fU" = (
/obj/effect/landmark/start/combatant/blue,
/turf/open/floor/plating/is12/wood,
/area/violence)
"fV" = (
/obj/effect/turf_decal/is12{
	icon_state = "wwi"
	},
/turf/open/floor/plating/is12/rock,
/area/violence)
"ga" = (
/obj/structure/bed/maint,
/obj/effect/turf_decal/stripes/line,
/turf/open/floor/plating/is12/wood,
/area/violence)
"gD" = (
/obj/effect/turf_decal/stripes/line{
	dir = 4
	},
/turf/open/floor/plating/is12/surface,
/area/violence)
"iK" = (
/obj/effect/turf_decal/stripes/line{
	dir = 1
	},
/obj/effect/turf_decal/is12{
	icon_state = "wwi"
	},
/turf/open/floor/plating/is12/rock,
/area/violence)
"iU" = (
/obj/effect/turf_decal/is12,
/turf/open/floor/plating/is12/surface,
/area/violence)
"jl" = (
/obj/effect/turf_decal/is12,
/obj/effect/turf_decal/is12{
	icon_state = "wwi"
	},
/turf/open/floor/plating/is12/rock,
/area/violence)
"ko" = (
/obj/effect/turf_decal/is12{
	icon_state = "m1"
	},
/turf/open/floor/plating/is12/surface,
/area/violence)
"ni" = (
/obj/structure/closet{
	anchored = 1
	},
/obj/effect/turf_decal/box,
/obj/effect/turf_decal/is12{
	icon_state = "wwi"
	},
/turf/open/floor/plating/is12/trenchcenter,
/area/violence)
"ri" = (
/obj/effect/turf_decal/stripes/line{
	dir = 5
	},
/turf/open/floor/plating/is12/wood,
/area/violence)
"sd" = (
/turf/closed/indestructible/necropolis,
/area/violence)
"ss" = (
/obj/effect/turf_decal/stripes/line{
	dir = 8
	},
/turf/open/floor/plating/is12/wood,
/area/violence)
"tw" = (
/obj/structure/closet{
	anchored = 1
	},
/obj/effect/turf_decal/box,
/obj/effect/turf_decal/is12{
	icon_state = "wwi"
	},
/obj/effect/landmark/observer_start,
/turf/open/floor/plating/is12/trenchcenter,
/area/violence)
"um" = (
/turf/open/floor/plating/is12/wood,
/area/violence)
"us" = (
/obj/effect/turf_decal/is12{
	icon_state = "wwi"
	},
/turf/closed/indestructible/riveted/dirtystone,
/area/violence)
"yj" = (
/obj/effect/turf_decal/stripes/line{
	dir = 10
	},
/turf/open/floor/plating/is12/surface,
/area/violence)
"yM" = (
/obj/effect/turf_decal/stripes/line{
	dir = 6
	},
/turf/open/floor/plating/is12/surface,
/area/violence)
"zg" = (
/obj/structure/table,
/obj/effect/turf_decal/is12{
	icon_state = "wwi"
	},
/turf/open/floor/plating/is12/trenchcenter,
/area/violence)
"AE" = (
/obj/effect/turf_decal/stripes/line,
/turf/open/floor/plating/is12/wood,
/area/violence)
"AK" = (
/obj/structure/table,
/obj/effect/turf_decal/stripes/line{
	dir = 9
	},
/turf/open/floor/plating/is12/wood,
/area/violence)
"AT" = (
/obj/effect/turf_decal/stripes/line{
	dir = 9
	},
/turf/open/floor/plating/is12/wood,
/area/violence)
"Bd" = (
/obj/effect/turf_decal/is12{
	icon_state = "grass"
	},
/turf/open/floor/plating/is12/surface,
/area/violence)
"Ce" = (
/obj/effect/turf_decal/stripes/line{
	dir = 1
	},
/turf/open/floor/plating/is12/wood,
/area/violence)
"Co" = (
/obj/effect/turf_decal/stripes/line{
	dir = 6
	},
/turf/open/floor/plating/is12/wood,
/area/violence)
"CB" = (
/turf/open/space/basic,
/area/space)
"CV" = (
/obj/effect/turf_decal/stripes/line{
	dir = 9
	},
/obj/effect/turf_decal/is12{
	icon_state = "wwi"
	},
/turf/open/floor/plating/is12/rock,
/area/violence)
"EJ" = (
/turf/open/floor/plating/is12/surface,
/area/violence)
"ER" = (
/obj/effect/turf_decal/stripes/line{
	dir = 8
	},
/turf/open/floor/plating/is12/surface,
/area/violence)
"Gr" = (
/obj/structure/table,
/obj/effect/turf_decal/stripes/line{
	dir = 6
	},
/turf/open/floor/plating/is12/wood,
/area/violence)
"GG" = (
/obj/effect/turf_decal/stripes/line{
	dir = 6
	},
/obj/effect/turf_decal/is12{
	icon_state = "wwi"
	},
/turf/open/floor/plating/is12/rock,
/area/violence)
"Hb" = (
/obj/effect/turf_decal/stripes/line{
	dir = 4
	},
/turf/open/floor/plating/is12/wood,
/area/violence)
"HM" = (
/obj/effect/turf_decal/stripes/line{
	dir = 9
	},
/turf/open/floor/plating/is12/surface,
/area/violence)
"IR" = (
/obj/structure/table,
/obj/effect/turf_decal/stripes/line{
	dir = 1
	},
/turf/open/floor/plating/is12/wood,
/area/violence)
"Jz" = (
/obj/structure/bed/maint,
/obj/effect/turf_decal/stripes/line{
	dir = 1
	},
/turf/open/floor/plating/is12/wood,
/area/violence)
"JC" = (
/obj/effect/turf_decal/stripes/line{
	dir = 5
	},
/obj/effect/turf_decal/is12{
	icon_state = "wwi"
	},
/turf/open/floor/plating/is12/rock,
/area/violence)
"JN" = (
/obj/machinery/door/poddoor,
/obj/effect/turf_decal/stripes/full,
/turf/open/floor/plating/is12/rock,
/area/violence)
"JT" = (
/obj/effect/turf_decal/is12{
	icon_state = "m3"
	},
/turf/open/floor/plating/is12/surface,
/area/violence)
"MO" = (
/obj/effect/turf_decal/stripes/line{
	dir = 5
	},
/turf/open/floor/plating/is12/surface,
/area/violence)
"OI" = (
/obj/effect/turf_decal/is12{
	icon_state = "dirtcornerleft"
	},
/obj/effect/turf_decal/is12{
	icon_state = "wwi"
	},
/turf/open/floor/plating/is12/rock,
/area/violence)
"OU" = (
/obj/effect/turf_decal/stripes/line{
	dir = 10
	},
/turf/open/floor/plating/is12/wood,
/area/violence)
"Rh" = (
/obj/effect/turf_decal/stripes/line,
/turf/open/floor/plating/is12/surface,
/area/violence)
"Rm" = (
/obj/effect/turf_decal/stripes/line{
	dir = 8
	},
/obj/effect/turf_decal/is12{
	icon_state = "wwi"
	},
/turf/open/floor/plating/is12/rock,
/area/violence)
"Rw" = (
/obj/effect/turf_decal/stripes/line,
/obj/effect/turf_decal/is12{
	icon_state = "wwi"
	},
/turf/open/floor/plating/is12/rock,
/area/violence)
"RY" = (
/obj/machinery/door/poddoor,
/obj/effect/turf_decal/stripes/full,
/turf/open/indestructible/boss/air,
/area/violence)
"Sa" = (
/obj/effect/turf_decal/stripes/full,
/turf/open/floor/plating/is12/surface,
/area/violence)
"TX" = (
/obj/effect/turf_decal/is12{
	icon_state = "dirtcornercenter"
	},
/obj/effect/turf_decal/is12{
	icon_state = "wwi"
	},
/turf/open/floor/plating/is12/rock,
/area/violence)
"UH" = (
/obj/effect/baseturf_helper/asteroid,
/turf/closed/indestructible/necropolis,
/area/violence)
"Wa" = (
/obj/effect/turf_decal/stripes/line{
	dir = 1
	},
/turf/open/floor/plating/is12/surface,
/area/violence)
"Xm" = (
/obj/structure/table,
/turf/open/floor/plating/is12/surface,
/area/violence)
"YA" = (
/obj/effect/turf_decal/is12{
	icon_state = "dirtcornerright"
	},
/obj/effect/turf_decal/is12{
	icon_state = "wwi"
	},
/turf/open/floor/plating/is12/rock,
/area/violence)
"ZD" = (
/obj/structure/table,
/obj/effect/turf_decal/stripes/line,
/turf/open/floor/plating/is12/wood,
/area/violence)

(1,1,1) = {"
CB
CB
CB
CB
CB
CB
CB
CB
CB
CB
CB
CB
CB
CB
CB
CB
CB
CB
CB
CB
CB
CB
CB
CB
CB
CB
CB
CB
CB
CB
CB
CB
CB
CB
CB
CB
CB
CB
CB
CB
CB
CB
CB
CB
CB
CB
CB
CB
CB
CB
"}
(2,1,1) = {"
CB
CB
CB
CB
CB
CB
CB
CB
CB
CB
CB
CB
CB
CB
CB
CB
CB
CB
CB
CB
CB
CB
CB
CB
CB
CB
CB
CB
CB
CB
CB
CB
CB
CB
CB
CB
CB
CB
CB
CB
CB
CB
CB
CB
CB
CB
CB
CB
CB
CB
"}
(3,1,1) = {"
CB
CB
CB
CB
CB
CB
CB
CB
CB
CB
CB
CB
CB
CB
CB
CB
CB
CB
CB
CB
CB
CB
CB
CB
CB
CB
CB
CB
CB
CB
CB
CB
CB
CB
CB
CB
CB
CB
CB
CB
CB
CB
CB
CB
CB
CB
CB
CB
CB
CB
"}
(4,1,1) = {"
CB
CB
CB
CB
CB
CB
CB
CB
CB
CB
CB
CB
CB
CB
CB
CB
CB
CB
CB
CB
CB
CB
CB
CB
CB
CB
CB
CB
CB
CB
CB
CB
CB
CB
CB
CB
CB
CB
CB
CB
CB
CB
CB
CB
CB
CB
CB
CB
CB
CB
"}
(5,1,1) = {"
CB
CB
CB
CB
CB
CB
CB
CB
CB
CB
CB
CB
CB
CB
CB
CB
CB
CB
CB
CB
CB
CB
CB
CB
CB
CB
CB
CB
CB
CB
CB
CB
CB
CB
CB
CB
CB
CB
CB
CB
CB
CB
CB
CB
CB
CB
CB
CB
CB
CB
"}
(6,1,1) = {"
CB
CB
CB
CB
CB
CB
CB
CB
CB
CB
CB
CB
CB
CB
CB
CB
CB
CB
CB
CB
CB
CB
CB
CB
CB
CB
CB
CB
CB
CB
CB
CB
CB
CB
CB
CB
CB
CB
CB
CB
CB
CB
CB
CB
CB
CB
CB
CB
CB
CB
"}
(7,1,1) = {"
CB
CB
CB
CB
CB
CB
CB
CB
CB
CB
CB
CB
CB
CB
CB
CB
CB
CB
CB
CB
CB
CB
CB
CB
CB
CB
CB
CB
CB
CB
CB
CB
CB
CB
CB
CB
CB
CB
CB
CB
CB
CB
CB
CB
CB
CB
CB
CB
CB
CB
"}
(8,1,1) = {"
CB
CB
CB
CB
CB
CB
CB
CB
CB
CB
CB
CB
CB
CB
CB
CB
CB
CB
CB
CB
CB
CB
CB
CB
CB
CB
CB
CB
CB
CB
CB
CB
CB
CB
CB
CB
CB
CB
CB
CB
CB
CB
CB
CB
CB
CB
CB
CB
CB
CB
"}
(9,1,1) = {"
CB
CB
CB
CB
CB
CB
CB
CB
CB
CB
CB
CB
CB
CB
CB
CB
CB
CB
CB
CB
CB
CB
CB
CB
CB
CB
CB
CB
CB
CB
CB
CB
CB
CB
CB
CB
CB
CB
CB
CB
CB
CB
CB
CB
CB
CB
CB
CB
CB
CB
"}
(10,1,1) = {"
CB
CB
CB
CB
CB
CB
CB
CB
CB
CB
CB
CB
CB
CB
CB
CB
CB
CB
CB
CB
CB
CB
CB
CB
CB
CB
CB
CB
CB
CB
CB
CB
CB
CB
CB
CB
CB
CB
CB
CB
CB
CB
CB
CB
CB
CB
CB
CB
CB
CB
"}
(11,1,1) = {"
CB
CB
CB
CB
CB
CB
CB
sd
sd
sd
sd
sd
sd
sd
sd
sd
sd
sd
sd
sd
sd
sd
sd
sd
sd
sd
sd
sd
sd
sd
sd
sd
sd
sd
sd
sd
sd
sd
sd
sd
sd
sd
UH
CB
CB
CB
CB
CB
CB
CB
"}
(12,1,1) = {"
CB
CB
CB
CB
CB
CB
CB
sd
HM
ER
ER
ER
ER
ER
ER
ER
ER
ER
ER
ER
ER
ER
ER
ER
ER
ER
ER
ER
ER
ER
ER
ER
ER
ER
ER
ER
ER
ER
ER
ER
ER
yj
sd
CB
CB
CB
CB
CB
CB
CB
"}
(13,1,1) = {"
CB
CB
CB
CB
CB
CB
CB
sd
Wa
EJ
EJ
Xm
EJ
EJ
iU
EJ
EJ
EJ
EJ
ae
JT
EJ
EJ
EJ
EJ
EJ
EJ
EJ
EJ
EJ
EJ
EJ
EJ
iU
EJ
EJ
EJ
EJ
Xm
EJ
EJ
Rh
sd
CB
CB
CB
CB
CB
CB
CB
"}
(14,1,1) = {"
CB
CB
CB
CB
CB
CB
CB
sd
Wa
EJ
EJ
Xm
EJ
EJ
EJ
EJ
Bd
EJ
EJ
fi
ko
EJ
Xm
Xm
Xm
Xm
Xm
Xm
EJ
EJ
EJ
EJ
EJ
EJ
Bd
EJ
EJ
EJ
Xm
EJ
EJ
Rh
sd
CB
CB
CB
CB
CB
CB
CB
"}
(15,1,1) = {"
CB
CB
CB
CB
CB
CB
CB
sd
Wa
EJ
EJ
Xm
EJ
EJ
EJ
EJ
EJ
EJ
EJ
EJ
EJ
EJ
EJ
EJ
EJ
EJ
EJ
EJ
EJ
EJ
EJ
EJ
EJ
EJ
EJ
EJ
EJ
EJ
Xm
EJ
EJ
Rh
sd
CB
CB
CB
CB
CB
CB
CB
"}
(16,1,1) = {"
CB
CB
CB
CB
CB
CB
CB
sd
MO
gD
gD
gD
gD
gD
gD
gD
gD
gD
gD
gD
gD
gD
gD
gD
gD
gD
gD
gD
gD
gD
gD
gD
gD
gD
gD
gD
gD
gD
gD
gD
gD
yM
sd
CB
CB
CB
CB
CB
CB
CB
"}
(17,1,1) = {"
CB
CB
CB
CB
CB
CB
CB
sd
sd
Sa
Sa
sd
sd
sd
sd
sd
sd
sd
sd
sd
sd
sd
sd
sd
Sa
Sa
sd
sd
sd
sd
sd
sd
sd
sd
sd
sd
sd
sd
sd
Sa
Sa
sd
sd
CB
CB
CB
CB
CB
CB
CB
"}
(18,1,1) = {"
CB
CB
CB
CB
CB
CB
bC
bC
bC
RY
RY
bC
bC
bC
bC
bC
bC
bC
bC
bC
bC
bC
bC
bC
JN
JN
bC
bC
bC
bC
bC
bC
bC
bC
bC
bC
bC
bC
bC
RY
RY
bC
bC
bC
CB
CB
CB
CB
CB
CB
"}
(19,1,1) = {"
CB
CB
CB
CB
CB
CB
bC
AK
ss
ss
ss
OU
bC
CV
Rm
Rm
Rm
Rm
Rm
Rm
Rm
Rm
Rm
Rm
Rm
Rm
Rm
Rm
Rm
Rm
Rm
Rm
Rm
Rm
Rm
Rm
dc
bC
AT
ss
ss
ss
fc
bC
CB
CB
CB
CB
CB
CB
"}
(20,1,1) = {"
CB
CB
CB
CB
CB
CB
bC
Jz
aK
um
um
AE
bC
iK
fV
fV
fV
fV
fV
fV
fV
fV
fV
fV
fV
fV
fV
fV
fV
fV
fV
fV
fV
jl
fV
fV
Rw
bC
Ce
um
um
fU
ga
bC
CB
CB
CB
CB
CB
CB
"}
(21,1,1) = {"
CB
CB
CB
CB
CB
CB
bC
IR
um
um
um
AE
bC
iK
OI
us
us
us
us
us
us
us
us
us
zg
zg
us
us
us
us
us
us
us
us
us
fV
Rw
bC
Ce
um
um
um
ZD
bC
CB
CB
CB
CB
CB
CB
"}
(22,1,1) = {"
CB
CB
CB
CB
CB
CB
bC
Ce
um
um
um
AE
bC
iK
TX
us
fQ
fQ
fQ
fQ
fQ
fQ
fQ
fQ
fQ
fQ
fQ
fQ
fQ
fQ
fQ
fQ
fQ
fQ
us
fV
Rw
bC
Ce
um
um
um
AE
bC
CB
CB
CB
CB
CB
CB
"}
(23,1,1) = {"
CB
CB
CB
CB
CB
CB
bC
Ce
aK
um
um
AE
bC
iK
TX
zg
fQ
zg
zg
ni
ni
ni
ni
ni
ni
ni
ni
ni
ni
ni
ni
zg
zg
fQ
zg
fV
Rw
bC
Ce
um
um
fU
AE
bC
CB
CB
CB
CB
CB
CB
"}
(24,1,1) = {"
CB
CB
CB
CB
CB
CB
bC
IR
um
um
um
AE
JN
iK
TX
us
fQ
zg
fQ
fQ
fQ
fQ
fQ
fQ
fQ
fQ
fQ
fQ
fQ
fQ
fQ
fQ
zg
fQ
us
fV
Rw
JN
Ce
um
um
um
ZD
bC
CB
CB
CB
CB
CB
CB
"}
(25,1,1) = {"
CB
CB
CB
CB
CB
CB
bC
Jz
um
um
um
AE
JN
iK
TX
us
fQ
ni
fQ
ni
ni
ni
ni
ni
tw
ni
ni
ni
ni
ni
ni
fQ
ni
fQ
us
fV
Rw
JN
Ce
um
um
um
ga
bC
CB
CB
CB
CB
CB
CB
"}
(26,1,1) = {"
CB
CB
CB
CB
CB
CB
bC
IR
um
um
um
AE
JN
iK
TX
us
fQ
zg
fQ
fQ
fQ
fQ
fQ
fQ
fQ
fQ
fQ
fQ
fQ
fQ
fQ
fQ
zg
fQ
us
fV
Rw
JN
Ce
um
um
um
ZD
bC
CB
CB
CB
CB
CB
CB
"}
(27,1,1) = {"
CB
CB
CB
CB
CB
CB
bC
Ce
aK
um
um
AE
bC
iK
TX
zg
fQ
zg
zg
ni
ni
ni
ni
ni
ni
ni
ni
ni
ni
ni
ni
zg
zg
fQ
zg
fV
Rw
bC
Ce
um
um
fU
AE
bC
CB
CB
CB
CB
CB
CB
"}
(28,1,1) = {"
CB
CB
CB
CB
CB
CB
bC
Ce
um
um
um
AE
bC
iK
TX
us
fQ
fQ
fQ
fQ
fQ
fQ
fQ
fQ
fQ
fQ
fQ
fQ
fQ
fQ
fQ
fQ
fQ
fQ
us
fV
Rw
bC
Ce
um
um
um
AE
bC
CB
CB
CB
CB
CB
CB
"}
(29,1,1) = {"
CB
CB
CB
CB
CB
CB
bC
IR
um
um
um
AE
bC
iK
YA
us
us
us
us
us
us
us
us
us
zg
zg
us
us
us
us
us
us
us
us
us
fV
Rw
bC
Ce
um
um
um
ZD
bC
CB
CB
CB
CB
CB
CB
"}
(30,1,1) = {"
CB
CB
CB
CB
CB
CB
bC
Jz
aK
um
um
AE
bC
iK
fV
fV
fV
fV
fV
fV
fV
fV
fV
fV
fV
fV
fV
fV
fV
fV
fV
fV
fV
fV
fV
fV
Rw
bC
Ce
um
um
fU
ga
bC
CB
CB
CB
CB
CB
CB
"}
(31,1,1) = {"
CB
CB
CB
CB
CB
CB
bC
fx
Hb
Hb
Hb
Co
bC
JC
ek
ek
ek
ek
ek
ek
ek
ek
ek
ek
ek
ek
ek
ek
ek
ek
ek
ek
ek
ek
ek
ek
GG
bC
ri
Hb
Hb
Hb
Gr
bC
CB
CB
CB
CB
CB
CB
"}
(32,1,1) = {"
CB
CB
CB
CB
CB
CB
bC
bC
bC
RY
RY
bC
bC
bC
bC
bC
bC
bC
bC
bC
bC
bC
bC
bC
JN
JN
bC
bC
bC
bC
bC
bC
bC
bC
bC
bC
bC
bC
bC
RY
RY
bC
bC
bC
CB
CB
CB
CB
CB
CB
"}
(33,1,1) = {"
CB
CB
CB
CB
CB
CB
CB
sd
sd
Sa
Sa
sd
sd
sd
sd
sd
sd
sd
sd
sd
sd
sd
sd
sd
Sa
Sa
sd
sd
sd
sd
sd
sd
sd
sd
sd
sd
sd
sd
sd
Sa
Sa
sd
sd
CB
CB
CB
CB
CB
CB
CB
"}
(34,1,1) = {"
CB
CB
CB
CB
CB
CB
CB
sd
HM
ER
ER
ER
ER
ER
ER
ER
ER
ER
ER
ER
ER
ER
ER
ER
ER
ER
ER
ER
ER
ER
ER
ER
ER
ER
ER
ER
ER
ER
ER
ER
ER
yj
sd
CB
CB
CB
CB
CB
CB
CB
"}
(35,1,1) = {"
CB
CB
CB
CB
CB
CB
CB
sd
Wa
EJ
EJ
Xm
EJ
EJ
EJ
EJ
EJ
EJ
EJ
EJ
EJ
EJ
EJ
EJ
EJ
EJ
EJ
EJ
EJ
EJ
EJ
EJ
EJ
EJ
EJ
EJ
EJ
EJ
Xm
EJ
EJ
Rh
sd
CB
CB
CB
CB
CB
CB
CB
"}
(36,1,1) = {"
CB
CB
CB
CB
CB
CB
CB
sd
Wa
EJ
EJ
Xm
EJ
EJ
EJ
iU
EJ
EJ
EJ
EJ
EJ
EJ
Xm
Xm
Xm
Xm
Xm
Xm
EJ
EJ
EJ
EJ
iU
EJ
EJ
ae
JT
EJ
Xm
EJ
EJ
Rh
sd
CB
CB
CB
CB
CB
CB
CB
"}
(37,1,1) = {"
CB
CB
CB
CB
CB
CB
CB
sd
Wa
EJ
EJ
Xm
EJ
EJ
EJ
EJ
EJ
Bd
EJ
EJ
EJ
EJ
EJ
EJ
EJ
EJ
EJ
EJ
EJ
Bd
EJ
EJ
EJ
EJ
EJ
fi
ko
EJ
Xm
EJ
EJ
Rh
sd
CB
CB
CB
CB
CB
CB
CB
"}
(38,1,1) = {"
CB
CB
CB
CB
CB
CB
CB
sd
MO
gD
gD
gD
gD
gD
gD
gD
gD
gD
gD
gD
gD
gD
gD
gD
gD
gD
gD
gD
gD
gD
gD
gD
gD
gD
gD
gD
gD
gD
gD
gD
gD
yM
sd
CB
CB
CB
CB
CB
CB
CB
"}
(39,1,1) = {"
CB
CB
CB
CB
CB
CB
CB
sd
sd
sd
sd
sd
sd
sd
sd
sd
sd
sd
sd
sd
sd
sd
sd
sd
sd
sd
sd
sd
sd
sd
sd
sd
sd
sd
sd
sd
sd
sd
sd
sd
sd
sd
sd
CB
CB
CB
CB
CB
CB
CB
"}
(40,1,1) = {"
CB
CB
CB
CB
CB
CB
CB
CB
CB
CB
CB
CB
CB
CB
CB
CB
CB
CB
CB
CB
CB
CB
CB
CB
CB
CB
CB
CB
CB
CB
CB
CB
CB
CB
CB
CB
CB
CB
CB
CB
CB
CB
CB
CB
CB
CB
CB
CB
CB
CB
"}
(41,1,1) = {"
CB
CB
CB
CB
CB
CB
CB
CB
CB
CB
CB
CB
CB
CB
CB
CB
CB
CB
CB
CB
CB
CB
CB
CB
CB
CB
CB
CB
CB
CB
CB
CB
CB
CB
CB
CB
CB
CB
CB
CB
CB
CB
CB
CB
CB
CB
CB
CB
CB
CB
"}
(42,1,1) = {"
CB
CB
CB
CB
CB
CB
CB
CB
CB
CB
CB
CB
CB
CB
CB
CB
CB
CB
CB
CB
CB
CB
CB
CB
CB
CB
CB
CB
CB
CB
CB
CB
CB
CB
CB
CB
CB
CB
CB
CB
CB
CB
CB
CB
CB
CB
CB
CB
CB
CB
"}
(43,1,1) = {"
CB
CB
CB
CB
CB
CB
CB
CB
CB
CB
CB
CB
CB
CB
CB
CB
CB
CB
CB
CB
CB
CB
CB
CB
CB
CB
CB
CB
CB
CB
CB
CB
CB
CB
CB
CB
CB
CB
CB
CB
CB
CB
CB
CB
CB
CB
CB
CB
CB
CB
"}
(44,1,1) = {"
CB
CB
CB
CB
CB
CB
CB
CB
CB
CB
CB
CB
CB
CB
CB
CB
CB
CB
CB
CB
CB
CB
CB
CB
CB
CB
CB
CB
CB
CB
CB
CB
CB
CB
CB
CB
CB
CB
CB
CB
CB
CB
CB
CB
CB
CB
CB
CB
CB
CB
"}
(45,1,1) = {"
CB
CB
CB
CB
CB
CB
CB
CB
CB
CB
CB
CB
CB
CB
CB
CB
CB
CB
CB
CB
CB
CB
CB
CB
CB
CB
CB
CB
CB
CB
CB
CB
CB
CB
CB
CB
CB
CB
CB
CB
CB
CB
CB
CB
CB
CB
CB
CB
CB
CB
"}
(46,1,1) = {"
CB
CB
CB
CB
CB
CB
CB
CB
CB
CB
CB
CB
CB
CB
CB
CB
CB
CB
CB
CB
CB
CB
CB
CB
CB
CB
CB
CB
CB
CB
CB
CB
CB
CB
CB
CB
CB
CB
CB
CB
CB
CB
CB
CB
CB
CB
CB
CB
CB
CB
"}
(47,1,1) = {"
CB
CB
CB
CB
CB
CB
CB
CB
CB
CB
CB
CB
CB
CB
CB
CB
CB
CB
CB
CB
CB
CB
CB
CB
CB
CB
CB
CB
CB
CB
CB
CB
CB
CB
CB
CB
CB
CB
CB
CB
CB
CB
CB
CB
CB
CB
CB
CB
CB
CB
"}
(48,1,1) = {"
CB
CB
CB
CB
CB
CB
CB
CB
CB
CB
CB
CB
CB
CB
CB
CB
CB
CB
CB
CB
CB
CB
CB
CB
CB
CB
CB
CB
CB
CB
CB
CB
CB
CB
CB
CB
CB
CB
CB
CB
CB
CB
CB
CB
CB
CB
CB
CB
CB
CB
"}
(49,1,1) = {"
CB
CB
CB
CB
CB
CB
CB
CB
CB
CB
CB
CB
CB
CB
CB
CB
CB
CB
CB
CB
CB
CB
CB
CB
CB
CB
CB
CB
CB
CB
CB
CB
CB
CB
CB
CB
CB
CB
CB
CB
CB
CB
CB
CB
CB
CB
CB
CB
CB
CB
"}
(50,1,1) = {"
CB
CB
CB
CB
CB
CB
CB
CB
CB
CB
CB
CB
CB
CB
CB
CB
CB
CB
CB
CB
CB
CB
CB
CB
CB
CB
CB
CB
CB
CB
CB
CB
CB
CB
CB
CB
CB
CB
CB
CB
CB
CB
CB
CB
CB
CB
CB
CB
CB
CB
"}
