//MAP CONVERTED BY dmm2tgm.py THIS HEADER COMMENT PREVENTS RECONVERSION, DO NOT REMOVE
"a" = (
/turf/open/chasm/lavaland,
/area/violence)
"b" = (
/obj/effect/spawner/structure/window/reinforced,
/turf/open/floor/plating,
/area/violence)
"f" = (
/obj/structure/reflector/single/mapping{
	dir = 5
	},
/turf/open/floor/plasteel/elevatorshaft,
/area/violence)
"h" = (
/obj/effect/landmark/start/combatant/blue,
/turf/open/floor/plasteel/bluespace,
/area/violence)
"j" = (
/turf/open/floor/plasteel/bluespace,
/area/violence)
"m" = (
/obj/structure/reflector/single/mapping{
	dir = 8
	},
/turf/open/floor/plasteel/elevatorshaft,
/area/violence)
"n" = (
/obj/effect/spawner/structure/window/reinforced,
/obj/machinery/door/poddoor/multi_tile/four_tile_hor{
	resistance_flags = 115
	},
/turf/open/floor/plating,
/area/violence)
"o" = (
/obj/effect/spawner/structure/window/reinforced,
/obj/machinery/door/poddoor/multi_tile/four_tile_ver{
	resistance_flags = 115
	},
/turf/open/floor/plating,
/area/violence)
"p" = (
/obj/effect/landmark/start/combatant/red,
/turf/open/floor/plasteel/bluespace,
/area/violence)
"s" = (
/turf/open/floor/light/colour_cycle/dancefloor_a,
/area/violence)
"v" = (
/turf/closed/indestructible/black,
/area/violence)
"x" = (
/obj/effect/turf_decal/box/red/corners{
	dir = 4
	},
/turf/open/floor/plasteel/bluespace,
/area/violence)
"y" = (
/obj/structure/reflector/double/mapping{
	dir = 5
	},
/turf/open/floor/plasteel/bluespace,
/area/violence)
"A" = (
/obj/effect/turf_decal/box/red/corners{
	dir = 1
	},
/turf/open/floor/plasteel/bluespace,
/area/violence)
"C" = (
/obj/structure/reflector/single/mapping{
	dir = 10
	},
/turf/open/floor/plasteel/elevatorshaft,
/area/violence)
"E" = (
/obj/effect/turf_decal/box/red,
/obj/effect/landmark/bomb_plant_location,
/turf/open/floor/plasteel/bluespace,
/area/violence)
"G" = (
/obj/structure/reflector/single/mapping{
	dir = 4
	},
/turf/open/floor/plasteel/elevatorshaft,
/area/violence)
"H" = (
/turf/closed/wall/r_wall,
/area/violence)
"J" = (
/obj/effect/turf_decal/box/red/corners,
/turf/open/floor/plasteel/bluespace,
/area/violence)
"K" = (
/obj/structure/reflector/double/mapping{
	dir = 10
	},
/turf/open/floor/plasteel/bluespace,
/area/violence)
"M" = (
/obj/effect/turf_decal/box/red/corners{
	dir = 8
	},
/turf/open/floor/plasteel/bluespace,
/area/violence)
"O" = (
/turf/open/floor/light/colour_cycle/dancefloor_b,
/area/violence)
"R" = (
/obj/structure/reflector/single/mapping{
	dir = 6
	},
/turf/open/floor/plasteel/elevatorshaft,
/area/violence)
"S" = (
/obj/effect/baseturf_helper/dune,
/turf/closed/indestructible/black,
/area/violence)
"T" = (
/obj/structure/reflector/single/mapping{
	dir = 9
	},
/turf/open/floor/plasteel/elevatorshaft,
/area/violence)
"U" = (
/turf/closed/wall,
/area/violence)

(1,1,1) = {"
S
v
v
v
v
v
v
v
v
v
v
v
v
v
v
v
v
v
v
v
v
v
v
v
v
v
v
v
v
v
v
v
v
v
v
v
v
v
v
v
"}
(2,1,1) = {"
v
U
U
U
U
U
U
U
U
U
U
U
U
U
U
U
U
U
U
U
U
U
U
U
U
U
U
U
U
U
U
U
U
U
U
U
U
U
U
v
"}
(3,1,1) = {"
v
U
a
a
a
a
a
a
a
a
a
a
a
a
a
a
a
a
a
a
a
a
a
a
a
a
a
a
a
a
a
a
a
a
a
a
a
a
U
v
"}
(4,1,1) = {"
v
U
a
R
a
a
a
a
a
a
a
a
a
a
a
G
a
a
a
a
a
a
a
a
G
a
a
a
a
a
a
a
a
a
a
a
f
a
U
v
"}
(5,1,1) = {"
v
U
a
a
a
a
a
a
a
a
a
a
a
a
a
a
a
a
a
a
a
a
a
a
a
a
a
a
a
a
a
a
a
a
a
a
a
a
U
v
"}
(6,1,1) = {"
v
U
a
a
a
H
b
b
b
b
H
a
a
H
b
b
b
b
H
a
a
H
b
b
b
b
H
a
a
H
b
b
b
o
H
a
a
a
U
v
"}
(7,1,1) = {"
v
U
a
a
a
b
j
j
j
j
b
a
a
b
j
j
j
j
b
a
a
b
j
j
j
j
b
a
a
n
p
p
p
p
n
a
a
a
U
v
"}
(8,1,1) = {"
v
U
a
a
a
H
j
j
j
j
b
a
a
b
j
j
j
j
b
a
a
b
j
j
j
j
b
a
a
b
p
p
p
p
b
a
a
a
U
v
"}
(9,1,1) = {"
v
U
a
a
a
H
j
j
j
j
b
a
a
b
j
j
j
j
b
a
a
b
j
j
j
j
b
a
a
b
p
p
p
p
b
a
a
a
U
v
"}
(10,1,1) = {"
v
U
a
a
a
b
j
j
j
j
b
a
a
b
j
j
j
j
b
a
a
b
j
j
j
j
b
a
a
b
p
p
p
p
b
a
a
a
U
v
"}
(11,1,1) = {"
v
U
a
a
a
H
b
b
b
b
H
a
a
H
b
b
b
b
H
a
a
H
b
H
H
b
H
a
a
H
b
b
b
o
H
a
a
a
U
v
"}
(12,1,1) = {"
v
U
a
a
a
a
a
a
a
a
a
a
a
a
a
a
a
a
a
a
a
a
a
a
G
a
a
a
a
a
a
a
a
a
a
a
a
a
U
v
"}
(13,1,1) = {"
v
U
a
a
a
a
a
a
R
a
a
a
a
a
a
a
a
a
a
a
a
a
a
a
a
a
a
a
a
a
a
f
a
a
a
a
a
a
U
v
"}
(14,1,1) = {"
v
U
a
a
a
a
a
a
a
a
a
a
a
a
a
a
a
a
a
a
a
a
a
a
a
a
a
a
a
a
a
a
a
a
a
a
a
a
U
v
"}
(15,1,1) = {"
v
U
a
a
a
H
b
b
b
b
H
a
a
H
b
b
b
b
H
b
b
H
b
b
b
b
H
a
a
H
b
b
b
b
H
a
a
a
U
v
"}
(16,1,1) = {"
v
U
a
a
a
H
j
j
j
j
H
a
a
H
j
j
j
j
H
s
O
H
j
j
j
j
H
a
a
H
j
j
j
j
H
a
a
a
U
v
"}
(17,1,1) = {"
v
U
a
a
a
H
j
j
j
j
H
a
a
H
j
j
j
j
b
O
s
b
j
j
j
j
H
a
a
H
j
j
j
j
H
a
a
a
U
v
"}
(18,1,1) = {"
v
U
a
a
a
H
j
j
j
j
H
a
a
H
j
j
j
j
b
s
O
b
j
j
j
j
H
a
a
H
j
j
j
j
H
a
a
a
U
v
"}
(19,1,1) = {"
v
U
a
a
a
H
j
j
j
j
H
a
a
H
j
y
j
j
H
O
s
H
j
j
j
j
H
a
f
H
j
j
j
j
H
a
a
a
U
v
"}
(20,1,1) = {"
v
U
a
a
a
b
j
j
j
j
b
a
a
b
j
j
j
j
b
s
O
b
j
j
j
j
b
a
a
b
j
j
j
j
b
a
T
a
U
v
"}
(21,1,1) = {"
v
U
a
R
a
b
j
j
j
j
b
a
a
b
j
j
j
j
b
O
s
b
j
j
j
j
b
a
a
b
j
j
j
j
b
a
a
a
U
v
"}
(22,1,1) = {"
v
U
a
a
a
H
j
j
j
j
H
C
a
H
j
j
j
j
H
s
O
H
j
j
K
j
H
a
a
H
j
j
j
j
H
a
a
a
U
v
"}
(23,1,1) = {"
v
U
a
a
a
H
j
j
j
j
H
a
a
H
J
j
x
j
b
O
s
b
j
j
j
j
H
a
a
H
j
j
j
j
H
a
a
a
U
v
"}
(24,1,1) = {"
v
U
a
a
a
H
j
j
j
j
H
a
a
H
j
E
j
j
b
s
O
b
j
j
j
j
H
a
a
H
j
j
j
j
H
a
a
a
U
v
"}
(25,1,1) = {"
v
U
a
a
a
H
j
j
j
j
H
a
a
H
M
j
A
j
H
O
s
H
j
j
j
j
H
a
a
H
j
j
j
j
H
a
a
a
U
v
"}
(26,1,1) = {"
v
U
a
a
a
H
b
b
b
b
H
a
a
H
b
b
b
b
H
b
b
H
b
b
b
b
H
a
a
H
b
b
b
b
H
a
a
a
U
v
"}
(27,1,1) = {"
v
U
a
a
a
a
a
a
a
a
a
a
a
a
a
a
a
a
a
a
a
a
a
a
a
a
a
a
a
a
a
a
a
a
a
a
a
a
U
v
"}
(28,1,1) = {"
v
U
a
a
a
a
a
a
C
a
a
a
a
a
a
a
a
a
a
a
a
a
a
a
a
a
a
a
a
a
a
T
a
a
a
a
a
a
U
v
"}
(29,1,1) = {"
v
U
a
a
a
a
a
a
a
a
a
a
a
a
a
m
a
a
a
a
a
a
a
a
a
a
a
a
a
a
a
a
a
a
a
a
a
a
U
v
"}
(30,1,1) = {"
v
U
a
a
a
H
b
b
b
o
H
a
a
H
b
H
H
b
H
a
a
H
b
b
b
b
H
a
a
H
b
b
b
b
H
a
a
a
U
v
"}
(31,1,1) = {"
v
U
a
a
a
n
h
h
h
h
n
a
a
b
j
j
j
j
b
a
a
b
j
j
j
j
b
a
a
b
j
j
j
j
b
a
a
a
U
v
"}
(32,1,1) = {"
v
U
a
a
a
b
h
h
h
h
b
a
a
b
j
j
j
j
b
a
a
b
j
j
j
j
b
a
a
b
j
j
j
j
H
a
a
a
U
v
"}
(33,1,1) = {"
v
U
a
a
a
b
h
h
h
h
b
a
a
b
j
j
j
j
b
a
a
b
j
j
j
j
b
a
a
b
j
j
j
j
H
a
a
a
U
v
"}
(34,1,1) = {"
v
U
a
a
a
b
h
h
h
h
b
a
a
b
j
j
j
j
b
a
a
b
j
j
j
j
b
a
a
b
j
j
j
j
b
a
a
a
U
v
"}
(35,1,1) = {"
v
U
a
a
a
H
b
b
b
o
H
a
a
H
b
b
b
b
H
a
a
H
b
b
b
b
H
a
a
H
b
b
b
b
H
a
a
a
U
v
"}
(36,1,1) = {"
v
U
a
a
a
a
a
a
a
a
a
a
a
a
a
a
a
a
a
a
a
a
a
a
a
a
a
a
a
a
a
a
a
a
a
a
a
a
U
v
"}
(37,1,1) = {"
v
U
a
C
a
a
a
a
a
a
a
a
a
a
a
m
a
a
a
a
a
a
a
a
m
a
a
a
a
a
a
a
a
a
a
a
T
a
U
v
"}
(38,1,1) = {"
v
U
a
a
a
a
a
a
a
a
a
a
a
a
a
a
a
a
a
a
a
a
a
a
a
a
a
a
a
a
a
a
a
a
a
a
a
a
U
v
"}
(39,1,1) = {"
v
U
U
U
U
U
U
U
U
U
U
U
U
U
U
U
U
U
U
U
U
U
U
U
U
U
U
U
U
U
U
U
U
U
U
U
U
U
U
v
"}
(40,1,1) = {"
v
v
v
v
v
v
v
v
v
v
v
v
v
v
v
v
v
v
v
v
v
v
v
v
v
v
v
v
v
v
v
v
v
v
v
v
v
v
v
v
"}
