//MAP CONVERTED BY dmm2tgm.py THIS HEADER COMMENT PREVENTS RECONVERSION, DO NOT REMOVE
"ao" = (
/obj/effect/landmark/start/combatant/red,
/obj/effect/turf_decal/siding/wood{
	dir = 1
	},
/turf/open/floor/plasteel/monofloor/white,
/area/violence)
"aI" = (
/obj/structure/punji_sticks,
/turf/open/water,
/area/violence)
"be" = (
/obj/machinery/door/poddoor/multi_tile/two_tile_ver{
	resistance_flags = 115
	},
/obj/effect/turf_decal/siding/wood{
	dir = 1
	},
/turf/open/floor/plasteel/monofloor/white,
/area/violence)
"bz" = (
/obj/effect/landmark/start/combatant/red,
/obj/effect/turf_decal/siding/wood{
	dir = 8
	},
/turf/open/floor/plasteel/monofloor/white,
/area/violence)
"bA" = (
/turf/open/floor/plasteel/monofloor/white,
/area/violence)
"cd" = (
/obj/structure/deployable_barricade/wooden{
	dir = 4
	},
/turf/open/floor/plasteel/monofloor/white,
/area/violence)
"cm" = (
/obj/structure/deployable_barricade/wooden,
/obj/effect/turf_decal/siding/wood{
	dir = 4
	},
/turf/open/floor/plasteel/monofloor/white,
/area/violence)
"cn" = (
/obj/effect/landmark/start/combatant/blue,
/obj/effect/turf_decal/siding/wood{
	dir = 5
	},
/turf/open/floor/plasteel/monofloor/white,
/area/violence)
"cD" = (
/turf/closed/wall/mineral/bamboo,
/area/violence)
"cN" = (
/obj/effect/turf_decal/siding/wood{
	dir = 4
	},
/turf/open/floor/plasteel/monofloor/white,
/area/violence)
"cZ" = (
/turf/open/floor/plasteel/monofloor/dark,
/area/violence)
"dZ" = (
/obj/structure/railing,
/turf/open/floor/bamboo,
/area/violence)
"ez" = (
/obj/effect/baseturf_helper/beach/water,
/turf/closed/indestructible/black,
/area/violence)
"fj" = (
/obj/structure/window/paperframe,
/obj/structure/railing{
	dir = 4
	},
/turf/open/floor/wood,
/area/violence)
"fx" = (
/obj/structure/railing/corner{
	dir = 4
	},
/turf/open/floor/bamboo,
/area/violence)
"fR" = (
/obj/structure/railing{
	dir = 4
	},
/turf/open/floor/bamboo,
/area/violence)
"gc" = (
/obj/structure/window/paperframe,
/obj/structure/railing,
/turf/open/floor/bamboo,
/area/violence)
"hY" = (
/obj/structure/railing,
/obj/structure/lattice/catwalk,
/turf/open/water,
/area/violence)
"it" = (
/obj/structure/railing{
	dir = 1
	},
/obj/structure/lattice/catwalk,
/turf/open/water,
/area/violence)
"iy" = (
/obj/effect/landmark/start/combatant/blue,
/obj/effect/turf_decal/siding/wood,
/turf/open/floor/plasteel/monofloor/white,
/area/violence)
"iS" = (
/obj/structure/deployable_barricade/wooden,
/obj/effect/turf_decal/siding/wood{
	dir = 8
	},
/turf/open/floor/plasteel/monofloor/white,
/area/violence)
"iV" = (
/obj/effect/landmark/start/combatant/red,
/obj/effect/turf_decal/siding/wood{
	dir = 10
	},
/turf/open/floor/plasteel/monofloor/white,
/area/violence)
"jA" = (
/obj/effect/landmark/start/combatant/red,
/obj/effect/turf_decal/siding/wood{
	dir = 4
	},
/turf/open/floor/plasteel/monofloor/white,
/area/violence)
"jK" = (
/obj/effect/turf_decal/box/red,
/obj/effect/landmark/bomb_plant_location,
/turf/open/floor/plasteel/grimy,
/area/violence)
"jM" = (
/obj/structure/flora/tree/jungle{
	alpha = 200;
	mouse_opacity = 0
	},
/turf/open/floor/plating/grass/jungle,
/area/violence)
"kO" = (
/obj/structure/railing{
	dir = 8
	},
/obj/structure/lattice/catwalk,
/turf/open/water,
/area/violence)
"ll" = (
/obj/structure/flora/rock/pile/largejungle,
/turf/open/floor/plating/grass/jungle,
/area/violence)
"me" = (
/obj/structure/deployable_barricade/wooden{
	dir = 8
	},
/turf/open/floor/plasteel/monofloor/white,
/area/violence)
"mm" = (
/obj/effect/turf_decal/siding/wood,
/turf/open/floor/plasteel/monofloor/white,
/area/violence)
"mz" = (
/obj/structure/chair/stool/bamboo,
/obj/effect/landmark/start/combatant/red,
/turf/open/floor/bamboo,
/area/violence)
"nC" = (
/obj/structure/railing/corner{
	dir = 8
	},
/obj/machinery/door/poddoor/multi_tile/two_tile_hor{
	resistance_flags = 115
	},
/turf/open/floor/bamboo,
/area/violence)
"om" = (
/obj/structure/window/paperframe,
/obj/structure/railing{
	dir = 1
	},
/turf/open/floor/bamboo,
/area/violence)
"ow" = (
/obj/effect/landmark/start/combatant/blue,
/obj/effect/turf_decal/siding/wood/corner{
	dir = 8
	},
/turf/open/floor/plasteel/monofloor/white,
/area/violence)
"pt" = (
/obj/structure/railing/corner{
	dir = 1
	},
/obj/machinery/door/poddoor/multi_tile/two_tile_hor{
	resistance_flags = 115
	},
/turf/open/floor/bamboo,
/area/violence)
"qe" = (
/obj/structure/deployable_barricade/wooden{
	dir = 8
	},
/obj/effect/turf_decal/siding/wood,
/turf/open/floor/plasteel/monofloor/white,
/area/violence)
"qo" = (
/obj/structure/window/paperframe,
/obj/structure/railing,
/turf/open/floor/wood,
/area/violence)
"qQ" = (
/obj/structure/window/paperframe,
/obj/structure/railing,
/obj/machinery/door/poddoor{
	resistance_flags = 115
	},
/turf/open/floor/bamboo,
/area/violence)
"qT" = (
/obj/structure/mineral_door/paperframe,
/obj/structure/railing/corner{
	dir = 8
	},
/turf/open/floor/bamboo,
/area/violence)
"rf" = (
/obj/machinery/door/poddoor{
	resistance_flags = 115
	},
/turf/open/floor/plasteel/monofloor/white,
/area/violence)
"rz" = (
/turf/closed/indestructible/black,
/area/violence)
"rH" = (
/obj/effect/landmark/start/combatant/red,
/turf/open/floor/plasteel/monofloor/white,
/area/violence)
"rL" = (
/obj/structure/window/paperframe,
/obj/structure/railing,
/obj/machinery/door/poddoor/multi_tile/two_tile_hor{
	resistance_flags = 115
	},
/turf/open/floor/bamboo,
/area/violence)
"sf" = (
/obj/structure/window/paperframe,
/obj/structure/railing{
	dir = 4
	},
/obj/machinery/door/poddoor{
	resistance_flags = 115
	},
/turf/open/floor/bamboo,
/area/violence)
"sD" = (
/obj/effect/landmark/start/combatant/blue,
/obj/effect/turf_decal/siding/wood{
	dir = 8
	},
/turf/open/floor/plasteel/monofloor/white,
/area/violence)
"sW" = (
/obj/effect/turf_decal/box/red/corners{
	dir = 8
	},
/turf/open/floor/plasteel/monofloor/dark,
/area/violence)
"te" = (
/obj/effect/turf_decal/siding/wood{
	dir = 9
	},
/turf/open/floor/plasteel/monofloor/white,
/area/violence)
"tk" = (
/obj/effect/landmark/start/combatant/blue,
/obj/effect/turf_decal/siding/wood{
	dir = 1
	},
/turf/open/floor/plasteel/monofloor/white,
/area/violence)
"tT" = (
/obj/structure/deployable_barricade/wooden{
	dir = 4
	},
/obj/effect/turf_decal/siding/wood,
/turf/open/floor/plasteel/monofloor/white,
/area/violence)
"tX" = (
/obj/structure/deployable_barricade/wooden,
/turf/open/floor/plasteel/monofloor/white,
/area/violence)
"ub" = (
/obj/effect/turf_decal/siding/wood/corner,
/turf/open/floor/plasteel/monofloor/white,
/area/violence)
"ug" = (
/obj/structure/window/paperframe,
/obj/structure/railing{
	dir = 8
	},
/turf/open/floor/wood,
/area/violence)
"uy" = (
/obj/structure/flora/grass/jungle,
/turf/open/floor/plating/grass/jungle,
/area/violence)
"vJ" = (
/obj/effect/landmark/start/combatant/blue,
/turf/open/floor/bamboo,
/area/violence)
"vN" = (
/obj/structure/deployable_barricade/wooden{
	dir = 1
	},
/turf/open/floor/plasteel/monofloor/white,
/area/violence)
"vZ" = (
/obj/effect/turf_decal/siding/wood{
	dir = 6
	},
/turf/open/floor/plasteel/monofloor/white,
/area/violence)
"wf" = (
/turf/open/floor/plating/grass/jungle,
/area/violence)
"wk" = (
/obj/effect/turf_decal/box/red/corners{
	dir = 1
	},
/turf/open/floor/plasteel/monofloor/dark,
/area/violence)
"wX" = (
/obj/structure/window/paperframe,
/obj/structure/railing{
	dir = 8
	},
/obj/machinery/door/poddoor{
	resistance_flags = 115
	},
/turf/open/floor/bamboo,
/area/violence)
"xL" = (
/obj/effect/landmark/start/combatant/blue,
/obj/effect/turf_decal/siding/wood{
	dir = 4
	},
/turf/open/floor/plasteel/monofloor/white,
/area/violence)
"yy" = (
/obj/machinery/door/poddoor/multi_tile/two_tile_hor{
	resistance_flags = 115
	},
/obj/effect/turf_decal/siding/wood{
	dir = 4
	},
/turf/open/floor/plasteel/monofloor/white,
/area/violence)
"Ai" = (
/obj/effect/turf_decal/box/red/corners{
	dir = 4
	},
/turf/open/floor/plasteel/grimy,
/area/violence)
"AQ" = (
/obj/effect/turf_decal/siding/wood/corner{
	dir = 1
	},
/turf/open/floor/plasteel/monofloor/white,
/area/violence)
"BO" = (
/obj/structure/window/paperframe,
/obj/structure/railing{
	dir = 8
	},
/obj/machinery/door/poddoor/multi_tile/two_tile_ver{
	resistance_flags = 115
	},
/turf/open/floor/bamboo,
/area/violence)
"CU" = (
/obj/structure/deployable_barricade/wooden{
	dir = 8
	},
/obj/effect/turf_decal/siding/wood{
	dir = 1
	},
/turf/open/floor/plasteel/monofloor/white,
/area/violence)
"DG" = (
/obj/structure/flora/tree/jungle/small{
	alpha = 200;
	mouse_opacity = 0
	},
/turf/open/floor/plating/grass/jungle,
/area/violence)
"Er" = (
/obj/structure/flora/junglebush,
/turf/open/floor/plating/grass/jungle,
/area/violence)
"Ex" = (
/obj/structure/railing/corner{
	dir = 8
	},
/obj/machinery/door/poddoor/multi_tile/two_tile_ver{
	resistance_flags = 115
	},
/turf/open/floor/bamboo,
/area/violence)
"EV" = (
/turf/open/water,
/area/violence)
"FX" = (
/obj/structure/flora/rock/jungle,
/turf/open/floor/plating/grass/jungle,
/area/violence)
"GK" = (
/obj/effect/turf_decal/siding/wood{
	dir = 8
	},
/turf/open/floor/plasteel/monofloor/white,
/area/violence)
"GO" = (
/obj/structure/railing/corner{
	dir = 1
	},
/turf/open/floor/bamboo,
/area/violence)
"Ik" = (
/obj/structure/deployable_barricade/wooden{
	dir = 1
	},
/obj/effect/turf_decal/siding/wood{
	dir = 4
	},
/turf/open/floor/plasteel/monofloor/white,
/area/violence)
"IJ" = (
/obj/structure/window/paperframe,
/obj/structure/railing{
	dir = 1
	},
/obj/machinery/door/poddoor{
	resistance_flags = 115
	},
/turf/open/floor/bamboo,
/area/violence)
"IW" = (
/obj/structure/window/paperframe,
/obj/structure/railing{
	dir = 8
	},
/turf/open/floor/bamboo,
/area/violence)
"Jd" = (
/obj/effect/landmark/start/combatant/red,
/obj/effect/turf_decal/siding/wood,
/turf/open/floor/plasteel/monofloor/white,
/area/violence)
"Jj" = (
/obj/structure/railing{
	dir = 8
	},
/turf/open/floor/bamboo,
/area/violence)
"JG" = (
/turf/open/floor/bamboo,
/area/violence)
"KB" = (
/obj/structure/window/paperframe,
/obj/structure/railing{
	dir = 4
	},
/obj/machinery/door/poddoor/multi_tile/two_tile_ver{
	resistance_flags = 115
	},
/turf/open/floor/bamboo,
/area/violence)
"KI" = (
/obj/structure/railing/corner,
/obj/machinery/door/poddoor/multi_tile/two_tile_ver{
	resistance_flags = 115
	},
/turf/open/floor/bamboo,
/area/violence)
"LM" = (
/obj/structure/railing{
	dir = 1
	},
/turf/open/floor/bamboo,
/area/violence)
"Mh" = (
/obj/structure/window/paperframe,
/obj/structure/railing{
	dir = 1
	},
/turf/open/floor/wood,
/area/violence)
"MJ" = (
/obj/structure/deployable_barricade/wooden{
	dir = 4
	},
/obj/effect/turf_decal/siding/wood{
	dir = 1
	},
/turf/open/floor/plasteel/monofloor/white,
/area/violence)
"MW" = (
/turf/open/floor/plasteel/grimy,
/area/violence)
"Nm" = (
/obj/effect/turf_decal/box/red/corners,
/turf/open/floor/plasteel/monofloor/dark,
/area/violence)
"Np" = (
/obj/structure/mineral_door/paperframe,
/obj/structure/railing/corner{
	dir = 4
	},
/turf/open/floor/bamboo,
/area/violence)
"Nw" = (
/obj/effect/turf_decal/siding/wood{
	dir = 1
	},
/turf/open/floor/plasteel/monofloor/white,
/area/violence)
"OR" = (
/obj/effect/landmark/start/combatant/red,
/turf/open/floor/bamboo,
/area/violence)
"OX" = (
/obj/structure/flora/grass/jungle/b,
/turf/open/floor/plating/grass/jungle,
/area/violence)
"Pw" = (
/obj/structure/headpike/bamboo,
/turf/open/floor/plating/grass/jungle,
/area/violence)
"PP" = (
/obj/structure/chair/stool/bamboo,
/obj/effect/landmark/start/combatant/blue,
/turf/open/floor/bamboo,
/area/violence)
"Rl" = (
/obj/effect/landmark/observer_start,
/turf/open/floor/plasteel/grimy,
/area/violence)
"RK" = (
/obj/effect/landmark/start/combatant/red,
/obj/effect/turf_decal/siding/wood/corner{
	dir = 4
	},
/turf/open/floor/plasteel/monofloor/white,
/area/violence)
"St" = (
/obj/structure/mineral_door/paperframe,
/obj/structure/railing/corner{
	dir = 1
	},
/turf/open/floor/bamboo,
/area/violence)
"Ta" = (
/obj/structure/deployable_barricade/wooden{
	dir = 1
	},
/obj/effect/turf_decal/siding/wood{
	dir = 8
	},
/turf/open/floor/plasteel/monofloor/white,
/area/violence)
"Tk" = (
/obj/structure/railing/corner,
/turf/open/floor/bamboo,
/area/violence)
"TH" = (
/obj/effect/landmark/start/combatant/blue,
/turf/open/floor/plasteel/monofloor/white,
/area/violence)
"TQ" = (
/obj/structure/window/paperframe,
/obj/structure/railing{
	dir = 1
	},
/obj/machinery/door/poddoor/multi_tile/two_tile_hor{
	resistance_flags = 115
	},
/turf/open/floor/bamboo,
/area/violence)
"Wd" = (
/obj/structure/railing{
	dir = 4
	},
/obj/structure/lattice/catwalk,
/turf/open/water,
/area/violence)
"Xv" = (
/obj/structure/window/paperframe,
/obj/structure/railing{
	dir = 4
	},
/turf/open/floor/bamboo,
/area/violence)
"XA" = (
/obj/structure/mineral_door/paperframe,
/obj/structure/railing/corner,
/turf/open/floor/bamboo,
/area/violence)
"ZA" = (
/obj/structure/window/paperframe,
/turf/open/floor/bamboo,
/area/violence)

(1,1,1) = {"
rz
rz
rz
rz
rz
rz
rz
rz
rz
rz
rz
rz
rz
rz
rz
rz
rz
rz
rz
rz
rz
rz
rz
rz
rz
rz
rz
rz
rz
rz
rz
rz
rz
rz
rz
rz
rz
rz
rz
ez
"}
(2,1,1) = {"
rz
EV
EV
EV
EV
EV
EV
EV
EV
EV
EV
EV
EV
EV
EV
EV
EV
EV
aI
EV
EV
aI
EV
EV
EV
EV
EV
EV
EV
EV
EV
EV
EV
EV
EV
EV
EV
EV
EV
rz
"}
(3,1,1) = {"
rz
EV
EV
EV
EV
EV
EV
EV
EV
EV
EV
EV
EV
EV
EV
EV
EV
EV
aI
EV
EV
aI
EV
EV
EV
EV
EV
EV
EV
EV
EV
EV
EV
EV
EV
EV
EV
EV
EV
rz
"}
(4,1,1) = {"
rz
EV
EV
DG
wf
Er
wf
wf
wf
wf
wf
wf
wf
wf
wf
wf
wf
EV
aI
EV
EV
aI
EV
wf
wf
wf
wf
wf
wf
wf
cD
IW
BO
wX
IW
BO
cD
EV
EV
rz
"}
(5,1,1) = {"
rz
EV
EV
wf
cD
IW
IW
IW
cD
ug
ug
ug
ug
ug
ug
ug
ug
ug
cD
IW
IW
cD
ug
ug
ug
ug
ug
ug
ug
ug
pt
mz
mz
mz
mz
mz
rL
EV
EV
rz
"}
(6,1,1) = {"
rz
EV
EV
OX
om
te
GK
GK
iS
GK
GK
GK
GK
GK
GK
GK
GK
GK
Ta
GK
GK
GK
GK
GK
GK
GK
GK
GK
Ta
GK
GK
bz
bz
bz
iV
mz
gc
EV
EV
rz
"}
(7,1,1) = {"
rz
EV
EV
wf
om
Nw
bA
bA
tX
bA
bA
bA
bA
bA
bA
bA
bA
bA
vN
bA
bA
bA
bA
bA
bA
bA
vN
bA
bA
bA
rf
rH
rH
rH
Jd
mz
qQ
EV
EV
rz
"}
(8,1,1) = {"
rz
EV
EV
wf
om
Nw
bA
ub
cm
cN
cN
cN
cN
cN
cN
cN
cN
cN
Ik
cN
cN
cN
cN
cN
cN
cN
cN
cN
Ik
cN
yy
jA
RK
rH
Jd
mz
rL
EV
EV
rz
"}
(9,1,1) = {"
rz
EV
EV
wf
cD
Nw
bA
mm
cD
fj
fj
fj
fj
fj
fj
fj
fj
fj
cD
Np
XA
cD
fj
fj
fj
fj
fj
fj
fj
fj
fx
OR
ao
rH
Jd
mz
gc
EV
EV
rz
"}
(10,1,1) = {"
rz
EV
EV
wf
Mh
Nw
bA
mm
qo
jM
OX
wf
wf
wf
wf
wf
EV
aI
EV
it
hY
EV
aI
EV
wf
wf
wf
wf
wf
wf
cD
fx
be
rf
mm
KI
cD
EV
EV
rz
"}
(11,1,1) = {"
rz
EV
EV
wf
Mh
Nw
bA
mm
qo
uy
wf
wf
wf
wf
wf
wf
EV
aI
EV
it
hY
EV
aI
EV
EV
EV
EV
EV
EV
wf
wf
Mh
Nw
bA
mm
qo
wf
EV
EV
rz
"}
(12,1,1) = {"
rz
EV
EV
wf
Mh
Nw
bA
mm
qo
wf
wf
wf
wf
wf
wf
EV
EV
aI
EV
it
hY
EV
aI
EV
EV
wf
wf
wf
EV
wf
wf
Mh
MJ
bA
tT
qo
wf
EV
EV
rz
"}
(13,1,1) = {"
rz
EV
EV
wf
Mh
Nw
bA
mm
qo
wf
wf
wf
EV
EV
EV
EV
EV
aI
EV
it
hY
EV
aI
EV
EV
wf
ll
wf
EV
wf
wf
Mh
Nw
bA
mm
qo
wf
EV
EV
rz
"}
(14,1,1) = {"
rz
EV
EV
wf
Mh
Nw
bA
mm
qo
wf
wf
wf
EV
FX
wf
wf
EV
aI
EV
it
hY
EV
aI
EV
EV
wf
wf
wf
EV
wf
wf
Mh
Nw
cd
mm
qo
wf
EV
EV
rz
"}
(15,1,1) = {"
rz
EV
EV
wf
Mh
Nw
bA
mm
qo
wf
wf
wf
EV
wf
wf
EV
EV
aI
EV
it
hY
EV
aI
EV
EV
wf
wf
wf
EV
wf
wf
Mh
Nw
bA
mm
qo
wf
EV
EV
rz
"}
(16,1,1) = {"
rz
EV
EV
wf
Mh
Nw
bA
mm
qo
wf
wf
EV
EV
wf
EV
EV
EV
Pw
Pw
LM
dZ
Pw
Pw
EV
EV
wf
wf
wf
EV
EV
wf
Mh
Nw
bA
mm
qo
wf
EV
EV
rz
"}
(17,1,1) = {"
rz
EV
EV
wf
Mh
Nw
bA
mm
qo
EV
EV
EV
EV
EV
EV
EV
cD
ZA
cD
St
qT
cD
ZA
cD
EV
EV
EV
EV
EV
EV
EV
Mh
Nw
bA
mm
qo
wf
EV
EV
rz
"}
(18,1,1) = {"
rz
EV
EV
EV
Mh
Nw
bA
mm
qo
aI
aI
aI
aI
aI
aI
Pw
ZA
JG
JG
JG
JG
JG
JG
ZA
Pw
aI
aI
aI
aI
aI
aI
Mh
Nw
bA
mm
qo
EV
EV
EV
rz
"}
(19,1,1) = {"
rz
aI
aI
aI
cD
Nw
bA
mm
cD
EV
EV
EV
EV
EV
EV
Pw
cD
JG
cZ
cZ
cZ
cZ
JG
cD
Pw
EV
EV
EV
EV
EV
EV
cD
Nw
cd
tT
cD
aI
aI
aI
rz
"}
(20,1,1) = {"
rz
EV
EV
EV
om
Nw
bA
mm
qT
kO
kO
kO
kO
kO
kO
Jj
St
JG
Nm
Rl
Ai
cZ
JG
qT
Jj
kO
kO
kO
kO
kO
kO
St
Nw
bA
mm
gc
EV
EV
EV
rz
"}
(21,1,1) = {"
rz
EV
EV
EV
om
Nw
bA
mm
XA
Wd
Wd
Wd
Wd
Wd
Wd
fR
Np
JG
cZ
jK
MW
cZ
JG
XA
fR
Wd
Wd
Wd
Wd
Wd
Wd
Np
Nw
bA
mm
gc
EV
EV
EV
rz
"}
(22,1,1) = {"
rz
aI
aI
aI
cD
CU
me
mm
cD
EV
EV
EV
EV
EV
EV
Pw
cD
JG
sW
cZ
wk
cZ
JG
cD
Pw
EV
EV
EV
EV
EV
EV
cD
Nw
bA
mm
cD
aI
aI
aI
rz
"}
(23,1,1) = {"
rz
EV
EV
EV
Mh
Nw
bA
mm
qo
aI
aI
aI
aI
aI
aI
Pw
ZA
JG
JG
JG
JG
JG
JG
ZA
Pw
aI
aI
aI
aI
aI
aI
Mh
Nw
bA
mm
qo
EV
EV
EV
rz
"}
(24,1,1) = {"
rz
EV
EV
wf
Mh
Nw
bA
mm
qo
EV
EV
EV
EV
EV
EV
EV
cD
ZA
cD
Np
XA
cD
ZA
cD
EV
EV
EV
EV
EV
EV
EV
Mh
Nw
bA
mm
qo
wf
EV
EV
rz
"}
(25,1,1) = {"
rz
EV
EV
wf
Mh
Nw
bA
mm
qo
wf
EV
EV
wf
wf
wf
EV
EV
Pw
Pw
LM
dZ
Pw
Pw
EV
EV
EV
wf
EV
EV
wf
wf
Mh
Nw
bA
mm
qo
wf
EV
EV
rz
"}
(26,1,1) = {"
rz
EV
EV
wf
Mh
Nw
bA
mm
qo
wf
wf
EV
wf
wf
wf
EV
EV
aI
EV
it
hY
EV
aI
EV
EV
wf
wf
EV
wf
wf
wf
Mh
Nw
bA
mm
qo
wf
EV
EV
rz
"}
(27,1,1) = {"
rz
EV
EV
wf
Mh
Nw
me
mm
qo
wf
wf
EV
wf
wf
wf
EV
EV
aI
EV
it
hY
EV
aI
EV
wf
wf
FX
EV
wf
wf
wf
Mh
Nw
bA
mm
qo
wf
EV
EV
rz
"}
(28,1,1) = {"
rz
EV
EV
wf
Mh
Nw
bA
mm
qo
wf
wf
EV
wf
ll
wf
EV
EV
aI
EV
it
hY
EV
aI
EV
EV
EV
EV
EV
wf
wf
wf
Mh
Nw
bA
mm
qo
wf
EV
EV
rz
"}
(29,1,1) = {"
rz
EV
EV
wf
Mh
CU
bA
qe
qo
wf
wf
EV
wf
wf
wf
EV
EV
aI
EV
it
hY
EV
aI
EV
EV
wf
wf
wf
wf
wf
wf
Mh
Nw
bA
mm
qo
wf
EV
EV
rz
"}
(30,1,1) = {"
rz
EV
EV
wf
Mh
Nw
bA
mm
qo
wf
wf
EV
EV
EV
EV
EV
EV
aI
EV
it
hY
EV
aI
EV
wf
wf
wf
wf
wf
wf
uy
Mh
Nw
bA
mm
qo
wf
EV
EV
rz
"}
(31,1,1) = {"
rz
EV
EV
cD
GO
be
rf
mm
Ex
cD
wf
wf
wf
wf
wf
wf
EV
aI
EV
it
hY
EV
aI
EV
wf
wf
wf
wf
wf
wf
jM
Mh
Nw
bA
mm
qo
wf
EV
EV
rz
"}
(32,1,1) = {"
rz
EV
EV
TQ
PP
tk
TH
iy
vJ
nC
ug
ug
ug
ug
ug
ug
ug
ug
cD
St
qT
cD
ug
ug
ug
ug
ug
ug
ug
ug
ug
cD
Nw
bA
mm
cD
wf
EV
EV
rz
"}
(33,1,1) = {"
rz
EV
EV
om
PP
tk
TH
ow
sD
GK
GK
iS
GK
GK
GK
GK
GK
GK
GK
GK
GK
iS
GK
GK
GK
GK
GK
GK
GK
GK
GK
Ta
AQ
bA
mm
gc
wf
EV
EV
rz
"}
(34,1,1) = {"
rz
EV
EV
IJ
PP
tk
TH
TH
TH
rf
bA
bA
bA
tX
bA
bA
bA
bA
bA
bA
bA
tX
bA
bA
bA
bA
bA
bA
bA
bA
bA
vN
bA
bA
mm
gc
wf
EV
EV
rz
"}
(35,1,1) = {"
rz
EV
EV
TQ
PP
cn
xL
xL
xL
yy
cN
cm
cN
cN
cN
cN
cN
cN
cN
cN
cN
cm
cN
cN
cN
cN
cN
cN
cN
cN
cN
Ik
cN
cN
vZ
gc
wf
EV
EV
rz
"}
(36,1,1) = {"
rz
EV
EV
om
PP
PP
PP
PP
PP
Tk
fj
fj
fj
fj
fj
fj
fj
fj
cD
Xv
Xv
cD
fj
fj
fj
fj
fj
fj
fj
fj
fj
cD
Xv
Xv
Xv
cD
OX
EV
EV
rz
"}
(37,1,1) = {"
rz
EV
EV
cD
Xv
KB
sf
Xv
KB
cD
wf
wf
wf
wf
wf
wf
wf
EV
aI
EV
EV
aI
EV
wf
wf
wf
wf
wf
wf
wf
wf
wf
wf
wf
Er
wf
DG
EV
EV
rz
"}
(38,1,1) = {"
rz
EV
EV
EV
EV
EV
EV
EV
EV
EV
EV
EV
EV
EV
EV
EV
EV
EV
aI
EV
EV
aI
EV
EV
EV
EV
EV
EV
EV
EV
EV
EV
EV
EV
EV
EV
EV
EV
EV
rz
"}
(39,1,1) = {"
rz
EV
EV
EV
EV
EV
EV
EV
EV
EV
EV
EV
EV
EV
EV
EV
EV
EV
aI
EV
EV
aI
EV
EV
EV
EV
EV
EV
EV
EV
EV
EV
EV
EV
EV
EV
EV
EV
EV
rz
"}
(40,1,1) = {"
rz
rz
rz
rz
rz
rz
rz
rz
rz
rz
rz
rz
rz
rz
rz
rz
rz
rz
rz
rz
rz
rz
rz
rz
rz
rz
rz
rz
rz
rz
rz
rz
rz
rz
rz
rz
rz
rz
rz
rz
"}
