//MAP CONVERTED BY dmm2tgm.py THIS HEADER COMMENT PREVENTS RECONVERSION, DO NOT REMOVE
"bi" = (
/obj/lab_monitor,
/turf/closed/dz/normal,
/area/violence)
"cC" = (
/turf/closed/dz/normal/cyber/ice,
/area/violence)
"dr" = (
/obj/effect/turf_decal/box/red/corners{
	dir = 1
	},
/turf/open/floor/dz/green,
/area/violence)
"dG" = (
/turf/closed/dz/normal/cyber/ice/red,
/area/violence)
"eK" = (
/obj/machinery/power/emitter/energycannon{
	dir = 4
	},
/turf/closed/dz/normal,
/area/violence)
"ff" = (
/obj/structure/sign/poster/random,
/turf/closed/dz/normal,
/area/violence)
"hy" = (
/obj/structure/sign/dz/middle,
/turf/closed/dz/normal,
/area/violence)
"hY" = (
/obj/effect/landmark/start/combatant/red,
/turf/open/floor/light{
	currentcolor = "#FA8282"
	},
/area/violence)
"jk" = (
/obj/effect/turf_decal/box/red/corners,
/turf/open/floor/dz/green,
/area/violence)
"jo" = (
/obj/structure/sign/dz/end,
/turf/closed/dz/normal/cyber,
/area/violence)
"jD" = (
/obj/machinery/door/poddoor/multi_tile/three_tile_ver{
	resistance_flags = 115
	},
/turf/open/floor/dz/cyber,
/area/violence)
"lY" = (
/obj/structure/sign/dz/end,
/turf/closed/dz/normal,
/area/violence)
"mj" = (
/obj/machinery/door/poddoor/multi_tile/three_tile_hor{
	resistance_flags = 115
	},
/turf/open/floor/dz/cyber,
/area/violence)
"mp" = (
/obj/effect/baseturf_helper/dune,
/turf/closed/dz/normal,
/area/violence)
"mT" = (
/obj/structure/sign/dz,
/turf/closed/dz/normal,
/area/violence)
"nd" = (
/obj/machinery/power/emitter/energycannon{
	dir = 8
	},
/turf/closed/dz/normal/cyber,
/area/violence)
"oE" = (
/obj/effect/landmark/bomb_plant_location,
/obj/effect/turf_decal/box/red,
/turf/open/floor/dz/trippy_green,
/area/violence)
"sq" = (
/turf/closed/dz/normal/cyber/ice/blue,
/area/violence)
"sR" = (
/obj/structure/sign/dz,
/turf/closed/dz/normal/cyber,
/area/violence)
"xw" = (
/turf/open/floor/dz/cyber,
/area/violence)
"zB" = (
/obj/effect/landmark/start/combatant/blue,
/turf/open/floor/light{
	currentcolor = "#3375F8"
	},
/area/violence)
"zU" = (
/obj/effect/mapping_helpers/turf_rotation,
/turf/open/floor/dz/hot_plates,
/area/violence)
"Ab" = (
/obj/machinery/power/emitter/energycannon{
	dir = 4
	},
/turf/closed/dz/normal/cyber,
/area/violence)
"CQ" = (
/turf/closed/dz/normal/cyber,
/area/violence)
"GZ" = (
/obj/lab_monitor{
	what_pic = "survive"
	},
/turf/closed/dz/normal/cyber,
/area/violence)
"Hy" = (
/turf/closed/dz/normal,
/area/violence)
"IU" = (
/obj/effect/turf_decal/box/red/corners{
	dir = 4
	},
/turf/open/floor/dz/green,
/area/violence)
"Js" = (
/turf/open/floor/rospilovo/cyber{
	icon_state = "bfloor-3"
	},
/area/violence)
"Jt" = (
/obj/lab_monitor{
	what_pic = "survive"
	},
/turf/closed/dz/normal,
/area/violence)
"JA" = (
/obj/structure/sign/poster/random,
/turf/closed/dz/normal/cyber,
/area/violence)
"Kt" = (
/turf/closed/dz/normal/cyber/ice/green,
/area/violence)
"Li" = (
/obj/effect/landmark/start/combatant/blue,
/turf/open/floor/dz/cyber,
/area/violence)
"Lr" = (
/turf/closed/dz/normal/cyber/ice/yellow,
/area/violence)
"Nb" = (
/obj/effect/turf_decal/box/red/corners{
	dir = 8
	},
/turf/open/floor/dz/green,
/area/violence)
"Op" = (
/obj/machinery/door/poddoor/multi_tile/three_tile_ver{
	resistance_flags = 115
	},
/turf/open/floor/rospilovo/cyber{
	icon_state = "bfloor-3"
	},
/area/violence)
"PD" = (
/obj/effect/landmark/start/combatant/red,
/turf/open/floor/rospilovo/cyber{
	icon_state = "bfloor-3"
	},
/area/violence)
"QI" = (
/obj/machinery/door/poddoor/multi_tile/three_tile_hor{
	resistance_flags = 115
	},
/turf/open/floor/rospilovo/cyber{
	icon_state = "bfloor-3"
	},
/area/violence)
"Ss" = (
/obj/lab_monitor,
/turf/closed/dz/normal/cyber,
/area/violence)
"TI" = (
/turf/closed/dz/normal/cyber/ice/black,
/area/violence)
"Vd" = (
/obj/machinery/power/emitter/energycannon{
	dir = 8
	},
/turf/closed/dz/normal,
/area/violence)
"VO" = (
/obj/structure/sign/dz/middle,
/turf/closed/dz/normal/cyber,
/area/violence)
"ZH" = (
/turf/open/floor/dz/green,
/area/violence)

(1,1,1) = {"
mp
Hy
Hy
Hy
Hy
Hy
Hy
Hy
Hy
Hy
Hy
Hy
Hy
Hy
Hy
Hy
eK
Hy
Hy
Ab
CQ
CQ
CQ
CQ
CQ
CQ
CQ
CQ
CQ
CQ
CQ
CQ
CQ
CQ
CQ
CQ
CQ
CQ
CQ
"}
(2,1,1) = {"
Hy
Kt
Kt
Kt
Kt
Kt
Hy
Lr
Lr
Lr
Lr
Lr
Lr
Lr
Hy
Js
Js
Js
TI
zU
zU
zU
zU
zU
zU
CQ
dG
dG
dG
dG
dG
dG
CQ
Kt
Kt
Kt
Kt
Kt
CQ
"}
(3,1,1) = {"
Hy
Kt
zU
zU
zU
zU
TI
Js
Js
Js
Js
Js
Js
Js
Hy
Js
Js
Js
TI
zU
zU
zU
zU
zU
zU
TI
xw
xw
xw
xw
xw
xw
TI
zU
zU
zU
zU
Kt
CQ
"}
(4,1,1) = {"
Hy
Kt
zU
zU
zU
zU
TI
Js
zU
zU
zU
zU
zU
Js
Hy
Js
Js
Js
TI
zU
zU
zU
zU
zU
zU
TI
xw
zU
zU
zU
zU
xw
TI
zU
zU
zU
zU
Kt
CQ
"}
(5,1,1) = {"
Hy
Kt
zU
zU
zU
Kt
Hy
Js
Js
Js
Js
Js
Js
Js
TI
Js
Js
Js
Hy
zU
zU
zU
zU
zU
zU
CQ
xw
zU
zU
zU
zU
xw
CQ
Kt
zU
zU
zU
Kt
CQ
"}
(6,1,1) = {"
Hy
Kt
zU
zU
zU
Kt
Hy
Js
dG
Js
Hy
Hy
Hy
Hy
Hy
Hy
Js
Js
Hy
zU
zU
zU
zU
zU
zU
CQ
xw
zU
zU
zU
zU
xw
CQ
Kt
zU
zU
zU
Kt
CQ
"}
(7,1,1) = {"
Hy
Kt
zU
zU
zU
Kt
Hy
Js
dG
Js
cC
cC
cC
cC
cC
Hy
Js
Js
Hy
zU
zU
zU
zU
zU
zU
CQ
xw
xw
xw
xw
xw
xw
CQ
Kt
zU
zU
zU
Kt
CQ
"}
(8,1,1) = {"
Hy
Kt
zU
zU
zU
Kt
Hy
Js
dG
Js
cC
cC
cC
cC
cC
Jt
Js
Js
Hy
Js
JA
Ss
xw
CQ
CQ
CQ
CQ
CQ
CQ
xw
dG
xw
CQ
Kt
zU
zU
zU
Kt
CQ
"}
(9,1,1) = {"
Hy
Kt
zU
zU
zU
Kt
Hy
Js
dG
Js
cC
cC
cC
cC
cC
TI
Js
Js
Js
Js
dG
TI
xw
cC
cC
cC
cC
cC
GZ
xw
dG
xw
CQ
Kt
zU
zU
zU
Kt
CQ
"}
(10,1,1) = {"
Hy
Kt
zU
zU
zU
Kt
Hy
Js
dG
Js
cC
cC
cC
cC
cC
TI
Js
Js
Js
Js
dG
TI
xw
cC
cC
cC
cC
cC
cC
xw
dG
xw
CQ
Kt
zU
zU
zU
Kt
CQ
"}
(11,1,1) = {"
Hy
Kt
zU
zU
zU
Kt
Hy
Js
dG
Js
cC
cC
cC
cC
cC
Jt
Js
Js
Js
Js
dG
TI
xw
cC
cC
cC
cC
cC
cC
xw
dG
xw
CQ
Kt
zU
zU
zU
Kt
CQ
"}
(12,1,1) = {"
Hy
Kt
zU
zU
zU
Kt
Hy
Js
dG
Js
cC
cC
cC
cC
cC
Hy
Js
Js
Js
Js
dG
TI
xw
cC
cC
cC
cC
cC
cC
xw
dG
xw
CQ
Kt
zU
zU
zU
Kt
CQ
"}
(13,1,1) = {"
Hy
Hy
Js
Js
Op
Hy
Hy
Js
dG
Js
Hy
Hy
Hy
Hy
Hy
Hy
Js
Js
Js
Js
dG
TI
xw
cC
cC
cC
cC
cC
GZ
xw
dG
xw
CQ
CQ
xw
xw
jD
CQ
CQ
"}
(14,1,1) = {"
Hy
hY
PD
PD
PD
hY
Jt
Js
Js
Js
zU
zU
zU
zU
zU
zU
Js
TI
ff
ZH
JA
CQ
xw
CQ
CQ
CQ
CQ
CQ
CQ
xw
dG
xw
CQ
zB
Li
Li
Li
zB
CQ
"}
(15,1,1) = {"
mT
PD
PD
PD
PD
PD
QI
Js
Js
Js
zU
zU
zU
zU
zU
zU
Js
TI
jk
ZH
IU
TI
xw
zU
zU
zU
zU
zU
zU
xw
xw
xw
mj
Li
Li
Li
Li
Li
sR
"}
(16,1,1) = {"
hy
PD
PD
sq
PD
PD
Js
Js
Js
Js
zU
zU
zU
zU
zU
zU
Js
TI
ZH
oE
ZH
TI
xw
zU
zU
zU
zU
zU
zU
xw
xw
xw
xw
Li
Li
sq
Li
Li
VO
"}
(17,1,1) = {"
lY
PD
PD
PD
PD
PD
Js
Js
Js
Js
zU
zU
zU
zU
zU
zU
Js
TI
Nb
ZH
dr
TI
xw
zU
zU
zU
zU
zU
zU
xw
xw
xw
xw
Li
Li
Li
Li
Li
jo
"}
(18,1,1) = {"
Hy
hY
PD
PD
PD
hY
Hy
Js
dG
Js
Hy
Hy
Hy
Hy
Hy
Hy
Js
Hy
ff
ZH
JA
TI
xw
zU
zU
zU
zU
zU
zU
xw
xw
xw
GZ
zB
Li
Li
Li
zB
CQ
"}
(19,1,1) = {"
Hy
Hy
Js
Js
Op
Hy
Hy
Js
dG
Js
Jt
cC
cC
cC
cC
cC
Js
TI
dG
xw
xw
xw
xw
CQ
CQ
CQ
CQ
CQ
CQ
xw
dG
xw
CQ
CQ
xw
xw
jD
CQ
CQ
"}
(20,1,1) = {"
Hy
Kt
zU
zU
zU
Kt
Hy
Js
dG
Js
cC
cC
cC
cC
cC
cC
Js
TI
dG
xw
xw
xw
xw
CQ
cC
cC
cC
cC
cC
xw
dG
xw
CQ
Kt
zU
zU
zU
Kt
CQ
"}
(21,1,1) = {"
Hy
Kt
zU
zU
zU
Kt
Hy
Js
dG
Js
cC
cC
cC
cC
cC
cC
Js
TI
dG
xw
xw
xw
xw
GZ
cC
cC
cC
cC
cC
xw
dG
xw
CQ
Kt
zU
zU
zU
Kt
CQ
"}
(22,1,1) = {"
Hy
Kt
zU
zU
zU
Kt
Hy
Js
dG
Js
cC
cC
cC
cC
cC
cC
Js
TI
dG
xw
xw
xw
xw
TI
cC
cC
cC
cC
cC
xw
dG
xw
CQ
Kt
zU
zU
zU
Kt
CQ
"}
(23,1,1) = {"
Hy
Kt
zU
zU
zU
Kt
Hy
Js
dG
Js
Jt
cC
cC
cC
cC
cC
Js
TI
dG
xw
xw
xw
xw
TI
cC
cC
cC
cC
cC
xw
dG
xw
CQ
Kt
zU
zU
zU
Kt
CQ
"}
(24,1,1) = {"
Hy
Kt
zU
zU
zU
Kt
Hy
Js
dG
Js
Hy
Hy
Hy
Hy
Hy
Hy
Js
bi
ff
xw
CQ
xw
xw
GZ
cC
cC
cC
cC
cC
xw
dG
xw
CQ
Kt
zU
zU
zU
Kt
CQ
"}
(25,1,1) = {"
Hy
Kt
zU
zU
zU
Kt
Hy
Js
Js
Js
Js
Js
Js
Hy
zU
zU
zU
zU
zU
zU
CQ
xw
xw
CQ
cC
cC
cC
cC
cC
xw
dG
xw
CQ
Kt
zU
zU
zU
Kt
CQ
"}
(26,1,1) = {"
Hy
Kt
zU
zU
zU
Kt
Hy
Js
zU
zU
zU
zU
Js
Hy
zU
zU
zU
zU
zU
zU
CQ
xw
xw
CQ
CQ
CQ
CQ
CQ
CQ
xw
dG
xw
CQ
Kt
zU
zU
zU
Kt
CQ
"}
(27,1,1) = {"
Hy
Kt
zU
zU
zU
Kt
Hy
Js
zU
zU
zU
zU
Js
Hy
zU
zU
zU
zU
zU
zU
CQ
xw
xw
xw
TI
xw
xw
xw
xw
xw
xw
xw
CQ
Kt
zU
zU
zU
Kt
CQ
"}
(28,1,1) = {"
Hy
Kt
zU
zU
zU
zU
TI
Js
zU
zU
zU
zU
Js
TI
zU
zU
zU
zU
zU
zU
TI
xw
xw
xw
CQ
xw
zU
zU
zU
zU
zU
xw
TI
zU
zU
zU
zU
Kt
CQ
"}
(29,1,1) = {"
Hy
Kt
zU
zU
zU
zU
TI
Js
Js
Js
Js
Js
Js
TI
zU
zU
zU
zU
zU
zU
TI
xw
xw
xw
CQ
xw
xw
xw
xw
xw
xw
xw
TI
zU
zU
zU
zU
Kt
CQ
"}
(30,1,1) = {"
Hy
Kt
Kt
Kt
Kt
Kt
Hy
dG
dG
dG
dG
dG
dG
Hy
zU
zU
zU
zU
zU
zU
TI
xw
xw
xw
CQ
Lr
Lr
Lr
Lr
Lr
Lr
Lr
CQ
Kt
Kt
Kt
Kt
Kt
CQ
"}
(31,1,1) = {"
Hy
Hy
Hy
Hy
Hy
Hy
Hy
Hy
Hy
Hy
Hy
Hy
Hy
Hy
Hy
Hy
Hy
Hy
Hy
Vd
CQ
CQ
nd
CQ
CQ
CQ
CQ
CQ
CQ
CQ
CQ
CQ
CQ
CQ
CQ
CQ
CQ
CQ
CQ
"}
