//MAP CONVERTED BY dmm2tgm.py THIS HEADER COMMENT PREVENTS RECONVERSION, DO NOT REMOVE
"aI" = (
/obj/structure/punji_sticks,
/turf/open/water,
/area/violence)
"be" = (
/obj/machinery/door/poddoor/multi_tile/two_tile_ver{
	resistance_flags = 115
	},
/turf/open/floor/bamboo,
/area/violence)
"cD" = (
/turf/closed/wall/mineral/bamboo,
/area/violence)
"cZ" = (
/turf/open/floor/carpet/green,
/area/violence)
"dZ" = (
/obj/structure/railing,
/turf/open/floor/bamboo,
/area/violence)
"ez" = (
/obj/effect/baseturf_helper/beach/water,
/turf/closed/indestructible/black,
/area/violence)
"fx" = (
/obj/structure/railing/corner{
	dir = 4
	},
/turf/open/floor/bamboo,
/area/violence)
"fR" = (
/obj/structure/railing{
	dir = 4
	},
/turf/open/floor/bamboo,
/area/violence)
"gc" = (
/obj/structure/window/paperframe,
/obj/structure/railing,
/turf/open/floor/bamboo,
/area/violence)
"iS" = (
/obj/structure/deployable_barricade/wooden,
/turf/open/floor/bamboo,
/area/violence)
"jK" = (
/obj/effect/turf_decal/box/red,
/obj/effect/landmark/bomb_plant_location,
/turf/open/floor/carpet/green,
/area/violence)
"jM" = (
/obj/structure/flora/tree/jungle{
	alpha = 200;
	mouse_opacity = 0
	},
/turf/open/floor/plating/grass/jungle,
/area/violence)
"ll" = (
/obj/structure/flora/rock/pile/largejungle,
/turf/open/floor/plating/grass/jungle,
/area/violence)
"mz" = (
/obj/structure/chair/stool/bamboo,
/obj/effect/landmark/start/combatant/red,
/turf/open/floor/bamboo,
/area/violence)
"nC" = (
/obj/structure/railing/corner{
	dir = 8
	},
/obj/machinery/door/poddoor/multi_tile/two_tile_hor{
	resistance_flags = 115
	},
/turf/open/floor/bamboo,
/area/violence)
"om" = (
/obj/structure/window/paperframe,
/obj/structure/railing{
	dir = 1
	},
/turf/open/floor/bamboo,
/area/violence)
"pt" = (
/obj/structure/railing/corner{
	dir = 1
	},
/obj/machinery/door/poddoor/multi_tile/two_tile_hor{
	resistance_flags = 115
	},
/turf/open/floor/bamboo,
/area/violence)
"qQ" = (
/obj/structure/window/paperframe,
/obj/structure/railing,
/obj/machinery/door/poddoor{
	resistance_flags = 115
	},
/turf/open/floor/bamboo,
/area/violence)
"qT" = (
/obj/structure/mineral_door/paperframe,
/obj/structure/railing/corner{
	dir = 8
	},
/turf/open/floor/bamboo,
/area/violence)
"rf" = (
/obj/machinery/door/poddoor{
	resistance_flags = 115
	},
/turf/open/floor/bamboo,
/area/violence)
"rz" = (
/turf/closed/indestructible/black,
/area/violence)
"rL" = (
/obj/structure/window/paperframe,
/obj/structure/railing,
/obj/machinery/door/poddoor/multi_tile/two_tile_hor{
	resistance_flags = 115
	},
/turf/open/floor/bamboo,
/area/violence)
"sf" = (
/obj/structure/window/paperframe,
/obj/structure/railing{
	dir = 4
	},
/obj/machinery/door/poddoor{
	resistance_flags = 115
	},
/turf/open/floor/bamboo,
/area/violence)
"sW" = (
/obj/effect/turf_decal/box/red/corners{
	dir = 8
	},
/turf/open/floor/carpet/green,
/area/violence)
"uy" = (
/obj/structure/flora/grass/jungle,
/turf/open/floor/plating/grass/jungle,
/area/violence)
"vJ" = (
/obj/effect/landmark/start/combatant/blue,
/turf/open/floor/bamboo,
/area/violence)
"wf" = (
/turf/open/floor/plating/grass/jungle,
/area/violence)
"wk" = (
/obj/effect/turf_decal/box/red/corners{
	dir = 1
	},
/turf/open/floor/carpet/green,
/area/violence)
"wX" = (
/obj/structure/window/paperframe,
/obj/structure/railing{
	dir = 8
	},
/obj/machinery/door/poddoor{
	resistance_flags = 115
	},
/turf/open/floor/bamboo,
/area/violence)
"yy" = (
/obj/machinery/door/poddoor/multi_tile/two_tile_hor{
	resistance_flags = 115
	},
/turf/open/floor/bamboo,
/area/violence)
"Ai" = (
/obj/effect/turf_decal/box/red/corners{
	dir = 4
	},
/turf/open/floor/carpet/green,
/area/violence)
"BO" = (
/obj/structure/window/paperframe,
/obj/structure/railing{
	dir = 8
	},
/obj/machinery/door/poddoor/multi_tile/two_tile_ver{
	resistance_flags = 115
	},
/turf/open/floor/bamboo,
/area/violence)
"CU" = (
/obj/structure/deployable_barricade/wooden{
	dir = 8
	},
/turf/open/floor/bamboo,
/area/violence)
"DG" = (
/obj/structure/flora/tree/jungle/small{
	alpha = 200;
	mouse_opacity = 0
	},
/turf/open/floor/plating/grass/jungle,
/area/violence)
"Er" = (
/obj/structure/flora/junglebush,
/turf/open/floor/plating/grass/jungle,
/area/violence)
"Ex" = (
/obj/structure/railing/corner{
	dir = 8
	},
/obj/machinery/door/poddoor/multi_tile/two_tile_ver{
	resistance_flags = 115
	},
/turf/open/floor/bamboo,
/area/violence)
"EV" = (
/obj/structure/table/wood,
/turf/open/floor/bamboo,
/area/violence)
"FX" = (
/obj/structure/flora/rock/jungle,
/turf/open/floor/plating/grass/jungle,
/area/violence)
"GO" = (
/obj/structure/railing/corner{
	dir = 1
	},
/turf/open/floor/bamboo,
/area/violence)
"IJ" = (
/obj/structure/window/paperframe,
/obj/structure/railing{
	dir = 1
	},
/obj/machinery/door/poddoor{
	resistance_flags = 115
	},
/turf/open/floor/bamboo,
/area/violence)
"IW" = (
/obj/structure/window/paperframe,
/obj/structure/railing{
	dir = 8
	},
/turf/open/floor/bamboo,
/area/violence)
"Jj" = (
/obj/structure/railing{
	dir = 8
	},
/turf/open/floor/bamboo,
/area/violence)
"JG" = (
/turf/open/floor/bamboo,
/area/violence)
"KB" = (
/obj/structure/window/paperframe,
/obj/structure/railing{
	dir = 4
	},
/obj/machinery/door/poddoor/multi_tile/two_tile_ver{
	resistance_flags = 115
	},
/turf/open/floor/bamboo,
/area/violence)
"KI" = (
/obj/structure/railing/corner,
/obj/machinery/door/poddoor/multi_tile/two_tile_ver{
	resistance_flags = 115
	},
/turf/open/floor/bamboo,
/area/violence)
"LM" = (
/obj/structure/railing{
	dir = 1
	},
/turf/open/floor/bamboo,
/area/violence)
"MJ" = (
/obj/structure/deployable_barricade/wooden{
	dir = 4
	},
/turf/open/floor/bamboo,
/area/violence)
"Nm" = (
/obj/effect/turf_decal/box/red/corners,
/turf/open/floor/carpet/green,
/area/violence)
"Np" = (
/obj/structure/mineral_door/paperframe,
/obj/structure/railing/corner{
	dir = 4
	},
/turf/open/floor/bamboo,
/area/violence)
"OR" = (
/obj/effect/landmark/start/combatant/red,
/turf/open/floor/bamboo,
/area/violence)
"OX" = (
/obj/structure/flora/grass/jungle/b,
/turf/open/floor/plating/grass/jungle,
/area/violence)
"Pw" = (
/obj/structure/headpike/bamboo,
/turf/open/floor/plating/grass/jungle,
/area/violence)
"PP" = (
/obj/structure/chair/stool/bamboo,
/obj/effect/landmark/start/combatant/blue,
/turf/open/floor/bamboo,
/area/violence)
"Rl" = (
/obj/effect/landmark/observer_start,
/turf/open/floor/carpet/green,
/area/violence)
"St" = (
/obj/structure/mineral_door/paperframe,
/obj/structure/railing/corner{
	dir = 1
	},
/turf/open/floor/bamboo,
/area/violence)
"Ta" = (
/obj/structure/deployable_barricade/wooden{
	dir = 1
	},
/turf/open/floor/bamboo,
/area/violence)
"Tk" = (
/obj/structure/railing/corner,
/turf/open/floor/bamboo,
/area/violence)
"TQ" = (
/obj/structure/window/paperframe,
/obj/structure/railing{
	dir = 1
	},
/obj/machinery/door/poddoor/multi_tile/two_tile_hor{
	resistance_flags = 115
	},
/turf/open/floor/bamboo,
/area/violence)
"Xv" = (
/obj/structure/window/paperframe,
/obj/structure/railing{
	dir = 4
	},
/turf/open/floor/bamboo,
/area/violence)
"XA" = (
/obj/structure/mineral_door/paperframe,
/obj/structure/railing/corner,
/turf/open/floor/bamboo,
/area/violence)
"ZA" = (
/obj/structure/window/paperframe,
/turf/open/floor/bamboo,
/area/violence)

(1,1,1) = {"
rz
rz
rz
rz
rz
rz
rz
rz
rz
rz
rz
rz
rz
rz
rz
rz
rz
rz
rz
rz
rz
rz
rz
rz
rz
rz
rz
rz
rz
rz
rz
rz
rz
rz
rz
rz
rz
rz
rz
ez
"}
(2,1,1) = {"
rz
aI
aI
aI
aI
aI
aI
aI
aI
aI
aI
aI
aI
aI
aI
aI
aI
aI
aI
aI
aI
aI
aI
aI
aI
aI
aI
aI
aI
aI
aI
aI
aI
aI
aI
aI
aI
aI
aI
rz
"}
(3,1,1) = {"
rz
aI
aI
aI
aI
aI
aI
aI
aI
aI
aI
aI
aI
aI
aI
aI
aI
aI
aI
aI
aI
aI
aI
aI
aI
aI
aI
aI
aI
aI
aI
aI
aI
aI
aI
aI
aI
aI
aI
rz
"}
(4,1,1) = {"
rz
aI
aI
DG
wf
Er
aI
aI
aI
aI
aI
aI
aI
aI
aI
aI
aI
aI
aI
aI
aI
aI
aI
aI
aI
aI
aI
aI
aI
aI
cD
IW
BO
wX
IW
BO
cD
aI
aI
rz
"}
(5,1,1) = {"
rz
aI
aI
wf
cD
IW
IW
IW
cD
IW
IW
IW
IW
IW
IW
IW
IW
IW
cD
IW
IW
cD
IW
IW
IW
IW
IW
IW
IW
IW
pt
mz
mz
mz
mz
mz
rL
aI
aI
rz
"}
(6,1,1) = {"
rz
aI
aI
OX
om
JG
JG
JG
iS
JG
JG
JG
JG
JG
JG
JG
JG
JG
Ta
JG
JG
JG
JG
JG
JG
JG
JG
JG
Ta
JG
JG
OR
OR
OR
OR
mz
gc
aI
aI
rz
"}
(7,1,1) = {"
rz
aI
aI
aI
om
JG
JG
JG
iS
JG
JG
JG
JG
JG
JG
JG
JG
JG
Ta
JG
JG
JG
JG
JG
JG
JG
Ta
JG
JG
JG
rf
OR
OR
OR
OR
mz
qQ
aI
aI
rz
"}
(8,1,1) = {"
rz
aI
aI
aI
om
JG
JG
JG
iS
JG
JG
JG
JG
JG
JG
JG
JG
JG
Ta
JG
JG
JG
JG
JG
JG
JG
JG
JG
Ta
JG
yy
OR
OR
OR
OR
mz
rL
aI
aI
rz
"}
(9,1,1) = {"
rz
aI
aI
aI
cD
JG
JG
JG
cD
Xv
Xv
Xv
Xv
Xv
Xv
Xv
Xv
Xv
cD
Np
XA
cD
Xv
Xv
Xv
Xv
Xv
Xv
Xv
Xv
fx
OR
OR
OR
OR
mz
gc
aI
aI
rz
"}
(10,1,1) = {"
rz
aI
aI
aI
om
JG
JG
JG
gc
jM
OX
aI
aI
aI
aI
aI
aI
aI
aI
LM
dZ
aI
aI
aI
aI
aI
aI
aI
aI
aI
cD
fx
be
rf
JG
KI
cD
aI
aI
rz
"}
(11,1,1) = {"
rz
aI
aI
aI
om
JG
JG
JG
gc
uy
aI
aI
aI
aI
aI
aI
aI
aI
aI
LM
dZ
aI
aI
aI
aI
aI
aI
aI
aI
aI
aI
om
JG
JG
JG
gc
aI
aI
aI
rz
"}
(12,1,1) = {"
rz
aI
aI
aI
om
JG
JG
JG
gc
aI
aI
aI
aI
aI
aI
aI
aI
aI
aI
LM
dZ
aI
aI
aI
aI
wf
wf
wf
aI
aI
aI
om
MJ
JG
MJ
gc
aI
aI
aI
rz
"}
(13,1,1) = {"
rz
aI
aI
aI
om
JG
JG
JG
gc
aI
aI
aI
aI
aI
aI
aI
aI
aI
aI
LM
dZ
aI
aI
aI
aI
wf
ll
wf
aI
aI
aI
om
JG
JG
JG
gc
aI
aI
aI
rz
"}
(14,1,1) = {"
rz
aI
aI
aI
om
JG
JG
JG
gc
aI
aI
aI
aI
FX
aI
aI
aI
aI
aI
LM
dZ
aI
aI
aI
aI
wf
wf
wf
aI
aI
aI
om
JG
MJ
JG
gc
aI
aI
aI
rz
"}
(15,1,1) = {"
rz
aI
aI
aI
om
JG
JG
JG
gc
aI
aI
aI
aI
aI
aI
aI
aI
aI
aI
LM
dZ
aI
aI
aI
aI
aI
aI
aI
aI
aI
aI
om
JG
JG
JG
gc
aI
aI
aI
rz
"}
(16,1,1) = {"
rz
aI
aI
aI
om
JG
JG
JG
gc
aI
aI
aI
aI
aI
aI
aI
aI
Pw
Pw
LM
dZ
Pw
Pw
aI
aI
aI
aI
aI
aI
aI
aI
om
JG
JG
JG
gc
aI
aI
aI
rz
"}
(17,1,1) = {"
rz
aI
aI
aI
om
JG
JG
JG
gc
aI
aI
aI
aI
aI
aI
aI
cD
ZA
cD
St
qT
cD
ZA
cD
aI
aI
aI
aI
aI
aI
aI
om
JG
JG
JG
gc
aI
aI
aI
rz
"}
(18,1,1) = {"
rz
aI
aI
aI
om
JG
JG
JG
gc
aI
aI
aI
aI
aI
aI
Pw
ZA
EV
EV
JG
JG
EV
EV
ZA
Pw
aI
aI
aI
aI
aI
aI
om
JG
JG
JG
gc
aI
aI
aI
rz
"}
(19,1,1) = {"
rz
aI
aI
aI
cD
JG
JG
JG
cD
aI
aI
aI
aI
aI
aI
Pw
cD
EV
cZ
cZ
cZ
cZ
EV
cD
Pw
aI
aI
aI
aI
aI
aI
cD
JG
MJ
MJ
cD
aI
aI
aI
rz
"}
(20,1,1) = {"
rz
aI
aI
aI
om
JG
JG
JG
qT
Jj
Jj
Jj
Jj
Jj
Jj
Jj
St
JG
Nm
Rl
Ai
cZ
JG
qT
Jj
Jj
Jj
Jj
Jj
Jj
Jj
St
JG
JG
JG
gc
aI
aI
aI
rz
"}
(21,1,1) = {"
rz
aI
aI
aI
om
JG
JG
JG
XA
fR
fR
fR
fR
fR
fR
fR
Np
JG
cZ
jK
cZ
cZ
JG
XA
fR
fR
fR
fR
fR
fR
fR
Np
JG
JG
JG
gc
aI
aI
aI
rz
"}
(22,1,1) = {"
rz
aI
aI
aI
cD
CU
CU
JG
cD
aI
aI
aI
aI
aI
aI
Pw
cD
EV
sW
cZ
wk
cZ
EV
cD
Pw
aI
aI
aI
aI
aI
aI
cD
JG
JG
JG
cD
aI
aI
aI
rz
"}
(23,1,1) = {"
rz
aI
aI
aI
om
JG
JG
JG
gc
aI
aI
aI
aI
aI
aI
Pw
ZA
EV
EV
JG
JG
EV
EV
ZA
Pw
aI
aI
aI
aI
aI
aI
om
JG
JG
JG
gc
aI
aI
aI
rz
"}
(24,1,1) = {"
rz
aI
aI
aI
om
JG
JG
JG
gc
aI
aI
aI
aI
aI
aI
aI
cD
ZA
cD
Np
XA
cD
ZA
cD
aI
aI
aI
aI
aI
aI
aI
om
JG
JG
JG
gc
aI
aI
aI
rz
"}
(25,1,1) = {"
rz
aI
aI
aI
om
JG
JG
JG
gc
aI
aI
aI
aI
aI
aI
aI
aI
Pw
Pw
LM
dZ
Pw
Pw
aI
aI
aI
aI
aI
aI
aI
aI
om
JG
JG
JG
gc
aI
aI
aI
rz
"}
(26,1,1) = {"
rz
aI
aI
aI
om
JG
JG
JG
gc
aI
aI
aI
aI
aI
aI
aI
aI
aI
aI
LM
dZ
aI
aI
aI
aI
aI
aI
aI
aI
aI
aI
om
JG
JG
JG
gc
aI
aI
aI
rz
"}
(27,1,1) = {"
rz
aI
aI
aI
om
JG
CU
JG
gc
aI
aI
aI
wf
wf
wf
aI
aI
aI
aI
LM
dZ
aI
aI
aI
aI
aI
FX
aI
aI
aI
aI
om
JG
JG
JG
gc
aI
aI
aI
rz
"}
(28,1,1) = {"
rz
aI
aI
aI
om
JG
JG
JG
gc
aI
aI
aI
wf
ll
wf
aI
aI
aI
aI
LM
dZ
aI
aI
aI
aI
aI
aI
aI
aI
aI
aI
om
JG
JG
JG
gc
aI
aI
aI
rz
"}
(29,1,1) = {"
rz
aI
aI
aI
om
CU
JG
CU
gc
aI
aI
aI
wf
wf
wf
aI
aI
aI
aI
LM
dZ
aI
aI
aI
aI
aI
aI
aI
aI
aI
aI
om
JG
JG
JG
gc
aI
aI
aI
rz
"}
(30,1,1) = {"
rz
aI
aI
aI
om
JG
JG
JG
gc
aI
aI
aI
aI
aI
aI
aI
aI
aI
aI
LM
dZ
aI
aI
aI
aI
aI
aI
aI
aI
aI
uy
om
JG
JG
JG
gc
aI
aI
aI
rz
"}
(31,1,1) = {"
rz
aI
aI
cD
GO
be
rf
JG
Ex
cD
aI
aI
aI
aI
aI
aI
aI
aI
aI
LM
dZ
aI
aI
aI
aI
aI
aI
aI
aI
wf
jM
om
JG
JG
JG
gc
aI
aI
aI
rz
"}
(32,1,1) = {"
rz
aI
aI
TQ
PP
vJ
vJ
vJ
vJ
nC
IW
IW
IW
IW
IW
IW
IW
IW
cD
St
qT
cD
IW
IW
IW
IW
IW
IW
IW
IW
IW
cD
JG
JG
JG
cD
aI
aI
aI
rz
"}
(33,1,1) = {"
rz
aI
aI
om
PP
vJ
vJ
vJ
vJ
JG
JG
iS
JG
JG
JG
JG
JG
JG
JG
JG
JG
iS
JG
JG
JG
JG
JG
JG
JG
JG
JG
Ta
JG
JG
JG
gc
aI
aI
aI
rz
"}
(34,1,1) = {"
rz
aI
aI
IJ
PP
vJ
vJ
vJ
vJ
rf
JG
JG
JG
iS
JG
JG
JG
JG
JG
JG
JG
iS
JG
JG
JG
JG
JG
JG
JG
JG
JG
Ta
JG
JG
JG
gc
aI
aI
aI
rz
"}
(35,1,1) = {"
rz
aI
aI
TQ
PP
vJ
vJ
vJ
vJ
yy
JG
iS
JG
JG
JG
JG
JG
JG
JG
JG
JG
iS
JG
JG
JG
JG
JG
JG
JG
JG
JG
Ta
JG
JG
JG
gc
wf
aI
aI
rz
"}
(36,1,1) = {"
rz
aI
aI
om
PP
PP
PP
PP
PP
Tk
Xv
Xv
Xv
Xv
Xv
Xv
Xv
Xv
cD
Xv
Xv
cD
Xv
Xv
Xv
Xv
Xv
Xv
Xv
Xv
Xv
cD
Xv
Xv
Xv
cD
OX
aI
aI
rz
"}
(37,1,1) = {"
rz
aI
aI
cD
Xv
KB
sf
Xv
KB
cD
aI
aI
aI
aI
aI
aI
aI
aI
aI
aI
aI
aI
aI
aI
aI
aI
aI
aI
aI
aI
aI
aI
aI
aI
Er
wf
DG
aI
aI
rz
"}
(38,1,1) = {"
rz
aI
aI
aI
aI
aI
aI
aI
aI
aI
aI
aI
aI
aI
aI
aI
aI
aI
aI
aI
aI
aI
aI
aI
aI
aI
aI
aI
aI
aI
aI
aI
aI
aI
aI
aI
aI
aI
aI
rz
"}
(39,1,1) = {"
rz
aI
aI
aI
aI
aI
aI
aI
aI
aI
aI
aI
aI
aI
aI
aI
aI
aI
aI
aI
aI
aI
aI
aI
aI
aI
aI
aI
aI
aI
aI
aI
aI
aI
aI
aI
aI
aI
aI
rz
"}
(40,1,1) = {"
rz
rz
rz
rz
rz
rz
rz
rz
rz
rz
rz
rz
rz
rz
rz
rz
rz
rz
rz
rz
rz
rz
rz
rz
rz
rz
rz
rz
rz
rz
rz
rz
rz
rz
rz
rz
rz
rz
rz
rz
"}
