//MAP CONVERTED BY dmm2tgm.py THIS HEADER COMMENT PREVENTS RECONVERSION, DO NOT REMOVE
"ax" = (
/turf/open/floor/rospilovo/plitka/old,
/area/violence)
"aP" = (
/obj/effect/turf_decal/siding/white{
	dir = 4
	},
/obj/structure/deployable_barricade/sandbags{
	dir = 1
	},
/turf/open/floor/rospilovo,
/area/violence)
"bq" = (
/obj/structure/rospilovo/battery{
	dir = 8;
	icon_state = "gazovaya_truba"
	},
/turf/open/floor/rospilovo/wood,
/area/violence)
"bs" = (
/obj/structure/mineral_door/wood{
	color = "#aaaaaa";
	name = "деревянная дверь"
	},
/turf/open/floor/rospilovo/wood,
/area/violence)
"cc" = (
/obj/effect/landmark/start/combatant/blue,
/obj/effect/turf_decal/siding/white{
	dir = 8
	},
/turf/open/floor/rospilovo,
/area/violence)
"cC" = (
/obj/structure/rospilovo/yashik,
/turf/open/floor/rospilovo/wood,
/area/violence)
"cT" = (
/obj/structure/rospilovo/doski/doski4,
/turf/open/floor/rospilovo/wood,
/area/violence)
"dg" = (
/obj/structure/rospilovo/tree{
	icon_state = "derevo5"
	},
/turf/open/floor/grass/rospilovo,
/area/violence)
"dA" = (
/obj/structure/rospilovo/tree,
/turf/open/floor/grass/gensgrass/dirty,
/area/violence)
"dU" = (
/obj/structure/deployable_barricade/sandbags{
	dir = 1
	},
/obj/structure/deployable_barricade/sandbags{
	dir = 8
	},
/turf/open/floor/rospilovo/plitka{
	icon_state = "plita4"
	},
/area/violence)
"ed" = (
/obj/structure/rospilovo/doski/doski4,
/obj/structure/rospilovo/doski,
/turf/open/floor/rospilovo/wood,
/area/violence)
"ex" = (
/turf/template_noop,
/area/template_noop)
"eA" = (
/obj/structure/rospilovo/vanna,
/turf/open/floor/rospilovo/plitka/old,
/area/violence)
"eB" = (
/obj/structure/rospilovo/musor_yashik/red,
/turf/open/floor/grass/rospilovo,
/area/violence)
"eO" = (
/obj/structure/rospilovo/doski/doski2,
/turf/open/floor/rospilovo/wood,
/area/violence)
"eV" = (
/obj/machinery/door/poddoor/multi_tile/two_tile_hor{
	resistance_flags = 115
	},
/obj/effect/turf_decal/siding/white{
	dir = 4
	},
/turf/open/floor/rospilovo,
/area/violence)
"fw" = (
/obj/effect/landmark/start/combatant/red,
/turf/open/floor/rospilovo/plitka{
	icon_state = "plita4"
	},
/area/violence)
"fI" = (
/obj/structure/rospilovo/musor_yashik/green,
/turf/open/floor/rospilovo/plitka{
	icon_state = "plita4"
	},
/area/violence)
"fP" = (
/obj/structure/rospilovo/leest,
/turf/open/floor/grass/rospilovo,
/area/violence)
"fS" = (
/obj/structure/rospilovo/doski/doski3,
/turf/open/floor/rospilovo/wood,
/area/violence)
"gc" = (
/obj/structure/rospilovo/yashik/yaskik_a/big,
/turf/open/floor/rospilovo/plitka/old,
/area/violence)
"gh" = (
/obj/effect/turf_decal/trimline/white/line{
	dir = 4;
	icon_state = "trimline"
	},
/obj/effect/turf_decal/trimline/white/line{
	dir = 8;
	icon_state = "trimline"
	},
/obj/structure/deployable_barricade/sandbags{
	dir = 1
	},
/turf/open/floor/rospilovo,
/area/violence)
"gB" = (
/obj/structure/deployable_barricade/metal,
/turf/open/floor/grass/gensgrass/dirty,
/area/violence)
"gQ" = (
/obj/effect/turf_decal/box/red/corners{
	dir = 1
	},
/turf/open/floor/rospilovo/wood,
/area/violence)
"hc" = (
/obj/effect/turf_decal/siding/white{
	dir = 4
	},
/obj/structure/rospilovo/doski/doski2,
/turf/open/floor/rospilovo,
/area/violence)
"hf" = (
/obj/structure/rospilovo/vanna,
/turf/open/floor/rospilovo/wood,
/area/violence)
"hn" = (
/obj/structure/rospilovo/televizor/broken,
/turf/open/floor/grass/gensgrass/dirty,
/area/violence)
"hu" = (
/obj/structure/rospilovo/doski,
/obj/structure/rospilovo/polka{
	dir = 4;
	icon_state = "polka"
	},
/turf/open/floor/rospilovo/wood,
/area/violence)
"hI" = (
/turf/closed/indestructible/black,
/area/violence)
"if" = (
/obj/item/chair/wood,
/turf/open/floor/rospilovo/wood,
/area/violence)
"iW" = (
/obj/structure/rospilovo/bochka,
/turf/open/floor/rospilovo/wood,
/area/violence)
"jd" = (
/obj/structure/rospilovo/battery{
	dir = 4;
	icon_state = "gazovaya_truba"
	},
/turf/open/floor/rospilovo/wood,
/area/violence)
"jN" = (
/obj/structure/rospilovo/doski,
/obj/effect/turf_decal/box/red/corners{
	dir = 8
	},
/turf/open/floor/rospilovo/wood,
/area/violence)
"jO" = (
/obj/structure/rospilovo/polka,
/turf/open/floor/rospilovo/wood,
/area/violence)
"ka" = (
/obj/structure/rospilovo/tree{
	icon_state = "derevo4"
	},
/turf/open/floor/grass/rospilovo,
/area/violence)
"kf" = (
/obj/structure/rospilovo/painting/lenin,
/turf/closed/wall/rospilovo/bricks,
/area/violence)
"lR" = (
/obj/effect/turf_decal/box/red/corners,
/turf/open/floor/rospilovo/wood,
/area/violence)
"lT" = (
/obj/structure/table/rospilovo,
/obj/structure/rospilovo/televizor,
/turf/open/floor/rospilovo/wood,
/area/violence)
"ma" = (
/obj/structure/rospilovo/bochka/red,
/turf/open/floor/rospilovo/wood,
/area/violence)
"mk" = (
/obj/effect/landmark/start/combatant/red,
/obj/effect/turf_decal/siding/white{
	dir = 8
	},
/turf/open/floor/rospilovo,
/area/violence)
"mn" = (
/obj/effect/landmark/start/combatant/red,
/turf/open/floor/rospilovo,
/area/violence)
"nc" = (
/obj/effect/turf_decal/trimline/white/line{
	dir = 4;
	icon_state = "trimline"
	},
/obj/effect/turf_decal/trimline/white/line{
	dir = 8;
	icon_state = "trimline"
	},
/obj/effect/landmark/start/combatant/red,
/turf/open/floor/rospilovo,
/area/violence)
"ny" = (
/obj/structure/rospilovo/doski/doski3,
/turf/open/floor/grass/rospilovo,
/area/violence)
"nM" = (
/obj/structure/rospilovo/yashik/yaskik_a,
/turf/open/floor/rospilovo/plitka/old,
/area/violence)
"ob" = (
/obj/effect/landmark/start/combatant/blue,
/obj/effect/turf_decal/siding/white{
	dir = 4
	},
/turf/open/floor/rospilovo,
/area/violence)
"oB" = (
/obj/structure/rospilovo/switcher,
/turf/closed/wall/rospilovo/bricks,
/area/violence)
"oI" = (
/obj/structure/deployable_barricade/sandbags{
	dir = 1
	},
/turf/open/floor/rospilovo,
/area/violence)
"oL" = (
/obj/structure/fluff/rospilovo,
/turf/open/floor/grass/rospilovo,
/area/violence)
"oR" = (
/obj/effect/landmark/start/combatant/red,
/obj/effect/turf_decal/siding/white{
	dir = 4
	},
/turf/open/floor/rospilovo,
/area/violence)
"pc" = (
/turf/open/floor/grass/rospilovo,
/area/violence)
"pw" = (
/obj/structure/rospilovo/switcher,
/turf/closed/wall/rospilovo/bricks_white,
/area/violence)
"pF" = (
/turf/open/floor/rospilovo/plitka{
	icon_state = "plita4"
	},
/area/violence)
"pR" = (
/obj/structure/rospilovo/yashik,
/turf/open/floor/rospilovo/plitka{
	icon_state = "plita4"
	},
/area/violence)
"qk" = (
/obj/effect/turf_decal/trimline/white/line{
	dir = 4;
	icon_state = "trimline"
	},
/obj/effect/turf_decal/trimline/white/line{
	dir = 8;
	icon_state = "trimline"
	},
/turf/closed/indestructible/black,
/area/violence)
"qn" = (
/obj/structure/deployable_barricade/sandbags{
	dir = 1
	},
/obj/structure/deployable_barricade/sandbags{
	dir = 4
	},
/turf/open/floor/rospilovo/plitka{
	icon_state = "plita4"
	},
/area/violence)
"qw" = (
/obj/structure/deployable_barricade/metal,
/turf/open/floor/rospilovo/plitka/full,
/area/violence)
"qx" = (
/obj/structure/rospilovo/bar_plitka{
	icon_state = "bar_plate3"
	},
/turf/open/floor/grass/rospilovo,
/area/violence)
"qC" = (
/obj/effect/turf_decal/box/red/corners{
	dir = 4
	},
/turf/open/floor/rospilovo/wood,
/area/violence)
"sn" = (
/obj/structure/rospilovo/televizor/broken,
/turf/open/floor/rospilovo/wood,
/area/violence)
"sw" = (
/obj/structure/rospilovo/polka{
	dir = 4;
	icon_state = "polka"
	},
/turf/open/floor/rospilovo/wood,
/area/violence)
"sO" = (
/obj/effect/landmark/start/combatant/blue,
/turf/open/floor/rospilovo/plitka{
	icon_state = "plita4"
	},
/area/violence)
"sS" = (
/obj/structure/deployable_barricade/metal{
	dir = 8
	},
/turf/open/floor/grass/rospilovo,
/area/violence)
"ts" = (
/obj/structure/rospilovo/water/bochka/kap,
/turf/open/floor/rospilovo/plitka/old,
/area/violence)
"tu" = (
/obj/structure/rospilovo/porog{
	dir = 1;
	icon_state = "porog1"
	},
/turf/open/floor/rospilovo/plitka/old,
/area/violence)
"uk" = (
/obj/structure/rospilovo/tree{
	icon_state = "derevo5"
	},
/turf/open/floor/grass/gensgrass/dirty,
/area/violence)
"uW" = (
/obj/structure/rospilovo/yashik,
/turf/open/floor/rospilovo/plitka/old,
/area/violence)
"vk" = (
/obj/structure/rospilovo/tree{
	icon_state = "derevo4"
	},
/obj/structure/rospilovo/shina2,
/turf/open/floor/grass/rospilovo,
/area/violence)
"vz" = (
/obj/structure/sink{
	pixel_y = 32
	},
/turf/open/floor/rospilovo/plitka/old,
/area/violence)
"xe" = (
/obj/structure/rospilovo/stolb,
/turf/open/floor/rospilovo/plitka{
	icon_state = "plita4"
	},
/area/violence)
"xn" = (
/obj/structure/rospilovo/luk,
/turf/open/floor/rospilovo/plitka{
	icon_state = "plita4"
	},
/area/violence)
"xx" = (
/obj/structure/deployable_barricade/metal{
	dir = 1
	},
/turf/open/floor/grass/gensgrass/dirty,
/area/violence)
"xW" = (
/obj/structure/rospilovo/komod,
/obj/structure/rospilovo/cover{
	pixel_y = 32
	},
/turf/open/floor/rospilovo/wood,
/area/violence)
"yC" = (
/turf/open/floor/rospilovo,
/area/violence)
"yX" = (
/obj/effect/turf_decal/siding/white{
	dir = 4
	},
/turf/open/floor/rospilovo,
/area/violence)
"zx" = (
/obj/structure/rospilovo/tree{
	icon_state = "derevo3"
	},
/turf/open/floor/grass/gensgrass/dirty,
/area/violence)
"zJ" = (
/turf/closed/wall/rospilovo/bricks,
/area/violence)
"zR" = (
/obj/structure/rospilovo/yashik/yaskik_a/big,
/turf/open/floor/rospilovo/wood,
/area/violence)
"Aw" = (
/obj/machinery/door/poddoor/multi_tile/three_tile_hor{
	resistance_flags = 115
	},
/turf/open/floor/rospilovo,
/area/violence)
"Bl" = (
/obj/structure/rospilovo/bar_plitka{
	icon_state = "bar_plate4"
	},
/turf/open/floor/grass/rospilovo,
/area/violence)
"BA" = (
/obj/structure/bed,
/obj/item/bedsheet/brown,
/turf/open/floor/rospilovo/wood,
/area/violence)
"Cn" = (
/obj/structure/rospilovo/yashik,
/turf/open/floor/grass/rospilovo,
/area/violence)
"CS" = (
/obj/effect/landmark/bomb_plant_location,
/obj/effect/turf_decal/box/red,
/turf/open/floor/rospilovo/wood,
/area/violence)
"Da" = (
/obj/structure/rospilovo/radiation,
/turf/open/floor/grass/rospilovo,
/area/violence)
"Dh" = (
/turf/open/floor/rospilovo/plitka/full,
/area/violence)
"Eg" = (
/obj/structure/rospilovo/shina3,
/turf/open/floor/grass/rospilovo,
/area/violence)
"Fj" = (
/obj/structure/table/rospilovo,
/turf/open/floor/rospilovo/wood,
/area/violence)
"Fk" = (
/obj/structure/rospilovo/plita,
/turf/open/floor/rospilovo/wood,
/area/violence)
"FT" = (
/obj/structure/chair/wood,
/turf/open/floor/rospilovo/wood,
/area/violence)
"Go" = (
/obj/structure/rospilovo/polka{
	dir = 8;
	icon_state = "polka"
	},
/turf/open/floor/rospilovo/wood,
/area/violence)
"Gu" = (
/obj/structure/rospilovo/yashik/yaskik_a/big,
/turf/open/floor/grass/rospilovo,
/area/violence)
"Gz" = (
/obj/effect/turf_decal/siding/white{
	dir = 4
	},
/obj/structure/rospilovo/doski,
/turf/open/floor/rospilovo,
/area/violence)
"GV" = (
/obj/structure/rospilovo/okno{
	icon_state = "okno4"
	},
/turf/closed/wall/rospilovo/bricks_white,
/area/violence)
"Ha" = (
/obj/structure/rospilovo/vanna,
/turf/open/floor/grass/rospilovo,
/area/violence)
"Hp" = (
/obj/structure/rospilovo/tree{
	icon_state = "derevo4"
	},
/obj/structure/rospilovo/yashik,
/turf/open/floor/grass/rospilovo,
/area/violence)
"HE" = (
/turf/open/floor/rospilovo/wood,
/area/violence)
"HI" = (
/obj/machinery/door/poddoor/multi_tile/two_tile_hor{
	resistance_flags = 115
	},
/turf/open/floor/rospilovo/plitka{
	icon_state = "plita4"
	},
/area/violence)
"HW" = (
/obj/structure/rospilovo/shkaf64,
/turf/open/floor/rospilovo/wood,
/area/violence)
"Ia" = (
/obj/structure/deployable_barricade/sandbags,
/obj/structure/deployable_barricade/sandbags{
	dir = 8
	},
/turf/open/floor/rospilovo/plitka{
	icon_state = "plita4"
	},
/area/violence)
"Ib" = (
/obj/structure/rospilovo/stolb,
/turf/open/floor/grass/rospilovo,
/area/violence)
"Id" = (
/obj/effect/turf_decal/trimline/white/line{
	dir = 4;
	icon_state = "trimline"
	},
/obj/effect/turf_decal/trimline/white/line{
	dir = 8;
	icon_state = "trimline"
	},
/turf/open/floor/rospilovo,
/area/violence)
"Ix" = (
/obj/machinery/shower{
	dir = 1;
	icon_state = "shower"
	},
/obj/structure/curtain,
/turf/open/floor/rospilovo/plitka/old,
/area/violence)
"IH" = (
/obj/structure/rospilovo/tree{
	icon_state = "derevo4"
	},
/turf/open/floor/grass/gensgrass/dirty,
/area/violence)
"IT" = (
/obj/structure/rospilovo/tree{
	icon_state = "derevo2"
	},
/turf/open/floor/grass/rospilovo,
/area/violence)
"IY" = (
/obj/structure/rospilovo/truba,
/turf/open/floor/rospilovo/wood,
/area/violence)
"Jh" = (
/obj/structure/rospilovo/tree{
	icon_state = "derevo3"
	},
/turf/open/floor/grass/rospilovo,
/area/violence)
"Js" = (
/obj/effect/turf_decal/siding/white{
	dir = 8
	},
/obj/structure/deployable_barricade/sandbags{
	dir = 1
	},
/turf/open/floor/rospilovo,
/area/violence)
"JN" = (
/obj/structure/rospilovo/broke_table/right,
/turf/open/floor/rospilovo/wood,
/area/violence)
"JU" = (
/obj/structure/rospilovo/doski/doski4,
/turf/open/floor/grass/rospilovo,
/area/violence)
"JY" = (
/obj/structure/rospilovo/doski,
/turf/open/floor/rospilovo/wood,
/area/violence)
"KO" = (
/obj/effect/turf_decal/siding/white{
	dir = 8
	},
/obj/structure/rospilovo/doski,
/obj/structure/deployable_barricade/sandbags,
/turf/open/floor/rospilovo,
/area/violence)
"KZ" = (
/turf/closed/wall/rospilovo/bricks_white,
/area/violence)
"LC" = (
/obj/structure/deployable_barricade/sandbags,
/turf/open/floor/rospilovo,
/area/violence)
"LH" = (
/obj/structure/rospilovo/bar_plitka,
/turf/open/floor/grass/rospilovo,
/area/violence)
"LX" = (
/obj/effect/turf_decal/trimline/white/line{
	dir = 4;
	icon_state = "trimline"
	},
/obj/effect/turf_decal/trimline/white/line{
	dir = 8;
	icon_state = "trimline"
	},
/obj/structure/deployable_barricade/sandbags,
/turf/open/floor/rospilovo,
/area/violence)
"No" = (
/obj/effect/turf_decal/siding/white{
	dir = 4
	},
/obj/structure/deployable_barricade/sandbags,
/turf/open/floor/rospilovo,
/area/violence)
"Nv" = (
/obj/structure/rospilovo/broke_table,
/obj/structure/rospilovo/painting/gorbachev{
	pixel_y = 32
	},
/turf/open/floor/rospilovo/wood,
/area/violence)
"NG" = (
/obj/structure/rospilovo/shina,
/turf/open/floor/rospilovo/wood,
/area/violence)
"NN" = (
/obj/structure/rospilovo/water/luzha,
/turf/open/floor/grass/rospilovo,
/area/violence)
"NS" = (
/obj/effect/landmark/start/combatant/blue,
/turf/open/floor/rospilovo,
/area/violence)
"Pf" = (
/obj/structure/deployable_barricade/metal{
	dir = 1
	},
/turf/open/floor/rospilovo/plitka/full,
/area/violence)
"PS" = (
/obj/structure/rospilovo/tree,
/turf/open/floor/grass/rospilovo,
/area/violence)
"Qw" = (
/obj/structure/rospilovo/komod,
/turf/open/floor/rospilovo/wood,
/area/violence)
"Qx" = (
/obj/structure/rospilovo/trubas{
	dir = 5
	},
/turf/open/floor/rospilovo/wood,
/area/violence)
"QG" = (
/obj/structure/mineral_door/wood{
	color = "#aaaaaa";
	name = "деревянная дверь"
	},
/turf/open/floor/rospilovo/plitka/old,
/area/violence)
"Rw" = (
/obj/effect/turf_decal/siding/white{
	dir = 8
	},
/turf/open/floor/rospilovo,
/area/violence)
"RL" = (
/obj/structure/rospilovo/porog{
	dir = 4
	},
/turf/open/floor/grass/rospilovo,
/area/violence)
"RN" = (
/obj/structure/rospilovo/doski/doski3,
/turf/open/floor/rospilovo,
/area/violence)
"Sl" = (
/obj/structure/deployable_barricade/sandbags,
/obj/structure/deployable_barricade/sandbags{
	dir = 4
	},
/turf/open/floor/rospilovo/plitka{
	icon_state = "plita4"
	},
/area/violence)
"Ub" = (
/obj/structure/table/rospilovo,
/obj/structure/rospilovo/radio{
	pixel_y = 11
	},
/turf/open/floor/rospilovo/wood,
/area/violence)
"Uu" = (
/obj/structure/rospilovo/shina,
/turf/open/floor/grass/rospilovo,
/area/violence)
"Va" = (
/obj/structure/rospilovo/water/bochka/kap,
/turf/open/floor/grass/rospilovo,
/area/violence)
"Vo" = (
/obj/structure/chair/wood{
	dir = 1;
	icon_state = "wooden_chair"
	},
/turf/open/floor/rospilovo/wood,
/area/violence)
"VH" = (
/obj/structure/deployable_barricade/metal,
/turf/open/floor/grass/rospilovo,
/area/violence)
"Wm" = (
/obj/structure/rospilovo/rozetka,
/turf/closed/wall/rospilovo/bricks,
/area/violence)
"Ws" = (
/obj/structure/chair/wood{
	dir = 4;
	icon_state = "wooden_chair"
	},
/turf/open/floor/rospilovo/wood,
/area/violence)
"WE" = (
/obj/structure/rospilovo/pech,
/turf/open/floor/rospilovo/wood,
/area/violence)
"XC" = (
/obj/structure/rospilovo/trubas,
/turf/open/floor/rospilovo/wood,
/area/violence)
"Ye" = (
/obj/structure/rospilovo/yashik/yaskik_a,
/turf/open/floor/rospilovo/wood,
/area/violence)
"Yo" = (
/obj/structure/toilet/greyscale,
/turf/open/floor/rospilovo/plitka/old,
/area/violence)
"Yv" = (
/obj/structure/rospilovo/bar_plitka{
	icon_state = "bar_plate2"
	},
/turf/open/floor/grass/rospilovo,
/area/violence)
"YW" = (
/turf/open/floor/grass/gensgrass/dirty,
/area/violence)
"ZO" = (
/obj/effect/turf_decal/trimline/white/line{
	dir = 4;
	icon_state = "trimline"
	},
/obj/effect/turf_decal/trimline/white/line{
	dir = 8;
	icon_state = "trimline"
	},
/obj/effect/landmark/start/combatant/blue,
/turf/open/floor/rospilovo,
/area/violence)

(1,1,1) = {"
ex
ex
ex
ex
ex
hI
hI
hI
hI
hI
hI
hI
hI
hI
hI
hI
hI
hI
hI
hI
hI
hI
hI
hI
hI
hI
hI
hI
hI
hI
hI
hI
hI
hI
hI
hI
hI
hI
hI
hI
hI
hI
hI
hI
hI
hI
hI
hI
hI
hI
hI
hI
hI
hI
hI
hI
hI
hI
hI
hI
hI
hI
hI
hI
hI
ex
ex
ex
ex
ex
"}
(2,1,1) = {"
ex
ex
ex
ex
ex
hI
KZ
Yv
pc
PS
Jh
pc
KZ
GV
KZ
KZ
KZ
GV
KZ
KZ
KZ
GV
KZ
KZ
GV
KZ
KZ
KZ
KZ
KZ
KZ
KZ
KZ
KZ
KZ
KZ
KZ
KZ
KZ
KZ
KZ
KZ
KZ
KZ
KZ
KZ
KZ
KZ
GV
KZ
KZ
KZ
GV
KZ
KZ
KZ
GV
KZ
pc
PS
Jh
pc
Yv
KZ
hI
ex
ex
ex
ex
ex
"}
(3,1,1) = {"
ex
ex
ex
ex
ex
hI
KZ
Yv
pc
pc
pc
pc
pc
ka
pc
PS
pc
pc
pc
pc
ka
pc
PS
pc
ka
pc
pc
pc
dg
pc
pc
pc
pc
pc
pc
pc
pc
ka
pc
pc
pc
pc
pc
Jh
pc
pc
pc
pc
pc
ka
pc
PS
pc
ka
pc
pc
pc
pc
Ib
pc
pc
pc
Yv
KZ
hI
ex
ex
ex
ex
ex
"}
(4,1,1) = {"
ex
ex
ex
ex
ex
hI
KZ
LH
pc
ka
pc
pc
dg
pc
pc
pc
pc
Jh
pc
dg
pc
pc
pc
pc
pc
pc
pc
pc
pc
pc
pc
Jh
pc
ka
pc
pc
pc
pc
pc
pc
pc
PS
pc
pc
pc
PS
Jh
pc
dg
pc
pc
pc
pc
pc
PS
Jh
pc
dg
pc
vk
pc
pc
LH
KZ
hI
ex
ex
ex
ex
ex
"}
(5,1,1) = {"
ex
ex
ex
ex
ex
hI
KZ
LH
pc
pc
pc
pc
pc
pc
pc
ka
pc
VH
pc
pc
pc
pc
ka
pc
pc
pc
pc
ka
pc
pc
dg
pc
pc
pc
pc
Jh
pc
pc
PS
pc
dg
pc
pc
pc
pc
pc
pc
pc
pc
pc
pc
ka
pc
pc
pc
pc
pc
pc
pc
pc
ka
pc
LH
KZ
hI
ex
ex
ex
ex
ex
"}
(6,1,1) = {"
ex
ex
ex
ex
ex
hI
GV
LH
pc
ka
pc
pc
Jh
pc
dg
ny
pc
pc
pc
Jh
pc
dg
pc
pc
Jh
pc
pc
pc
pc
pc
pc
pc
pc
pc
pc
dg
pc
pc
pc
pc
pc
pc
pc
pc
pc
ka
pc
pc
Jh
pc
dg
pc
pc
pc
ka
pc
pc
Jh
pc
dg
pc
pc
LH
GV
hI
ex
ex
ex
ex
ex
"}
(7,1,1) = {"
ex
ex
ex
ex
ex
hI
KZ
LH
dg
pc
pc
PS
pc
pc
NN
pc
PS
pc
pc
pc
pc
pc
pc
PS
pc
pc
pc
pc
dg
pc
pc
PS
pc
pc
pc
pc
pc
pc
ka
pc
pc
pc
pc
PS
pc
pc
pc
PS
pc
pc
pc
pc
pc
dg
pc
pc
PS
pc
pc
pc
pc
pc
LH
KZ
hI
ex
ex
ex
ex
ex
"}
(8,1,1) = {"
ex
ex
ex
ex
ex
hI
KZ
Yv
pc
pc
pc
pc
pc
dg
pc
pc
pc
PS
pc
YW
dg
pc
pc
pc
Uu
pc
pc
pc
pc
RL
RL
pc
pc
pc
pc
pc
pc
pc
pc
pc
pc
pc
pc
pc
pc
pc
pc
YW
YW
Cn
pc
pc
pc
pc
pc
pc
pc
pc
pc
pc
pc
pc
Yv
KZ
hI
ex
ex
ex
ex
ex
"}
(9,1,1) = {"
ex
ex
ex
ex
ex
hI
KZ
Yv
pc
pc
pc
Jh
zJ
zJ
zJ
zJ
zJ
zJ
zJ
YW
YW
zJ
zJ
zJ
zJ
zJ
zJ
zJ
zJ
QG
QG
zJ
zJ
zJ
zJ
zJ
zJ
zJ
zJ
zJ
zJ
zJ
zJ
zJ
zJ
zJ
zJ
YW
YW
zJ
zJ
zJ
zJ
zJ
zJ
zJ
zJ
zJ
pc
IT
pc
pc
Yv
KZ
hI
ex
ex
ex
ex
ex
"}
(10,1,1) = {"
ex
ex
ex
ex
ex
hI
GV
Yv
Jh
pc
uk
pc
zJ
sw
sw
sw
XC
cC
zJ
hn
YW
jd
HE
zJ
Fk
HE
Ws
HE
zJ
ax
ax
zJ
jO
HE
jd
HE
zJ
Fk
HE
Ws
HE
zJ
HE
cT
HE
HE
zJ
iW
YW
sw
hu
zJ
XC
HE
HE
HE
HE
zJ
pc
pc
pc
pc
Yv
GV
hI
ex
ex
ex
ex
ex
"}
(11,1,1) = {"
ex
ex
ex
ex
ex
hI
KZ
LH
pc
pc
YW
YW
YW
YW
HE
HE
XC
HE
zJ
Nv
YW
YW
HE
Wm
Fj
HE
Fj
Vo
zJ
ax
ax
zJ
Fj
HE
HE
HE
Wm
lT
HE
Fj
if
zJ
FT
Fj
Fj
HE
zJ
sn
ed
HE
ma
zJ
XC
HE
HE
HE
HE
YW
YW
pc
pc
pc
LH
KZ
hI
ex
ex
ex
ex
ex
"}
(12,1,1) = {"
ex
ex
ex
ex
ex
hI
KZ
Bl
pc
IT
pc
YW
YW
YW
HE
HE
XC
HE
zJ
JN
if
cT
HE
bs
HE
HE
Ub
HE
zJ
ax
ax
zJ
Fj
Vo
cT
HE
bs
HE
HE
Fj
Vo
zJ
HE
Fj
Fj
HE
bs
HE
HE
HE
HE
zJ
XC
HE
HE
HE
YW
YW
YW
YW
pc
pc
LH
KZ
hI
ex
ex
ex
ex
ex
"}
(13,1,1) = {"
ex
ex
ex
ex
ex
hI
KZ
Yv
pc
pc
pc
YW
YW
YW
YW
HE
XC
HE
zJ
xW
HE
HE
HE
oB
HE
HE
fS
HE
zJ
ax
ax
zJ
Qw
HE
HE
HE
zJ
HE
HE
fS
HE
YW
fS
HE
HE
HE
zJ
HE
eO
HE
iW
zJ
XC
HE
HE
YW
YW
YW
YW
YW
PS
pc
Yv
KZ
hI
ex
ex
ex
ex
ex
"}
(14,1,1) = {"
ex
ex
ex
ex
ex
hI
GV
LH
pc
pc
pc
PS
YW
YW
YW
HE
XC
HE
zJ
BA
HE
HE
Go
Wm
IY
HE
HE
HE
zJ
ax
ax
zJ
BA
HE
HE
Go
zJ
IY
lR
HE
qC
YW
YW
hf
HE
HE
zJ
iW
Qw
ma
Qw
zJ
XC
HE
HE
YW
YW
YW
YW
YW
pc
pc
LH
GV
hI
ex
ex
ex
ex
ex
"}
(15,1,1) = {"
ex
ex
ex
ex
ex
hI
KZ
LH
pc
pc
IT
pc
zJ
YW
YW
YW
XC
HE
zJ
zJ
zJ
zJ
zJ
kf
HE
HE
HE
HE
zJ
ax
ax
zJ
zJ
zJ
zJ
zJ
zJ
HW
HE
CS
YW
YW
HE
eO
HE
HE
zJ
zJ
zJ
zJ
zJ
zJ
XC
HE
HE
YW
YW
YW
YW
pc
ka
pc
LH
KZ
hI
ex
ex
ex
ex
ex
"}
(16,1,1) = {"
ex
ex
ex
ex
ex
hI
KZ
Yv
pc
pc
pc
ka
zJ
YW
YW
YW
XC
HE
zJ
Yo
ax
ax
QG
HE
HE
JY
HE
HE
bs
tu
YW
zJ
Yo
ax
ax
QG
HE
HE
jN
HE
gQ
zJ
HE
fS
eO
HE
HE
QG
ax
ax
uW
zJ
XC
HE
YW
YW
YW
YW
YW
dg
pc
pc
Yv
KZ
hI
ex
ex
ex
ex
ex
"}
(17,1,1) = {"
ex
ex
ex
ex
ex
hI
KZ
LH
pc
Jh
pc
pc
zJ
YW
YW
HE
XC
HE
zJ
vz
eA
Ix
zJ
WE
HE
bq
HE
HE
zJ
YW
YW
zJ
vz
ax
Ix
zJ
WE
HE
bq
HE
HE
zJ
NG
HE
HE
HE
WE
zJ
nM
gc
ts
zJ
Qx
HE
YW
YW
YW
YW
pc
pc
pc
pc
LH
KZ
hI
ex
ex
ex
ex
ex
"}
(18,1,1) = {"
ex
ex
ex
ex
ex
hI
GV
LH
pc
pc
pc
pc
zJ
HE
HE
HE
XC
HE
zJ
zJ
zJ
zJ
zJ
zJ
zJ
zJ
zJ
zJ
zJ
YW
ax
zJ
zJ
zJ
zJ
zJ
zJ
zJ
zJ
bs
zJ
zJ
zJ
bs
zJ
zJ
zJ
zJ
zJ
zJ
zJ
zJ
HE
YW
YW
YW
YW
YW
pc
pc
pc
pc
LH
GV
hI
ex
ex
ex
ex
ex
"}
(19,1,1) = {"
ex
ex
ex
ex
ex
hI
KZ
Yv
pc
pc
pc
Ha
zJ
HE
HE
HE
XC
HE
zJ
ax
ax
ax
ax
ax
ax
ax
ax
ax
ax
YW
ax
ax
ax
ax
YW
YW
YW
YW
ax
ax
ax
ax
ax
ax
ax
ax
YW
ax
ax
ax
ax
zJ
HE
YW
YW
YW
YW
zJ
PS
pc
pc
pc
Yv
KZ
hI
ex
ex
ex
ex
ex
"}
(20,1,1) = {"
ex
ex
ex
ex
ex
qk
KZ
LH
pc
IT
pc
pc
zJ
Ye
HE
HE
XC
HE
zJ
ax
qw
Dh
Dh
YW
Dh
Dh
Dh
YW
YW
YW
YW
Dh
Dh
Dh
Dh
YW
YW
YW
YW
Dh
Dh
Dh
Dh
Dh
Dh
Dh
Dh
Dh
Pf
Dh
ax
zJ
HE
HE
YW
YW
HE
zJ
pc
pc
pc
pc
LH
KZ
hI
ex
ex
ex
ex
ex
"}
(21,1,1) = {"
ex
ex
ex
ex
ex
hI
KZ
Yv
pc
pc
pc
Hp
zJ
zR
HE
HE
XC
HE
bs
ax
qw
Dh
YW
YW
Dh
Dh
YW
YW
YW
YW
YW
YW
YW
YW
YW
YW
YW
YW
YW
Dh
Dh
Dh
YW
YW
YW
YW
Dh
Dh
Pf
Dh
ax
bs
HE
HE
HE
HE
HE
zJ
ka
pc
PS
pc
Yv
KZ
hI
ex
ex
ex
ex
ex
"}
(22,1,1) = {"
ex
ex
ex
ex
ex
hI
GV
Yv
pc
ka
pc
pc
zJ
Ye
HE
HE
XC
HE
zJ
ax
qw
YW
YW
YW
YW
YW
YW
Dh
Dh
Dh
Dh
Dh
Dh
YW
YW
YW
Dh
Dh
Dh
Dh
Dh
Dh
Dh
YW
YW
YW
YW
YW
Pf
Dh
ax
zJ
jO
HE
HE
HE
HE
zJ
pc
pc
pc
pc
Yv
GV
hI
ex
ex
ex
ex
ex
"}
(23,1,1) = {"
ex
ex
ex
ex
ex
hI
KZ
Yv
pc
pc
IT
pc
zJ
Ye
HE
HE
XC
HE
zJ
ax
YW
YW
YW
YW
YW
YW
YW
ax
ax
ax
ax
ax
ax
YW
YW
YW
YW
ax
ax
ax
ax
ax
ax
YW
YW
YW
YW
YW
ax
ax
ax
zJ
jO
HE
HE
HE
HE
zJ
pc
pc
ka
pc
Yv
KZ
hI
ex
ex
ex
ex
ex
"}
(24,1,1) = {"
ex
ex
ex
ex
ex
hI
KZ
qx
pc
pc
pc
pc
zJ
zJ
zJ
zJ
zJ
zJ
zJ
zJ
YW
YW
YW
YW
YW
YW
YW
zJ
zJ
zJ
zJ
zJ
zJ
YW
YW
YW
YW
zJ
zJ
zJ
zJ
zJ
zJ
zJ
zJ
YW
YW
YW
YW
zJ
zJ
zJ
zJ
zJ
zJ
zJ
zJ
zJ
pc
dg
pc
pc
Yv
KZ
hI
ex
ex
ex
ex
ex
"}
(25,1,1) = {"
ex
ex
ex
ex
ex
hI
KZ
Yv
pc
Jh
pc
dg
pc
pc
PS
pc
pc
Jh
pc
dg
YW
YW
dA
YW
zx
pc
pc
pc
pc
pc
pc
pc
pc
pc
YW
YW
Jh
pc
pc
pc
pc
pc
PS
pc
pc
pc
uk
YW
YW
dA
pc
Jh
pc
dg
pc
pc
PS
pc
pc
pc
pc
pc
Yv
KZ
hI
ex
ex
ex
ex
ex
"}
(26,1,1) = {"
ex
ex
ex
ex
ex
hI
GV
Yv
pc
pc
pc
pc
pc
pc
pc
pc
pc
pc
pc
YW
YW
YW
YW
YW
pc
pc
pc
Jh
pc
pc
dg
pc
pc
PS
pc
pc
pc
pc
pc
Jh
pc
pc
pc
pc
pc
pc
pc
pc
YW
YW
pc
pc
pc
pc
pc
pc
pc
pc
pc
pc
pc
pc
Yv
GV
hI
ex
ex
ex
ex
ex
"}
(27,1,1) = {"
hI
hI
hI
hI
hI
hI
KZ
Yv
pc
pc
pc
pc
pc
Ib
ka
JU
pc
pc
pc
YW
gB
YW
IH
pc
pc
pc
pc
pc
PS
pc
fP
pc
pc
pc
pc
dg
pc
pc
pc
pc
pc
pc
pc
oL
pc
pc
pc
sS
pc
IH
xx
YW
pc
pc
pc
pc
ka
pc
pc
IT
pc
pc
Yv
KZ
hI
hI
hI
hI
hI
hI
"}
(28,1,1) = {"
hI
KZ
KZ
GV
KZ
KZ
KZ
Yv
Da
pc
pc
pc
pc
pc
pc
pc
pc
pc
YW
YW
YW
YW
pc
pc
pc
pc
pc
pc
pc
pc
pc
pc
pc
pc
pc
pc
pc
pc
pc
pc
pc
pc
pc
pc
pc
pc
pc
pc
pc
YW
YW
YW
pc
pc
pc
pc
pc
pc
pc
pc
pc
Da
Yv
KZ
pw
KZ
GV
KZ
KZ
hI
"}
(29,1,1) = {"
hI
fw
fw
fw
fw
fw
HI
pF
pF
pF
pF
Ia
pF
pF
pF
pF
pF
pR
pF
pF
pF
pF
pF
xn
pF
pF
pF
pF
pF
pF
pF
pF
pF
pF
pF
pF
pF
pF
pF
pF
pF
pF
pF
pF
pF
pF
pF
pF
pF
pF
pF
pF
pF
pF
pF
pF
pF
pF
dU
pF
pF
pF
pF
HI
sO
sO
sO
sO
sO
hI
"}
(30,1,1) = {"
hI
mk
mk
mk
mk
mk
Rw
Rw
Rw
Rw
Rw
KO
Rw
Rw
Rw
Rw
Rw
Rw
Rw
Rw
Rw
Rw
Rw
Rw
Rw
Rw
Rw
Rw
Rw
Rw
Rw
Rw
Rw
Rw
Rw
Rw
Rw
Rw
Rw
Rw
Rw
Rw
Rw
Rw
Rw
Rw
Rw
Rw
Rw
Rw
Rw
Rw
Rw
Rw
Rw
Rw
Rw
Rw
Js
Rw
Rw
Rw
Rw
Rw
cc
cc
cc
cc
cc
hI
"}
(31,1,1) = {"
hI
mn
mn
mn
mn
mn
Aw
yC
yC
yC
yC
LC
yC
yC
yC
yC
yC
yC
yC
yC
yC
yC
yC
yC
yC
yC
yC
yC
yC
yC
yC
yC
yC
yC
yC
yC
yC
yC
yC
yC
yC
yC
yC
yC
yC
yC
yC
yC
yC
yC
yC
yC
yC
yC
yC
yC
yC
yC
oI
yC
yC
yC
yC
Aw
NS
NS
NS
NS
NS
hI
"}
(32,1,1) = {"
hI
nc
nc
nc
nc
nc
Id
Id
Id
Id
Id
LX
Id
Id
Id
Id
Id
Id
Id
Id
Id
Id
Id
Id
Id
Id
Id
Id
Id
Id
Id
Id
Id
Id
Id
Id
Id
Id
Id
Id
Id
Id
Id
Id
Id
Id
Id
Id
Id
Id
Id
Id
Id
Id
Id
Id
Id
Id
gh
Id
Id
Id
Id
Id
ZO
ZO
ZO
ZO
ZO
hI
"}
(33,1,1) = {"
hI
mn
mn
mn
mn
mn
yC
yC
yC
yC
yC
LC
yC
yC
yC
yC
yC
yC
yC
yC
yC
yC
yC
yC
yC
yC
yC
yC
yC
yC
yC
yC
yC
yC
yC
yC
yC
yC
yC
yC
yC
yC
yC
yC
yC
yC
yC
yC
yC
yC
yC
yC
yC
yC
yC
yC
yC
yC
oI
RN
yC
yC
yC
yC
NS
NS
NS
NS
NS
hI
"}
(34,1,1) = {"
hI
oR
oR
oR
oR
oR
eV
yX
yX
yX
yX
No
yX
yX
yX
yX
yX
hc
yX
yX
yX
yX
yX
yX
yX
yX
yX
yX
yX
yX
yX
yX
yX
yX
yX
yX
yX
yX
yX
yX
yX
yX
yX
yX
yX
yX
Gz
yX
yX
yX
yX
yX
yX
yX
yX
yX
yX
yX
aP
yX
yX
yX
yX
eV
ob
ob
ob
ob
ob
hI
"}
(35,1,1) = {"
hI
fw
fw
fw
fw
fw
pF
pF
pF
pF
pF
Sl
pF
xe
pF
pF
pF
pF
pF
pF
pF
pF
pF
pF
pF
pF
pF
pF
pF
pF
pF
pF
pF
pF
pF
pF
pF
pF
pF
pF
pF
pF
pF
pF
pF
pF
pF
pF
pF
pF
pF
pF
fI
pF
pF
pF
pF
pF
qn
pF
pF
pF
pF
pF
sO
sO
sO
sO
sO
hI
"}
(36,1,1) = {"
hI
KZ
KZ
GV
pw
KZ
KZ
Bl
Da
pc
Eg
pc
pc
pc
pc
pc
pc
pc
pc
eB
pc
pc
pc
pc
pc
pc
pc
ka
pc
pc
pc
pc
pc
pc
pc
pc
pc
pc
pc
pc
pc
pc
pc
pc
pc
sS
pc
pc
pc
pc
pc
pc
pc
pc
pc
pc
pc
pc
pc
pc
pc
Da
Yv
KZ
KZ
KZ
GV
KZ
KZ
hI
"}
(37,1,1) = {"
hI
hI
hI
hI
hI
hI
GV
Bl
pc
PS
Jh
pc
pc
pc
pc
ka
pc
pc
Jh
pc
pc
pc
ka
pc
pc
pc
Jh
pc
pc
pc
dg
pc
pc
pc
ka
pc
pc
pc
Jh
pc
pc
ka
pc
dg
pc
pc
ka
pc
pc
Jh
pc
pc
Cn
ka
pc
pc
Jh
pc
pc
pc
PS
pc
Yv
GV
hI
hI
hI
hI
hI
hI
"}
(38,1,1) = {"
ex
ex
ex
ex
ex
hI
KZ
Bl
pc
pc
pc
pc
Cn
pc
eB
pc
pc
pc
pc
pc
pc
pc
pc
pc
pc
pc
pc
pc
pc
pc
pc
pc
pc
pc
pc
pc
pc
pc
pc
pc
pc
pc
pc
pc
pc
pc
pc
pc
pc
pc
pc
pc
pc
pc
pc
pc
pc
pc
pc
pc
pc
pc
Bl
KZ
hI
ex
ex
ex
ex
ex
"}
(39,1,1) = {"
ex
ex
ex
ex
ex
hI
KZ
Bl
Ib
ka
pc
Va
KZ
GV
KZ
KZ
KZ
GV
KZ
KZ
KZ
GV
KZ
KZ
GV
KZ
KZ
KZ
KZ
KZ
KZ
KZ
KZ
KZ
KZ
KZ
KZ
KZ
KZ
KZ
KZ
KZ
KZ
KZ
KZ
KZ
KZ
KZ
GV
KZ
KZ
KZ
GV
KZ
KZ
KZ
GV
KZ
Gu
pc
ka
pc
LH
KZ
hI
ex
ex
ex
ex
ex
"}
(40,1,1) = {"
ex
ex
ex
ex
ex
hI
hI
hI
hI
hI
hI
hI
hI
hI
hI
hI
hI
hI
hI
hI
hI
hI
hI
hI
hI
hI
hI
hI
hI
hI
hI
hI
hI
hI
hI
hI
hI
hI
hI
hI
hI
hI
hI
hI
hI
hI
hI
hI
hI
hI
hI
hI
hI
hI
hI
hI
hI
hI
hI
hI
hI
hI
hI
hI
hI
ex
ex
ex
ex
ex
"}
