//MAP CONVERTED BY dmm2tgm.py THIS HEADER COMMENT PREVENTS RECONVERSION, DO NOT REMOVE
"ax" = (
/obj/structure/rospilovo/vanna,
/turf/open/floor/grass/rospilovo,
/area/violence)
"aP" = (
/obj/effect/turf_decal/siding/white{
	dir = 4
	},
/obj/structure/deployable_barricade/sandbags{
	dir = 1
	},
/turf/open/floor/rospilovo,
/area/violence)
"cc" = (
/obj/effect/landmark/start/combatant/blue,
/obj/effect/turf_decal/siding/white{
	dir = 8
	},
/turf/open/floor/rospilovo,
/area/violence)
"dg" = (
/obj/structure/rospilovo/tree{
	icon_state = "derevo5"
	},
/turf/open/floor/grass/rospilovo,
/area/violence)
"dw" = (
/obj/structure/deployable_barricade/metal{
	dir = 1
	},
/turf/open/floor/grass/rospilovo,
/area/violence)
"dC" = (
/obj/structure/rospilovo/bar_plitka{
	icon_state = "bar_plate3"
	},
/turf/open/floor/grass/rospilovo,
/area/violence)
"dU" = (
/obj/structure/deployable_barricade/sandbags{
	dir = 1
	},
/obj/structure/deployable_barricade/sandbags{
	dir = 8
	},
/turf/open/floor/rospilovo/plitka{
	icon_state = "plita4"
	},
/area/violence)
"ex" = (
/obj/structure/rospilovo/doski/doski4,
/turf/open/floor/grass/rospilovo,
/area/violence)
"eV" = (
/obj/machinery/door/poddoor/multi_tile/two_tile_hor{
	resistance_flags = 115
	},
/obj/effect/turf_decal/siding/white{
	dir = 4
	},
/turf/open/floor/rospilovo,
/area/violence)
"fw" = (
/obj/effect/turf_decal/siding/white{
	dir = 8
	},
/obj/structure/rospilovo/doski,
/obj/structure/deployable_barricade/sandbags,
/turf/open/floor/rospilovo,
/area/violence)
"fI" = (
/obj/structure/rospilovo/musor_yashik/green,
/turf/open/floor/rospilovo/plitka{
	icon_state = "plita4"
	},
/area/violence)
"gh" = (
/obj/effect/turf_decal/trimline/white/line{
	dir = 4;
	icon_state = "trimline"
	},
/obj/effect/turf_decal/trimline/white/line{
	dir = 8;
	icon_state = "trimline"
	},
/obj/structure/deployable_barricade/sandbags{
	dir = 1
	},
/turf/open/floor/rospilovo,
/area/violence)
"hI" = (
/turf/closed/indestructible/black,
/area/violence)
"ka" = (
/obj/structure/rospilovo/tree{
	icon_state = "derevo4"
	},
/turf/open/floor/grass/rospilovo,
/area/violence)
"kV" = (
/obj/structure/rospilovo/leest,
/turf/open/floor/grass/rospilovo,
/area/violence)
"mk" = (
/obj/structure/rospilovo/doski/doski3,
/turf/open/floor/grass/rospilovo,
/area/violence)
"mn" = (
/obj/structure/rospilovo/water/bochka/kap,
/turf/open/floor/grass/rospilovo,
/area/violence)
"nc" = (
/obj/structure/rospilovo/stolb,
/turf/open/floor/rospilovo/plitka{
	icon_state = "plita4"
	},
/area/violence)
"ob" = (
/obj/effect/landmark/start/combatant/blue,
/obj/effect/turf_decal/siding/white{
	dir = 4
	},
/turf/open/floor/rospilovo,
/area/violence)
"ov" = (
/obj/structure/deployable_barricade/metal,
/turf/open/floor/grass/rospilovo,
/area/violence)
"oI" = (
/obj/structure/deployable_barricade/sandbags{
	dir = 1
	},
/turf/open/floor/rospilovo,
/area/violence)
"oR" = (
/obj/structure/deployable_barricade/sandbags,
/obj/structure/deployable_barricade/sandbags{
	dir = 4
	},
/turf/open/floor/rospilovo/plitka{
	icon_state = "plita4"
	},
/area/violence)
"pc" = (
/turf/open/floor/grass/rospilovo,
/area/violence)
"pw" = (
/obj/structure/rospilovo/switcher,
/turf/closed/wall/rospilovo/bricks_white,
/area/violence)
"pF" = (
/turf/open/floor/rospilovo/plitka{
	icon_state = "plita4"
	},
/area/violence)
"qk" = (
/obj/effect/turf_decal/trimline/white/line{
	dir = 4;
	icon_state = "trimline"
	},
/obj/effect/turf_decal/trimline/white/line{
	dir = 8;
	icon_state = "trimline"
	},
/obj/structure/deployable_barricade/sandbags,
/turf/open/floor/rospilovo,
/area/violence)
"qn" = (
/obj/structure/deployable_barricade/sandbags{
	dir = 1
	},
/obj/structure/deployable_barricade/sandbags{
	dir = 4
	},
/turf/open/floor/rospilovo/plitka{
	icon_state = "plita4"
	},
/area/violence)
"qx" = (
/obj/structure/rospilovo/shina3,
/turf/open/floor/grass/rospilovo,
/area/violence)
"sO" = (
/obj/effect/landmark/start/combatant/blue,
/turf/open/floor/rospilovo/plitka{
	icon_state = "plita4"
	},
/area/violence)
"sS" = (
/obj/structure/deployable_barricade/metal{
	dir = 8
	},
/turf/open/floor/grass/rospilovo,
/area/violence)
"uk" = (
/obj/structure/rospilovo/musor_yashik/red,
/turf/open/floor/grass/rospilovo,
/area/violence)
"vk" = (
/obj/structure/rospilovo/tree{
	icon_state = "derevo4"
	},
/obj/structure/rospilovo/shina2,
/turf/open/floor/grass/rospilovo,
/area/violence)
"xn" = (
/obj/effect/landmark/start/combatant/red,
/turf/open/floor/rospilovo/plitka{
	icon_state = "plita4"
	},
/area/violence)
"yC" = (
/turf/open/floor/rospilovo,
/area/violence)
"yX" = (
/obj/effect/turf_decal/siding/white{
	dir = 4
	},
/turf/open/floor/rospilovo,
/area/violence)
"zJ" = (
/obj/structure/rospilovo/doski/doski2,
/turf/open/floor/grass/rospilovo,
/area/violence)
"Aw" = (
/obj/machinery/door/poddoor/multi_tile/three_tile_hor{
	resistance_flags = 115
	},
/turf/open/floor/rospilovo,
/area/violence)
"Bl" = (
/obj/structure/rospilovo/bar_plitka{
	icon_state = "bar_plate4"
	},
/turf/open/floor/grass/rospilovo,
/area/violence)
"Cn" = (
/obj/structure/rospilovo/yashik,
/turf/open/floor/grass/rospilovo,
/area/violence)
"Da" = (
/obj/structure/rospilovo/radiation,
/turf/open/floor/grass/rospilovo,
/area/violence)
"Dh" = (
/obj/effect/turf_decal/trimline/white/line{
	dir = 4;
	icon_state = "trimline"
	},
/obj/effect/turf_decal/trimline/white/line{
	dir = 8;
	icon_state = "trimline"
	},
/turf/closed/indestructible/black,
/area/violence)
"Eg" = (
/obj/structure/rospilovo/yashik,
/turf/open/floor/rospilovo/plitka{
	icon_state = "plita4"
	},
/area/violence)
"Fk" = (
/obj/structure/rospilovo/water/luzha,
/turf/open/floor/grass/rospilovo,
/area/violence)
"Fn" = (
/obj/structure/rospilovo/shina,
/turf/open/floor/grass/rospilovo,
/area/violence)
"Gu" = (
/obj/structure/rospilovo/yashik/yaskik_a/big,
/turf/open/floor/grass/rospilovo,
/area/violence)
"Gz" = (
/obj/effect/turf_decal/siding/white{
	dir = 4
	},
/obj/structure/rospilovo/doski,
/turf/open/floor/rospilovo,
/area/violence)
"GV" = (
/obj/structure/rospilovo/okno{
	icon_state = "okno4"
	},
/turf/closed/wall/rospilovo/bricks_white,
/area/violence)
"Ha" = (
/obj/effect/turf_decal/siding/white{
	dir = 4
	},
/obj/structure/rospilovo/doski/doski2,
/turf/open/floor/rospilovo,
/area/violence)
"Hp" = (
/obj/structure/deployable_barricade/sandbags,
/turf/open/floor/rospilovo,
/area/violence)
"HE" = (
/obj/structure/fluff/rospilovo,
/turf/open/floor/grass/rospilovo,
/area/violence)
"HI" = (
/obj/machinery/door/poddoor/multi_tile/two_tile_hor{
	resistance_flags = 115
	},
/turf/open/floor/rospilovo/plitka{
	icon_state = "plita4"
	},
/area/violence)
"Ia" = (
/obj/effect/turf_decal/trimline/white/line{
	dir = 4;
	icon_state = "trimline"
	},
/obj/effect/turf_decal/trimline/white/line{
	dir = 8;
	icon_state = "trimline"
	},
/obj/effect/landmark/start/combatant/red,
/turf/open/floor/rospilovo,
/area/violence)
"Ib" = (
/obj/structure/rospilovo/stolb,
/turf/open/floor/grass/rospilovo,
/area/violence)
"Id" = (
/obj/effect/turf_decal/trimline/white/line{
	dir = 4;
	icon_state = "trimline"
	},
/obj/effect/turf_decal/trimline/white/line{
	dir = 8;
	icon_state = "trimline"
	},
/turf/open/floor/rospilovo,
/area/violence)
"IT" = (
/obj/structure/rospilovo/tree{
	icon_state = "derevo2"
	},
/turf/open/floor/grass/rospilovo,
/area/violence)
"Jh" = (
/obj/structure/rospilovo/tree{
	icon_state = "derevo3"
	},
/turf/open/floor/grass/rospilovo,
/area/violence)
"Js" = (
/obj/effect/turf_decal/siding/white{
	dir = 8
	},
/obj/structure/deployable_barricade/sandbags{
	dir = 1
	},
/turf/open/floor/rospilovo,
/area/violence)
"KO" = (
/obj/effect/landmark/start/combatant/red,
/turf/open/floor/rospilovo,
/area/violence)
"KZ" = (
/turf/closed/wall/rospilovo/bricks_white,
/area/violence)
"LC" = (
/obj/effect/turf_decal/siding/white{
	dir = 4
	},
/obj/structure/deployable_barricade/sandbags,
/turf/open/floor/rospilovo,
/area/violence)
"LH" = (
/obj/structure/rospilovo/bar_plitka,
/turf/open/floor/grass/rospilovo,
/area/violence)
"LX" = (
/obj/structure/rospilovo/luk,
/turf/open/floor/rospilovo/plitka{
	icon_state = "plita4"
	},
/area/violence)
"No" = (
/obj/structure/deployable_barricade/sandbags,
/obj/structure/deployable_barricade/sandbags{
	dir = 8
	},
/turf/open/floor/rospilovo/plitka{
	icon_state = "plita4"
	},
/area/violence)
"NS" = (
/obj/effect/landmark/start/combatant/blue,
/turf/open/floor/rospilovo,
/area/violence)
"PS" = (
/obj/structure/rospilovo/tree,
/turf/open/floor/grass/rospilovo,
/area/violence)
"QJ" = (
/turf/open/space/basic,
/area/space)
"Rw" = (
/obj/effect/turf_decal/siding/white{
	dir = 8
	},
/turf/open/floor/rospilovo,
/area/violence)
"RN" = (
/obj/structure/rospilovo/doski/doski3,
/turf/open/floor/rospilovo,
/area/violence)
"Sl" = (
/obj/effect/landmark/start/combatant/red,
/obj/effect/turf_decal/siding/white{
	dir = 4
	},
/turf/open/floor/rospilovo,
/area/violence)
"Va" = (
/obj/effect/landmark/start/combatant/red,
/obj/effect/turf_decal/siding/white{
	dir = 8
	},
/turf/open/floor/rospilovo,
/area/violence)
"Yv" = (
/obj/structure/rospilovo/bar_plitka{
	icon_state = "bar_plate2"
	},
/turf/open/floor/grass/rospilovo,
/area/violence)
"YW" = (
/obj/structure/rospilovo/tree{
	icon_state = "derevo5"
	},
/obj/structure/rospilovo/doski/doski4,
/turf/open/floor/grass/rospilovo,
/area/violence)
"ZO" = (
/obj/effect/turf_decal/trimline/white/line{
	dir = 4;
	icon_state = "trimline"
	},
/obj/effect/turf_decal/trimline/white/line{
	dir = 8;
	icon_state = "trimline"
	},
/obj/effect/landmark/start/combatant/blue,
/turf/open/floor/rospilovo,
/area/violence)

(1,1,1) = {"
QJ
QJ
QJ
QJ
QJ
hI
hI
hI
hI
hI
hI
hI
hI
hI
hI
hI
hI
hI
hI
hI
hI
hI
hI
hI
hI
hI
hI
hI
hI
hI
hI
hI
hI
hI
hI
hI
hI
hI
hI
hI
hI
hI
hI
hI
hI
QJ
QJ
QJ
QJ
QJ
"}
(2,1,1) = {"
QJ
QJ
QJ
QJ
QJ
hI
KZ
Yv
pc
PS
Jh
pc
KZ
GV
KZ
KZ
KZ
GV
KZ
KZ
KZ
GV
KZ
KZ
GV
KZ
KZ
KZ
GV
KZ
KZ
KZ
GV
KZ
KZ
KZ
GV
KZ
pc
PS
Jh
pc
Yv
KZ
hI
QJ
QJ
QJ
QJ
QJ
"}
(3,1,1) = {"
QJ
QJ
QJ
QJ
QJ
hI
KZ
Yv
pc
pc
pc
pc
pc
ka
pc
PS
pc
pc
pc
pc
ka
pc
PS
pc
ka
pc
pc
pc
pc
ka
pc
PS
pc
ka
pc
pc
pc
pc
Ib
pc
pc
pc
Yv
KZ
hI
QJ
QJ
QJ
QJ
QJ
"}
(4,1,1) = {"
QJ
QJ
QJ
QJ
QJ
hI
KZ
LH
pc
ka
pc
pc
dg
pc
pc
pc
pc
Jh
pc
dg
pc
pc
pc
pc
pc
PS
Jh
pc
dg
pc
pc
pc
pc
pc
PS
Jh
pc
dg
pc
vk
pc
pc
LH
KZ
hI
QJ
QJ
QJ
QJ
QJ
"}
(5,1,1) = {"
QJ
QJ
QJ
QJ
QJ
hI
KZ
LH
pc
pc
pc
pc
pc
pc
pc
ka
pc
ov
pc
pc
pc
pc
ka
pc
pc
pc
pc
pc
pc
pc
pc
ka
pc
pc
pc
pc
pc
pc
pc
pc
ka
pc
LH
KZ
hI
QJ
QJ
QJ
QJ
QJ
"}
(6,1,1) = {"
QJ
QJ
QJ
QJ
QJ
hI
GV
LH
pc
ka
pc
pc
Jh
pc
dg
mk
pc
pc
pc
Jh
pc
dg
pc
pc
pc
ka
pc
pc
Jh
pc
dg
pc
pc
pc
ka
pc
pc
Jh
pc
dg
pc
pc
LH
GV
hI
QJ
QJ
QJ
QJ
QJ
"}
(7,1,1) = {"
QJ
QJ
QJ
QJ
QJ
hI
KZ
LH
dg
pc
pc
PS
pc
pc
pc
pc
pc
pc
PS
pc
pc
pc
pc
pc
dg
pc
pc
PS
pc
pc
pc
pc
pc
dg
pc
pc
PS
pc
pc
pc
pc
pc
LH
KZ
hI
QJ
QJ
QJ
QJ
QJ
"}
(8,1,1) = {"
QJ
QJ
QJ
QJ
QJ
hI
KZ
Yv
pc
pc
pc
pc
pc
pc
pc
pc
PS
pc
pc
pc
pc
pc
pc
PS
pc
pc
pc
pc
pc
Cn
pc
pc
PS
pc
pc
pc
pc
pc
pc
pc
pc
pc
Yv
KZ
hI
QJ
QJ
QJ
QJ
QJ
"}
(9,1,1) = {"
QJ
QJ
QJ
QJ
QJ
hI
KZ
Yv
pc
pc
pc
Jh
pc
dg
pc
pc
PS
pc
pc
pc
dg
pc
pc
pc
pc
pc
pc
pc
PS
Jh
IT
pc
pc
pc
pc
pc
ka
pc
pc
IT
pc
pc
Yv
KZ
hI
QJ
QJ
QJ
QJ
QJ
"}
(10,1,1) = {"
QJ
QJ
QJ
QJ
QJ
hI
GV
Yv
Jh
pc
dg
pc
pc
pc
pc
pc
pc
Fk
pc
pc
pc
pc
pc
ka
Fn
pc
IT
pc
pc
pc
pc
pc
ka
Jh
pc
dg
pc
pc
pc
pc
pc
pc
Yv
GV
hI
QJ
QJ
QJ
QJ
QJ
"}
(11,1,1) = {"
QJ
QJ
QJ
QJ
QJ
hI
KZ
LH
pc
pc
pc
pc
Cn
pc
pc
pc
pc
PS
pc
pc
Jh
pc
dg
pc
pc
pc
pc
pc
ka
pc
pc
Ib
pc
PS
pc
pc
pc
pc
PS
pc
pc
pc
LH
KZ
hI
QJ
QJ
QJ
QJ
QJ
"}
(12,1,1) = {"
QJ
QJ
QJ
QJ
QJ
hI
KZ
Bl
pc
IT
pc
pc
pc
IT
pc
IT
pc
pc
pc
PS
pc
pc
pc
pc
pc
Jh
pc
dg
pc
pc
pc
IT
pc
pc
pc
pc
IT
pc
pc
pc
pc
pc
LH
KZ
hI
QJ
QJ
QJ
QJ
QJ
"}
(13,1,1) = {"
QJ
QJ
QJ
QJ
QJ
hI
KZ
Yv
pc
pc
pc
pc
pc
pc
pc
pc
pc
ka
pc
pc
pc
pc
pc
Cn
pc
pc
pc
pc
pc
pc
pc
pc
pc
ka
pc
pc
pc
pc
ka
pc
PS
pc
Yv
KZ
hI
QJ
QJ
QJ
QJ
QJ
"}
(14,1,1) = {"
QJ
QJ
QJ
QJ
QJ
hI
GV
LH
pc
pc
pc
PS
Jh
pc
dg
pc
pc
pc
PS
pc
PS
pc
pc
pc
pc
HE
pc
PS
pc
pc
pc
pc
pc
pc
PS
Jh
pc
YW
pc
pc
pc
pc
LH
GV
hI
QJ
QJ
QJ
QJ
QJ
"}
(15,1,1) = {"
QJ
QJ
QJ
QJ
QJ
hI
KZ
LH
pc
pc
IT
pc
pc
pc
pc
pc
IT
pc
pc
pc
pc
pc
pc
IT
pc
IT
pc
pc
pc
kV
pc
pc
IT
pc
pc
pc
pc
pc
pc
pc
ka
pc
LH
KZ
hI
QJ
QJ
QJ
QJ
QJ
"}
(16,1,1) = {"
QJ
QJ
QJ
QJ
QJ
hI
KZ
Yv
pc
pc
pc
ka
pc
pc
Jh
pc
pc
pc
ka
pc
ka
pc
pc
pc
pc
pc
pc
ka
pc
pc
pc
pc
pc
pc
ka
pc
pc
Jh
pc
dg
pc
pc
Yv
KZ
hI
QJ
QJ
QJ
QJ
QJ
"}
(17,1,1) = {"
QJ
QJ
QJ
QJ
QJ
hI
KZ
LH
pc
Jh
pc
dg
pc
pc
PS
pc
pc
pc
pc
pc
pc
PS
Jh
pc
dg
Ib
pc
pc
PS
Jh
pc
Jh
pc
dg
pc
pc
PS
pc
pc
pc
pc
pc
LH
KZ
hI
QJ
QJ
QJ
QJ
QJ
"}
(18,1,1) = {"
QJ
QJ
QJ
QJ
QJ
hI
GV
LH
pc
pc
pc
pc
pc
pc
pc
pc
pc
pc
pc
IT
pc
pc
pc
pc
pc
pc
IT
pc
pc
pc
zJ
pc
pc
pc
pc
dw
pc
pc
pc
pc
pc
pc
LH
GV
hI
QJ
QJ
QJ
QJ
QJ
"}
(19,1,1) = {"
QJ
QJ
QJ
QJ
QJ
hI
KZ
Yv
pc
pc
pc
PS
ax
pc
pc
pc
PS
pc
pc
PS
pc
pc
pc
pc
pc
pc
PS
pc
pc
pc
pc
pc
pc
PS
pc
pc
pc
pc
PS
pc
pc
pc
Yv
KZ
hI
QJ
QJ
QJ
QJ
QJ
"}
(20,1,1) = {"
QJ
QJ
QJ
QJ
QJ
Dh
KZ
LH
pc
IT
pc
pc
pc
pc
IT
pc
pc
IT
pc
pc
ov
pc
IT
pc
IT
pc
pc
pc
pc
IT
pc
IT
pc
pc
pc
pc
IT
pc
pc
pc
pc
pc
LH
KZ
hI
QJ
QJ
QJ
QJ
QJ
"}
(21,1,1) = {"
QJ
QJ
QJ
QJ
QJ
hI
KZ
Yv
pc
pc
pc
ka
pc
pc
pc
pc
ka
pc
pc
ka
pc
pc
pc
pc
pc
pc
ka
pc
pc
pc
pc
pc
pc
ka
pc
pc
pc
pc
ka
pc
PS
pc
Yv
KZ
hI
QJ
QJ
QJ
QJ
QJ
"}
(22,1,1) = {"
QJ
QJ
QJ
QJ
QJ
hI
GV
Yv
pc
pc
pc
pc
PS
Jh
pc
dg
pc
pc
Ib
pc
PS
Jh
pc
dg
pc
pc
pc
PS
Jh
pc
dg
Fk
pc
pc
PS
Jh
pc
dg
pc
pc
pc
pc
Yv
GV
hI
QJ
QJ
QJ
QJ
QJ
"}
(23,1,1) = {"
QJ
QJ
QJ
QJ
QJ
hI
KZ
Yv
pc
pc
IT
pc
pc
pc
pc
pc
pc
pc
IT
pc
pc
pc
pc
pc
pc
IT
pc
pc
pc
pc
pc
pc
IT
pc
pc
pc
pc
pc
pc
pc
ka
pc
Yv
KZ
hI
QJ
QJ
QJ
QJ
QJ
"}
(24,1,1) = {"
QJ
QJ
QJ
QJ
QJ
hI
KZ
dC
pc
pc
pc
pc
ka
pc
Cn
Jh
pc
pc
pc
pc
ka
pc
pc
Jh
pc
pc
pc
ka
pc
pc
Jh
pc
pc
pc
ka
pc
pc
Jh
pc
dg
pc
pc
Yv
KZ
hI
QJ
QJ
QJ
QJ
QJ
"}
(25,1,1) = {"
QJ
QJ
QJ
QJ
QJ
hI
KZ
Yv
pc
Jh
pc
dg
pc
pc
PS
pc
pc
Jh
pc
dg
pc
pc
PS
pc
Jh
pc
dg
pc
pc
PS
pc
Jh
pc
dg
pc
pc
PS
pc
pc
pc
pc
pc
Yv
KZ
hI
QJ
QJ
QJ
QJ
QJ
"}
(26,1,1) = {"
QJ
QJ
QJ
QJ
QJ
hI
GV
Yv
pc
pc
pc
pc
pc
pc
pc
pc
pc
pc
pc
pc
pc
pc
pc
pc
pc
pc
pc
pc
pc
pc
pc
pc
pc
pc
pc
pc
pc
pc
pc
pc
pc
pc
Yv
GV
hI
QJ
QJ
QJ
QJ
QJ
"}
(27,1,1) = {"
hI
hI
hI
hI
hI
hI
KZ
Yv
pc
pc
pc
pc
pc
Ib
ka
ex
pc
pc
pc
pc
pc
pc
ka
pc
pc
pc
pc
sS
pc
ka
pc
pc
pc
pc
pc
pc
ka
pc
pc
IT
pc
pc
Yv
KZ
hI
hI
hI
hI
hI
hI
"}
(28,1,1) = {"
hI
KZ
KZ
GV
KZ
KZ
KZ
Yv
Da
pc
pc
pc
pc
pc
pc
pc
pc
pc
pc
pc
pc
pc
pc
pc
pc
pc
pc
pc
pc
pc
pc
pc
pc
pc
pc
pc
pc
pc
pc
pc
pc
Da
Yv
KZ
pw
KZ
GV
KZ
KZ
hI
"}
(29,1,1) = {"
hI
xn
xn
xn
xn
xn
HI
pF
pF
pF
pF
No
pF
pF
pF
pF
pF
Eg
pF
pF
pF
pF
pF
LX
pF
pF
pF
pF
pF
pF
pF
pF
pF
pF
pF
pF
pF
pF
dU
pF
pF
pF
pF
HI
sO
sO
sO
sO
sO
hI
"}
(30,1,1) = {"
hI
Va
Va
Va
Va
Va
Rw
Rw
Rw
Rw
Rw
fw
Rw
Rw
Rw
Rw
Rw
Rw
Rw
Rw
Rw
Rw
Rw
Rw
Rw
Rw
Rw
Rw
Rw
Rw
Rw
Rw
Rw
Rw
Rw
Rw
Rw
Rw
Js
Rw
Rw
Rw
Rw
Rw
cc
cc
cc
cc
cc
hI
"}
(31,1,1) = {"
hI
KO
KO
KO
KO
KO
Aw
yC
yC
yC
yC
Hp
yC
yC
yC
yC
yC
yC
yC
yC
yC
yC
yC
yC
yC
yC
yC
yC
yC
yC
yC
yC
yC
yC
yC
yC
yC
yC
oI
yC
yC
yC
yC
Aw
NS
NS
NS
NS
NS
hI
"}
(32,1,1) = {"
hI
Ia
Ia
Ia
Ia
Ia
Id
Id
Id
Id
Id
qk
Id
Id
Id
Id
Id
Id
Id
Id
Id
Id
Id
Id
Id
Id
Id
Id
Id
Id
Id
Id
Id
Id
Id
Id
Id
Id
gh
Id
Id
Id
Id
Id
ZO
ZO
ZO
ZO
ZO
hI
"}
(33,1,1) = {"
hI
KO
KO
KO
KO
KO
yC
yC
yC
yC
yC
Hp
yC
yC
yC
yC
yC
yC
yC
yC
yC
yC
yC
yC
yC
yC
yC
yC
yC
yC
yC
yC
yC
yC
yC
yC
yC
yC
oI
RN
yC
yC
yC
yC
NS
NS
NS
NS
NS
hI
"}
(34,1,1) = {"
hI
Sl
Sl
Sl
Sl
Sl
eV
yX
yX
yX
yX
LC
yX
yX
yX
yX
yX
Ha
yX
yX
yX
yX
yX
yX
yX
yX
Gz
yX
yX
yX
yX
yX
yX
yX
yX
yX
yX
yX
aP
yX
yX
yX
yX
eV
ob
ob
ob
ob
ob
hI
"}
(35,1,1) = {"
hI
xn
xn
xn
xn
xn
pF
pF
pF
pF
pF
oR
pF
nc
pF
pF
pF
pF
pF
pF
pF
pF
pF
pF
pF
pF
pF
pF
pF
pF
pF
pF
fI
pF
pF
pF
pF
pF
qn
pF
pF
pF
pF
pF
sO
sO
sO
sO
sO
hI
"}
(36,1,1) = {"
hI
KZ
KZ
GV
pw
KZ
KZ
Bl
Da
pc
qx
pc
pc
pc
pc
pc
pc
pc
pc
uk
pc
pc
pc
pc
pc
sS
pc
pc
pc
pc
pc
pc
pc
pc
pc
pc
pc
pc
pc
pc
pc
Da
Yv
KZ
KZ
KZ
GV
KZ
KZ
hI
"}
(37,1,1) = {"
hI
hI
hI
hI
hI
hI
GV
Bl
pc
PS
Jh
pc
pc
pc
pc
ka
pc
pc
Jh
pc
pc
pc
ka
pc
pc
pc
ka
pc
pc
Jh
pc
pc
Cn
ka
pc
pc
Jh
pc
pc
pc
PS
pc
Yv
GV
hI
hI
hI
hI
hI
hI
"}
(38,1,1) = {"
QJ
QJ
QJ
QJ
QJ
hI
KZ
Bl
pc
pc
pc
pc
Cn
pc
uk
pc
pc
pc
pc
pc
pc
pc
pc
pc
pc
pc
pc
pc
pc
pc
pc
pc
pc
pc
pc
pc
pc
pc
pc
pc
pc
pc
Bl
KZ
hI
QJ
QJ
QJ
QJ
QJ
"}
(39,1,1) = {"
QJ
QJ
QJ
QJ
QJ
hI
KZ
Bl
Ib
ka
pc
mn
KZ
GV
KZ
KZ
KZ
GV
KZ
KZ
KZ
GV
KZ
KZ
GV
KZ
KZ
KZ
GV
KZ
KZ
KZ
GV
KZ
KZ
KZ
GV
KZ
Gu
pc
ka
pc
LH
KZ
hI
QJ
QJ
QJ
QJ
QJ
"}
(40,1,1) = {"
QJ
QJ
QJ
QJ
QJ
hI
hI
hI
hI
hI
hI
hI
hI
hI
hI
hI
hI
hI
hI
hI
hI
hI
hI
hI
hI
hI
hI
hI
hI
hI
hI
hI
hI
hI
hI
hI
hI
hI
hI
hI
hI
hI
hI
hI
hI
QJ
QJ
QJ
QJ
QJ
"}
