//MAP CONVERTED BY dmm2tgm.py THIS HEADER COMMENT PREVENTS RECONVERSION, DO NOT REMOVE
"a" = (
/turf/open/floor/plating/sandy_dirt,
/area/violence)
"b" = (
/obj/structure/barricade/sandbags,
/turf/open/floor/plating/beach/sand,
/area/violence)
"c" = (
/turf/open/floor/plasteel/stairs,
/area/violence)
"d" = (
/turf/open/floor/plating/beach/sand,
/area/violence)
"e" = (
/obj/effect/landmark/start/combatant/blue,
/turf/open/floor/plating/sandy_dirt,
/area/violence)
"f" = (
/obj/structure/barricade/wooden,
/turf/open/floor/plating/beach/sand,
/area/violence)
"g" = (
/obj/machinery/door/poddoor/multi_tile/four_tile_ver{
	resistance_flags = 115
	},
/turf/open/indestructible/cataclysmdda/sand,
/area/violence)
"m" = (
/turf/open/floor/plasteel/stairs{
	dir = 8
	},
/area/violence)
"n" = (
/obj/structure/barricade/wooden,
/turf/open/floor/plating/sandy_dirt,
/area/violence)
"o" = (
/obj/effect/landmark/start/combatant/blue,
/turf/open/indestructible/cataclysmdda/sand,
/area/violence)
"p" = (
/obj/structure/barricade/security/ctf,
/turf/open/floor/plating/sandy_dirt,
/area/violence)
"q" = (
/turf/open/indestructible/cataclysmdda/sand,
/area/violence)
"s" = (
/obj/structure/barricade/security/ctf,
/turf/open/indestructible/cataclysmdda/sand,
/area/violence)
"u" = (
/turf/open/floor/plasteel/stairs{
	dir = 1
	},
/area/violence)
"w" = (
/obj/machinery/door/poddoor/multi_tile/three_tile_ver{
	resistance_flags = 115
	},
/turf/open/indestructible/cataclysmdda/sand,
/area/violence)
"x" = (
/turf/closed/indestructible/black,
/area/violence)
"z" = (
/obj/effect/landmark/observer_start,
/turf/open/indestructible/cataclysmdda/sand,
/area/violence)
"A" = (
/obj/structure/barricade/sandbags,
/turf/open/indestructible/cataclysmdda/sand,
/area/violence)
"B" = (
/turf/open/floor/plasteel/stairs{
	dir = 4
	},
/area/violence)
"C" = (
/obj/structure/barricade/sandbags,
/obj/machinery/door/poddoor/multi_tile/three_tile_hor{
	resistance_flags = 115
	},
/turf/open/floor/plating/beach/sand,
/area/violence)
"D" = (
/obj/structure/barricade/security/ctf,
/turf/open/floor/plating/beach/sand,
/area/violence)
"I" = (
/obj/effect/landmark/start/combatant/red,
/turf/open/floor/plating/sandy_dirt,
/area/violence)
"K" = (
/turf/template_noop,
/area/template_noop)
"R" = (
/turf/closed/wall/mineral/sandstone,
/area/violence)
"U" = (
/obj/machinery/door/poddoor/multi_tile/two_tile_hor{
	resistance_flags = 115
	},
/turf/open/indestructible/cataclysmdda/sand,
/area/violence)
"V" = (
/obj/machinery/door/poddoor/multi_tile/three_tile_hor{
	resistance_flags = 115
	},
/turf/open/floor/plating/sandy_dirt,
/area/violence)
"W" = (
/obj/structure/barricade/wooden,
/turf/open/indestructible/cataclysmdda/sand,
/area/violence)
"Z" = (
/obj/machinery/door/poddoor/multi_tile/two_tile_ver{
	resistance_flags = 115
	},
/turf/open/indestructible/cataclysmdda/sand,
/area/violence)

(1,1,1) = {"
K
K
K
K
K
x
x
x
x
x
x
x
K
K
K
K
K
K
K
K
K
K
K
K
K
K
K
K
K
K
K
K
K
K
K
K
K
K
K
K
K
K
K
K
K
K
K
K
K
K
K
K
K
K
K
K
K
K
K
K
K
K
K
K
K
K
K
K
K
K
K
"}
(2,1,1) = {"
K
K
K
K
x
x
R
R
R
R
R
x
x
x
x
x
x
x
x
K
K
K
K
K
K
K
K
K
K
K
K
K
K
K
K
K
K
K
K
K
K
K
K
K
K
K
K
K
K
K
K
K
K
K
K
K
K
K
K
K
x
x
x
x
x
x
x
x
x
K
K
"}
(3,1,1) = {"
K
K
K
K
x
R
R
a
a
a
R
R
R
R
R
R
R
R
x
K
K
K
K
K
K
K
K
K
K
K
K
K
K
K
K
K
K
K
K
K
K
K
K
K
K
K
K
K
K
K
K
K
K
K
K
K
K
K
K
K
x
R
R
R
R
R
R
R
x
K
K
"}
(4,1,1) = {"
K
K
K
K
x
R
q
a
a
a
q
q
q
q
q
W
W
R
x
K
K
K
K
K
K
K
K
K
K
K
K
K
K
K
K
K
K
K
K
K
K
K
K
K
K
K
K
K
K
K
K
K
K
K
K
K
K
K
K
K
x
R
d
d
d
d
d
R
x
K
K
"}
(5,1,1) = {"
K
K
K
K
x
R
q
a
a
a
q
q
q
q
q
W
W
R
x
K
K
K
K
K
K
K
K
K
K
K
K
K
K
K
K
K
K
K
K
K
K
K
K
K
K
K
K
K
K
K
K
K
K
K
K
K
K
K
K
K
x
R
f
f
f
f
f
R
x
K
K
"}
(6,1,1) = {"
K
K
K
K
x
R
q
a
a
a
q
q
q
q
q
q
q
R
x
x
K
K
K
K
K
K
K
K
K
K
K
K
K
K
K
K
K
K
K
K
K
K
K
K
K
K
K
K
K
K
K
K
K
K
K
K
K
K
K
K
x
R
f
f
f
f
f
R
x
K
K
"}
(7,1,1) = {"
K
K
K
K
x
R
q
a
a
a
q
q
q
q
q
q
q
R
R
x
x
x
x
x
x
x
x
x
x
x
x
x
K
K
K
K
K
K
K
K
K
K
K
K
K
K
K
K
K
K
K
K
x
x
x
x
x
x
x
x
x
R
d
d
d
d
f
R
x
K
K
"}
(8,1,1) = {"
K
K
K
K
x
R
q
a
a
a
q
b
m
m
m
m
m
b
R
R
R
R
R
R
R
R
R
R
R
R
R
x
K
K
K
K
K
K
K
K
K
K
K
K
K
K
K
K
K
K
K
K
x
R
R
R
R
R
R
R
R
R
d
d
d
d
d
R
x
K
K
"}
(9,1,1) = {"
K
K
K
K
x
R
q
a
a
a
q
b
d
d
d
d
d
d
d
d
d
d
b
b
b
d
d
d
d
d
R
x
K
K
K
K
K
K
K
K
K
K
K
K
x
x
x
x
x
x
x
K
x
R
q
a
a
a
p
s
b
d
d
d
d
f
f
R
x
K
K
"}
(10,1,1) = {"
K
K
K
K
x
R
q
a
a
a
q
b
d
d
d
d
d
d
d
d
d
d
d
d
d
d
d
d
d
d
R
x
K
K
K
K
K
K
K
K
K
K
x
x
x
R
R
R
R
R
x
x
x
R
q
a
a
a
p
s
b
d
d
d
d
f
f
R
x
K
K
"}
(11,1,1) = {"
K
K
K
K
x
R
q
a
a
a
q
b
D
d
d
d
d
d
d
d
d
d
d
d
d
d
d
d
d
d
R
x
K
K
K
K
K
K
K
K
K
K
x
R
R
R
q
q
q
R
R
R
x
R
s
a
a
a
a
q
b
d
d
d
d
d
d
R
x
K
K
"}
(12,1,1) = {"
K
K
K
K
x
R
q
a
a
a
q
b
D
d
d
d
D
D
d
d
d
d
d
d
d
d
d
d
d
d
R
x
x
x
x
x
x
K
K
K
K
x
x
R
q
q
q
q
q
q
q
R
R
R
W
p
a
a
a
q
b
d
d
d
d
d
d
R
x
K
K
"}
(13,1,1) = {"
K
K
K
K
x
R
q
a
a
a
q
b
d
d
d
d
D
D
d
d
d
d
d
d
d
d
d
d
d
d
R
R
R
R
R
R
x
K
K
K
K
x
R
R
q
q
q
q
q
q
q
q
q
A
q
a
a
a
a
q
b
d
d
d
d
d
d
R
x
K
K
"}
(14,1,1) = {"
K
K
K
K
x
R
q
a
a
p
s
b
d
d
d
D
D
b
b
b
b
b
b
b
b
d
d
d
d
d
c
q
q
q
q
R
x
K
K
K
K
x
R
q
q
q
q
q
q
q
q
q
q
A
q
a
a
a
p
q
b
d
d
d
d
f
f
R
x
K
K
"}
(15,1,1) = {"
K
K
K
K
x
R
q
a
a
p
s
b
d
d
d
D
D
b
q
q
q
q
W
W
b
d
d
d
d
d
c
q
q
q
q
R
x
K
K
K
K
x
R
q
q
q
s
s
q
q
q
W
W
R
q
a
a
a
p
q
b
d
d
d
d
f
f
R
x
x
K
"}
(16,1,1) = {"
K
K
K
K
x
R
q
a
a
a
q
b
d
d
d
d
d
b
q
q
q
q
W
W
b
d
d
d
d
d
R
q
q
q
q
R
x
x
x
x
x
x
R
q
q
q
s
q
q
q
W
W
W
R
q
a
a
a
a
q
b
b
B
B
B
b
b
R
R
x
K
"}
(17,1,1) = {"
K
K
K
K
x
R
q
a
a
a
q
b
b
b
b
b
b
b
q
q
q
g
q
Z
C
d
d
d
d
d
R
q
q
W
W
R
R
R
R
R
R
R
R
q
q
q
q
q
q
q
W
W
W
R
q
a
a
a
a
q
q
W
q
q
q
q
q
q
R
x
K
"}
(18,1,1) = {"
K
x
x
x
x
R
q
a
a
a
q
q
q
q
q
q
q
q
U
q
o
q
o
q
b
d
d
d
d
d
R
q
q
W
W
q
W
W
q
q
q
q
q
q
q
q
q
q
q
q
q
q
q
R
q
a
a
a
a
q
q
q
q
q
q
q
q
q
R
x
K
"}
(19,1,1) = {"
K
x
R
R
R
R
q
a
a
a
a
a
a
a
a
a
a
a
a
e
a
e
a
e
b
d
d
d
d
d
R
a
a
a
a
a
n
n
a
a
a
a
a
a
a
a
a
a
a
a
a
a
a
R
a
a
a
a
a
a
a
a
a
a
a
a
a
a
R
x
K
"}
(20,1,1) = {"
K
x
R
q
q
q
q
a
a
a
a
a
a
a
a
a
a
a
V
a
e
a
e
a
C
d
d
d
d
d
R
a
a
a
a
a
a
a
a
a
a
a
a
a
a
a
a
a
a
a
a
a
a
a
a
a
a
a
a
a
a
a
a
a
a
a
a
a
R
x
K
"}
(21,1,1) = {"
K
x
R
q
q
q
q
a
a
a
a
a
a
a
a
a
a
a
a
e
a
e
a
e
b
d
d
d
d
d
R
a
a
a
a
a
a
a
a
a
a
a
a
a
a
a
a
a
a
a
a
a
a
R
a
a
a
a
a
a
a
a
a
a
a
a
a
a
R
x
K
"}
(22,1,1) = {"
K
x
R
q
q
q
q
a
a
a
a
a
a
a
a
a
a
a
a
a
e
a
e
a
b
d
d
d
d
d
R
a
a
a
a
a
a
a
a
a
a
a
a
a
a
a
a
a
a
a
n
n
a
R
a
a
a
a
a
a
a
a
a
a
a
a
a
a
R
x
K
"}
(23,1,1) = {"
K
x
R
q
q
q
q
a
a
a
q
R
R
R
q
q
q
q
q
q
w
R
R
R
R
d
d
d
d
d
R
q
q
q
q
q
q
s
q
a
a
a
q
q
q
q
q
q
q
q
W
W
W
R
q
q
q
q
q
q
q
q
q
q
q
q
q
q
R
x
K
"}
(24,1,1) = {"
K
x
R
W
W
q
q
a
a
a
q
R
x
R
R
R
R
R
R
R
R
R
x
x
R
d
d
d
d
d
R
R
R
R
R
R
R
R
q
a
a
a
q
R
R
R
R
R
R
R
R
R
R
R
q
q
q
q
q
q
q
q
q
q
q
q
q
q
R
x
K
"}
(25,1,1) = {"
K
x
R
W
W
q
q
a
a
a
q
R
R
x
x
x
x
x
x
x
x
x
x
x
R
f
f
d
d
d
R
x
x
x
x
x
x
R
q
a
a
a
q
R
x
x
x
x
x
x
x
x
x
R
R
q
q
q
q
q
q
q
W
q
q
q
q
q
R
x
K
"}
(26,1,1) = {"
K
x
R
R
R
R
q
a
a
a
q
q
R
x
K
K
K
K
K
K
K
K
K
x
R
f
f
d
d
d
R
x
K
K
K
K
x
R
R
a
a
a
R
R
x
K
K
K
K
K
K
K
x
x
R
R
q
q
q
q
q
R
R
R
m
m
m
R
R
x
K
"}
(27,1,1) = {"
K
x
x
x
x
R
q
a
a
a
q
q
R
x
K
K
K
K
K
K
K
K
K
x
R
d
d
d
d
d
R
x
K
K
K
K
x
x
R
R
a
R
R
x
x
K
K
K
K
K
K
K
K
x
x
R
R
q
q
q
q
R
x
R
d
d
d
R
x
x
K
"}
(28,1,1) = {"
K
K
K
K
x
R
q
a
a
a
q
q
R
x
K
K
K
K
K
K
K
K
K
x
R
d
d
d
d
d
R
x
K
K
K
K
x
R
R
a
a
a
R
R
x
K
K
K
K
K
K
K
K
K
x
x
R
R
W
W
q
R
x
R
d
d
d
R
x
K
K
"}
(29,1,1) = {"
K
K
K
K
x
R
q
a
a
a
q
q
R
x
K
K
K
K
K
K
K
K
K
x
R
d
d
d
d
d
R
x
K
K
K
x
x
R
q
a
a
a
q
R
x
K
K
K
K
K
K
K
K
K
K
x
x
R
W
W
q
R
x
R
d
d
d
R
x
K
K
"}
(30,1,1) = {"
K
K
K
K
x
R
q
a
a
a
q
q
R
x
K
K
K
K
K
K
K
K
K
x
R
A
A
B
B
B
R
x
x
x
x
x
R
R
q
a
a
a
q
R
x
x
x
x
x
x
x
x
x
x
x
K
x
R
q
q
q
R
x
R
d
d
d
R
x
K
K
"}
(31,1,1) = {"
K
K
K
K
x
R
q
a
a
a
q
q
R
x
K
K
K
K
K
K
K
K
K
x
R
q
A
B
B
B
R
x
x
R
R
R
R
b
q
a
a
a
q
R
R
R
R
R
R
R
R
R
R
R
x
K
x
R
R
R
R
R
x
R
d
d
d
R
x
K
K
"}
(32,1,1) = {"
K
K
K
K
x
R
q
a
a
a
q
q
R
x
K
K
K
K
K
K
K
K
K
x
R
q
A
B
B
B
R
R
R
R
q
q
q
b
q
a
a
a
q
R
d
d
d
d
d
d
d
f
f
R
x
K
x
x
x
x
x
x
x
R
d
d
d
R
x
K
K
"}
(33,1,1) = {"
K
K
K
K
x
R
q
a
a
a
q
q
R
x
K
K
K
K
K
K
K
K
K
x
R
q
q
q
q
q
q
W
W
q
q
q
q
b
W
n
a
a
q
d
d
d
d
d
d
d
d
d
d
R
x
K
K
K
K
K
K
K
x
R
d
d
d
R
x
K
K
"}
(34,1,1) = {"
K
K
K
K
x
R
q
a
a
a
q
q
R
x
K
K
K
K
K
K
K
K
K
x
R
q
q
q
q
q
q
q
q
q
q
q
q
b
W
n
a
a
q
d
d
d
d
d
d
d
d
d
d
R
x
x
x
x
x
x
x
x
x
R
d
d
d
R
x
x
x
"}
(35,1,1) = {"
K
K
K
K
x
R
q
a
a
a
q
R
R
x
K
K
K
K
K
K
K
K
K
x
R
W
W
q
q
q
q
q
q
q
q
q
q
b
q
a
a
a
q
d
d
f
f
d
d
d
d
d
d
R
R
R
R
R
R
R
R
R
R
R
d
d
d
R
R
R
x
"}
(36,1,1) = {"
K
K
K
K
x
R
q
a
a
a
q
R
x
x
x
x
x
x
x
x
x
x
x
x
R
W
W
q
q
q
q
q
q
q
q
q
q
b
z
a
a
a
q
R
d
f
f
d
d
d
d
d
d
b
f
f
d
d
d
d
d
d
d
d
d
d
d
f
f
R
x
"}
(37,1,1) = {"
K
K
K
K
x
R
q
a
a
a
q
R
R
R
R
R
R
R
R
R
R
R
x
x
R
R
R
R
R
R
R
R
R
R
q
q
q
b
q
a
a
a
q
R
R
R
R
R
R
R
m
m
m
b
d
d
d
d
d
d
d
d
d
d
d
d
d
f
f
R
x
"}
(38,1,1) = {"
K
K
K
K
x
R
q
a
a
a
q
q
q
q
s
W
W
q
q
q
q
R
R
x
x
x
x
x
x
x
x
x
x
R
q
q
q
b
q
a
a
a
q
R
x
x
x
x
x
R
m
m
m
b
b
d
d
d
d
d
d
d
d
d
d
d
d
d
d
R
x
"}
(39,1,1) = {"
K
K
K
K
x
R
q
a
a
a
q
q
q
q
q
W
W
q
q
q
q
q
R
R
x
K
K
K
K
K
K
K
x
R
q
q
q
b
q
a
a
a
q
R
x
K
K
K
x
R
d
d
d
u
u
d
d
d
d
d
d
d
d
d
d
d
d
d
d
R
x
"}
(40,1,1) = {"
K
K
K
K
x
R
q
a
a
a
q
q
q
q
q
q
q
q
q
q
q
q
q
R
x
K
K
K
K
K
K
K
x
R
q
q
q
b
q
a
a
a
q
R
x
K
K
K
x
R
d
d
d
u
u
d
d
d
d
d
d
d
d
d
d
d
d
d
d
R
x
"}
(41,1,1) = {"
x
x
x
x
x
R
q
a
a
a
q
q
q
q
q
q
q
q
q
q
q
q
q
R
x
K
K
K
K
K
K
K
x
R
q
q
q
b
q
a
a
a
q
R
x
K
K
K
x
R
R
R
R
R
R
R
R
d
d
d
R
R
R
R
R
R
R
R
R
R
x
"}
(42,1,1) = {"
x
R
R
R
R
R
q
a
a
a
q
q
q
q
q
q
q
q
q
q
q
q
q
R
x
K
K
K
K
K
K
K
x
R
q
q
q
b
q
a
a
a
q
R
x
K
K
K
x
x
x
x
x
x
x
x
R
d
d
d
R
x
x
x
x
x
x
x
x
x
x
"}
(43,1,1) = {"
x
R
f
d
d
b
q
a
a
a
a
a
a
a
a
a
a
a
a
a
a
a
a
R
x
K
K
K
K
K
K
K
x
R
q
q
q
b
q
a
a
a
q
R
x
K
K
K
K
K
K
K
K
K
K
x
R
d
d
d
R
x
K
K
K
K
K
K
K
K
K
"}
(44,1,1) = {"
x
R
d
d
d
b
q
a
a
a
a
a
a
a
a
a
a
a
a
a
a
a
a
R
x
K
K
K
K
K
K
K
x
R
q
q
q
b
q
a
a
a
q
R
x
K
K
K
K
K
K
K
K
K
K
x
R
d
d
d
R
x
K
K
K
K
K
K
K
K
K
"}
(45,1,1) = {"
x
R
d
d
d
c
q
a
a
a
a
a
a
a
a
a
a
a
a
a
a
a
a
R
x
K
K
K
K
K
K
K
x
R
q
q
q
q
q
a
a
a
q
R
x
x
K
K
K
K
K
K
K
K
K
x
R
d
d
d
R
x
K
K
K
K
K
K
K
K
K
"}
(46,1,1) = {"
x
R
d
d
d
c
q
a
a
a
q
q
q
q
q
q
q
R
R
a
a
a
R
R
x
K
K
K
K
K
K
K
x
R
q
q
q
q
q
a
a
a
q
R
R
x
x
x
K
K
K
K
K
K
K
x
R
d
d
d
R
x
K
K
K
K
K
K
K
K
K
"}
(47,1,1) = {"
x
R
d
d
d
b
q
a
a
a
q
b
q
q
q
q
q
R
q
a
a
a
q
R
x
K
K
K
K
K
K
K
x
R
q
q
q
q
q
a
a
a
q
q
R
R
R
x
K
K
K
x
x
x
x
x
R
d
d
d
R
x
x
x
x
x
K
K
K
K
K
"}
(48,1,1) = {"
x
R
d
d
d
b
q
a
a
a
q
b
q
q
q
q
q
R
W
n
a
a
q
R
x
x
x
x
x
x
x
x
x
R
q
q
q
q
q
a
a
a
q
q
s
s
R
x
K
K
K
x
R
R
R
R
R
d
d
d
R
R
R
R
R
x
K
K
K
K
K
"}
(49,1,1) = {"
x
R
f
d
d
b
q
a
a
a
q
b
q
q
q
q
q
R
W
n
a
a
q
R
x
x
R
R
R
R
x
R
R
R
q
q
q
q
q
a
a
a
q
q
s
s
R
x
K
K
K
x
R
d
d
d
d
d
d
d
d
d
f
f
R
x
K
K
K
K
K
"}
(50,1,1) = {"
x
R
R
R
R
b
q
a
a
a
q
b
q
q
q
q
q
R
q
a
a
a
q
R
x
x
R
q
q
R
R
R
q
q
q
q
q
q
q
a
a
a
a
a
a
a
R
x
K
K
K
x
R
d
d
d
d
d
d
d
d
d
f
f
R
x
K
K
K
K
K
"}
(51,1,1) = {"
x
x
x
x
R
R
q
a
a
a
q
R
R
R
q
q
q
R
q
a
a
a
q
R
x
x
R
q
q
q
q
q
q
q
q
q
q
q
q
a
a
a
a
a
a
a
R
x
K
K
K
x
R
d
d
d
d
d
d
d
d
d
d
d
R
x
K
K
K
K
K
"}
(52,1,1) = {"
K
K
K
x
x
R
q
a
a
a
q
R
x
R
R
W
W
R
q
a
a
a
q
R
x
x
R
q
q
q
q
q
q
q
q
q
q
q
q
a
a
a
a
a
a
a
R
x
K
K
K
x
R
d
d
d
d
d
d
d
d
d
d
d
R
x
K
K
K
K
K
"}
(53,1,1) = {"
K
K
K
K
x
R
W
a
a
a
q
R
x
x
R
W
W
R
q
a
a
a
q
R
x
x
R
W
q
q
q
q
q
q
q
q
q
q
q
a
a
a
a
a
a
a
R
x
K
K
K
x
R
B
B
B
B
B
B
B
B
B
B
B
R
x
K
K
K
K
K
"}
(54,1,1) = {"
K
K
K
K
x
R
W
a
a
a
q
R
x
x
R
R
R
R
q
a
a
a
q
R
x
x
R
q
q
q
q
q
q
q
q
q
q
q
s
s
q
q
q
q
W
W
R
x
K
K
K
x
R
a
a
a
a
a
a
a
a
a
a
a
R
x
K
K
K
K
K
"}
(55,1,1) = {"
K
K
K
K
x
R
q
a
a
a
W
R
x
x
x
x
x
R
R
R
a
R
R
R
R
R
R
q
q
q
q
q
q
q
q
q
q
q
s
s
q
q
q
q
W
W
R
x
K
K
K
x
R
a
a
a
a
a
a
a
a
a
a
a
R
x
K
K
K
K
K
"}
(56,1,1) = {"
K
K
K
K
x
R
q
a
a
a
W
R
x
K
K
K
x
R
q
a
a
a
q
q
q
q
q
q
q
q
q
q
q
R
R
R
R
R
R
R
R
q
q
R
R
R
R
x
K
K
K
x
R
n
a
a
a
a
a
a
a
a
a
a
R
x
K
K
K
K
K
"}
(57,1,1) = {"
K
K
K
K
x
R
R
R
R
R
R
R
x
K
K
K
x
R
q
a
a
a
q
q
q
q
q
q
q
q
q
q
R
R
x
x
x
x
x
x
R
q
q
R
x
x
x
x
K
K
K
x
R
W
q
q
q
q
q
q
a
a
a
q
R
x
K
K
K
K
K
"}
(58,1,1) = {"
K
K
K
K
x
x
x
x
x
x
x
x
x
K
K
K
x
R
q
a
a
a
q
q
q
q
q
q
q
q
q
q
R
x
x
K
K
K
K
x
R
q
W
R
x
K
K
K
K
K
K
x
R
b
b
b
b
b
b
q
a
a
a
q
R
x
K
K
K
K
K
"}
(59,1,1) = {"
K
K
K
K
K
K
K
K
K
K
K
K
K
K
K
K
x
R
q
a
a
a
q
q
q
q
q
q
q
q
q
q
R
R
x
x
x
x
x
x
R
q
W
R
x
K
K
K
K
K
K
x
R
q
q
q
W
W
b
q
a
a
a
q
R
x
K
K
K
K
K
"}
(60,1,1) = {"
K
K
K
K
K
K
K
K
K
K
K
K
K
K
K
K
x
R
q
a
a
a
q
q
q
q
q
q
q
q
q
q
q
R
R
R
R
R
R
R
R
q
q
R
x
K
K
K
x
x
x
x
R
q
q
q
W
W
b
q
a
a
a
q
R
x
x
x
x
K
K
"}
(61,1,1) = {"
K
K
K
K
K
K
K
K
K
K
K
K
K
K
K
K
x
R
q
a
a
a
q
q
q
q
q
q
q
q
q
q
q
q
q
q
q
q
q
q
q
q
q
R
x
K
K
K
x
R
R
R
R
q
q
q
q
W
b
q
a
a
a
q
R
R
R
R
x
K
K
"}
(62,1,1) = {"
K
K
K
K
K
K
K
K
K
K
K
K
K
K
K
K
x
R
q
a
a
a
q
q
q
q
q
q
q
q
q
q
q
q
q
q
q
q
q
q
q
q
q
R
x
x
x
x
x
R
W
q
q
q
q
q
q
q
b
q
a
a
a
q
b
q
q
R
x
K
K
"}
(63,1,1) = {"
K
K
K
K
K
K
K
K
K
K
K
K
K
K
K
K
x
R
q
a
a
a
q
q
q
q
W
W
q
q
q
q
q
q
q
b
b
b
b
b
b
b
b
R
R
R
R
x
x
R
W
W
q
q
q
q
q
q
b
q
a
a
a
q
b
q
q
R
x
K
K
"}
(64,1,1) = {"
K
K
K
K
K
K
K
K
K
K
K
K
K
K
K
K
x
R
R
a
a
a
R
R
R
R
W
W
q
q
q
q
q
q
q
q
q
q
q
q
q
q
q
q
q
q
R
x
x
R
W
W
q
q
q
q
q
q
q
q
a
a
a
q
q
q
q
R
x
K
K
"}
(65,1,1) = {"
K
K
K
K
K
K
K
K
K
K
K
K
K
K
K
K
x
x
R
R
R
R
R
x
x
R
R
q
q
q
q
q
q
q
q
q
q
q
q
q
q
q
q
q
q
g
R
R
R
R
q
Z
q
q
q
q
q
q
q
q
a
a
a
q
q
q
q
R
x
K
K
"}
(66,1,1) = {"
K
K
K
K
K
K
K
K
K
K
K
K
K
K
K
K
K
x
x
x
x
x
x
x
x
x
R
a
a
a
a
a
a
a
a
a
a
a
a
a
a
a
V
I
a
I
a
a
I
a
I
V
a
a
a
a
a
a
a
a
a
a
a
a
a
a
a
R
x
K
K
"}
(67,1,1) = {"
K
K
K
K
K
K
K
K
K
K
K
K
K
K
K
K
K
K
K
K
K
K
K
K
K
x
R
a
a
a
a
a
a
a
a
a
a
a
a
a
a
a
a
a
I
a
I
I
a
I
a
a
a
a
a
a
a
a
a
a
a
a
a
a
a
a
a
R
x
K
K
"}
(68,1,1) = {"
K
K
K
K
K
K
K
K
K
K
K
K
K
K
K
K
K
K
K
K
K
K
K
K
K
x
R
a
a
a
a
a
a
a
a
a
a
a
a
a
a
a
a
I
a
I
a
a
I
a
I
a
a
a
a
a
a
a
a
a
a
a
a
a
a
a
a
R
x
K
K
"}
(69,1,1) = {"
K
K
K
K
K
K
K
K
K
K
K
K
K
K
K
K
K
K
K
K
K
K
K
K
K
x
R
q
q
q
q
q
q
q
q
q
q
q
q
q
q
q
q
q
q
g
R
R
R
R
q
Z
q
q
q
q
q
q
q
q
q
q
q
q
q
q
q
R
x
K
K
"}
(70,1,1) = {"
K
K
K
K
K
K
K
K
K
K
K
K
K
K
K
K
K
K
K
K
K
K
K
K
K
x
R
q
q
q
q
q
q
q
q
q
q
q
q
q
q
q
q
q
q
q
R
x
x
R
q
q
q
q
q
q
q
q
q
q
q
q
q
q
q
q
q
R
x
K
K
"}
(71,1,1) = {"
K
K
K
K
K
K
K
K
K
K
K
K
K
K
K
K
K
K
K
K
K
K
K
K
K
x
R
R
R
R
R
R
R
R
R
R
R
q
q
q
q
q
q
q
q
q
R
x
x
R
q
q
q
R
R
R
q
q
q
q
R
R
R
q
q
q
q
R
x
K
K
"}
(72,1,1) = {"
K
K
K
K
K
K
K
K
K
K
K
K
K
K
K
K
K
K
K
K
K
K
K
K
K
x
x
x
x
x
x
x
x
x
x
x
R
R
R
R
R
R
R
R
R
R
R
x
x
R
R
R
R
R
R
R
R
R
R
R
R
R
R
R
R
R
R
R
x
K
K
"}
(73,1,1) = {"
K
K
K
K
K
K
K
K
K
K
K
K
K
K
K
K
K
K
K
K
K
K
K
K
K
K
K
K
K
K
K
K
K
K
K
x
x
x
x
x
x
x
x
x
x
x
x
x
x
x
x
x
x
x
x
x
x
x
x
x
x
x
x
x
x
x
x
x
x
K
K
"}
