//MAP CONVERTED BY dmm2tgm.py THIS HEADER COMMENT PREVENTS RECONVERSION, DO NOT REMOVE
"ao" = (
/obj/structure/railing{
	dir = 1
	},
/obj/structure/window/paperframe,
/obj/machinery/door/poddoor/multi_tile/three_tile_hor{
	resistance_flags = 115
	},
/turf/open/floor/wood,
/area/violence)
"be" = (
/obj/structure/railing{
	dir = 1
	},
/obj/structure/window/paperframe,
/turf/open/floor/wood,
/area/violence)
"bz" = (
/obj/structure/railing{
	dir = 8
	},
/obj/structure/window/paperframe,
/turf/open/floor/wood,
/area/violence)
"cD" = (
/turf/closed/wall/mineral/bamboo,
/area/violence)
"cQ" = (
/obj/structure/window/paperframe,
/obj/machinery/door/poddoor/multi_tile/three_tile_hor{
	resistance_flags = 115
	},
/obj/structure/railing,
/turf/open/floor/wood,
/area/violence)
"dX" = (
/obj/structure/deployable_barricade/wooden{
	dir = 4
	},
/obj/effect/turf_decal/siding/wood,
/turf/open/floor/plasteel/grimy,
/area/violence)
"dZ" = (
/obj/effect/landmark/start/combatant/blue,
/turf/open/floor/bamboo,
/area/violence)
"ez" = (
/obj/structure/railing{
	dir = 4
	},
/obj/structure/window/paperframe,
/turf/open/floor/wood,
/area/violence)
"fj" = (
/obj/structure/window/paperframe,
/obj/structure/railing{
	dir = 4
	},
/turf/open/floor/wood,
/area/violence)
"fx" = (
/obj/effect/landmark/start/combatant/blue,
/turf/open/floor/carpet/blue,
/area/violence)
"hY" = (
/obj/structure/flora/grass/jungle,
/turf/open/floor/plating/grass/jungle,
/area/violence)
"it" = (
/obj/structure/railing{
	dir = 8
	},
/obj/structure/window/paperframe,
/obj/machinery/door/poddoor/multi_tile/three_tile_ver{
	resistance_flags = 115
	},
/turf/open/floor/wood,
/area/violence)
"iy" = (
/obj/structure/railing{
	dir = 4
	},
/obj/structure/window/paperframe,
/obj/machinery/door/poddoor/multi_tile/three_tile_ver{
	resistance_flags = 115
	},
/turf/open/floor/wood,
/area/violence)
"iK" = (
/obj/structure/window/paperframe,
/obj/structure/railing,
/turf/open/floor/bamboo,
/area/violence)
"iV" = (
/obj/structure/railing,
/obj/structure/window/paperframe,
/obj/machinery/door/poddoor{
	resistance_flags = 115
	},
/turf/open/floor/wood,
/area/violence)
"jA" = (
/obj/structure/mineral_door/paperframe,
/obj/machinery/door/poddoor/multi_tile/two_tile_hor{
	layer = 4;
	resistance_flags = 115
	},
/obj/structure/railing/corner{
	dir = 8
	},
/turf/open/floor/bamboo,
/area/violence)
"jK" = (
/obj/structure/flora/tree/jungle/small{
	alpha = 200;
	mouse_opacity = 0
	},
/turf/open/floor/plating/grass/jungle,
/area/violence)
"kO" = (
/obj/structure/railing{
	dir = 8
	},
/obj/structure/lattice/catwalk,
/turf/open/water,
/area/violence)
"ll" = (
/obj/structure/flora/grass/jungle/b,
/turf/open/floor/plating/grass/jungle,
/area/violence)
"lx" = (
/obj/structure/mineral_door/paperframe,
/obj/machinery/door/poddoor/multi_tile/two_tile_hor{
	layer = 4;
	resistance_flags = 115
	},
/obj/structure/railing/corner{
	dir = 1
	},
/turf/open/floor/bamboo,
/area/violence)
"mz" = (
/obj/structure/window/paperframe,
/obj/structure/railing{
	dir = 1
	},
/turf/open/floor/bamboo,
/area/violence)
"nC" = (
/obj/structure/mineral_door/paperframe,
/obj/structure/railing/corner{
	dir = 1
	},
/turf/open/floor/bamboo,
/area/violence)
"oD" = (
/obj/structure/deployable_barricade/wooden{
	dir = 4
	},
/turf/open/floor/plasteel/grimy,
/area/violence)
"pt" = (
/obj/structure/window/paperframe,
/obj/structure/railing{
	dir = 1
	},
/turf/open/floor/wood,
/area/violence)
"qQ" = (
/obj/structure/mineral_door/paperframe,
/obj/structure/railing/corner{
	dir = 4
	},
/turf/open/floor/bamboo,
/area/violence)
"qT" = (
/obj/effect/turf_decal/box/red/corners,
/turf/open/floor/carpet/green,
/area/violence)
"rz" = (
/turf/closed/indestructible/black,
/area/violence)
"rH" = (
/obj/structure/flora/junglebush,
/turf/open/floor/plating/grass/jungle,
/area/violence)
"rL" = (
/obj/structure/window/paperframe,
/obj/structure/railing{
	dir = 8
	},
/turf/open/floor/bamboo,
/area/violence)
"sf" = (
/obj/effect/turf_decal/siding/wood{
	dir = 9
	},
/turf/open/floor/plasteel/grimy,
/area/violence)
"sW" = (
/obj/effect/turf_decal/siding/wood{
	dir = 1
	},
/turf/open/floor/plasteel/grimy,
/area/violence)
"tI" = (
/obj/structure/railing/corner{
	dir = 4
	},
/turf/open/floor/bamboo,
/area/violence)
"tT" = (
/obj/effect/landmark/start/combatant/red,
/turf/open/floor/carpet/red,
/area/violence)
"tX" = (
/obj/structure/deployable_barricade/wooden{
	dir = 1
	},
/turf/open/floor/plasteel/grimy,
/area/violence)
"ug" = (
/obj/structure/window/paperframe,
/obj/structure/railing{
	dir = 8
	},
/turf/open/floor/wood,
/area/violence)
"uj" = (
/obj/effect/baseturf_helper/beach/water,
/turf/closed/indestructible/black,
/area/violence)
"uy" = (
/obj/structure/railing{
	dir = 1
	},
/obj/structure/lattice/catwalk,
/turf/open/water,
/area/violence)
"vJ" = (
/obj/structure/deployable_barricade/wooden{
	dir = 8
	},
/obj/effect/turf_decal/siding/wood{
	dir = 1
	},
/turf/open/floor/plasteel/grimy,
/area/violence)
"vZ" = (
/obj/effect/turf_decal/siding/wood{
	dir = 5
	},
/turf/open/floor/plasteel/grimy,
/area/violence)
"wf" = (
/turf/open/floor/plating/grass/jungle,
/area/violence)
"wk" = (
/obj/structure/deployable_barricade/wooden{
	dir = 8
	},
/turf/open/floor/plasteel/grimy,
/area/violence)
"wX" = (
/obj/effect/turf_decal/siding/wood/corner,
/turf/open/floor/plasteel/grimy,
/area/violence)
"yP" = (
/obj/effect/turf_decal/siding/wood/corner{
	dir = 4
	},
/turf/open/floor/plasteel/grimy,
/area/violence)
"Ai" = (
/obj/effect/turf_decal/siding/wood,
/turf/open/floor/plasteel/grimy,
/area/violence)
"Av" = (
/obj/effect/turf_decal/siding/wood{
	dir = 10
	},
/turf/open/floor/plasteel/grimy,
/area/violence)
"AQ" = (
/obj/structure/deployable_barricade/wooden{
	dir = 8
	},
/obj/effect/turf_decal/siding/wood,
/turf/open/floor/plasteel/grimy,
/area/violence)
"BO" = (
/obj/effect/turf_decal/siding/wood/corner{
	dir = 8
	},
/turf/open/floor/plasteel/grimy,
/area/violence)
"DG" = (
/obj/structure/deployable_barricade/wooden,
/obj/effect/turf_decal/siding/wood{
	dir = 8
	},
/turf/open/floor/plasteel/grimy,
/area/violence)
"Er" = (
/obj/structure/deployable_barricade/wooden,
/obj/effect/turf_decal/siding/wood{
	dir = 4
	},
/turf/open/floor/plasteel/grimy,
/area/violence)
"Ex" = (
/obj/structure/window/paperframe,
/obj/structure/railing,
/turf/open/floor/wood,
/area/violence)
"EV" = (
/turf/open/water,
/area/violence)
"FX" = (
/obj/structure/railing/corner{
	dir = 8
	},
/turf/open/floor/bamboo,
/area/violence)
"GO" = (
/obj/structure/flora/tree/jungle{
	alpha = 200;
	mouse_opacity = 0
	},
/turf/open/floor/plating/grass/jungle,
/area/violence)
"Ik" = (
/obj/structure/deployable_barricade/wooden{
	dir = 1
	},
/obj/effect/turf_decal/siding/wood{
	dir = 4
	},
/turf/open/floor/plasteel/grimy,
/area/violence)
"IJ" = (
/obj/structure/deployable_barricade/wooden,
/turf/open/floor/plasteel/grimy,
/area/violence)
"IW" = (
/obj/structure/railing/corner{
	dir = 1
	},
/turf/open/floor/bamboo,
/area/violence)
"Jc" = (
/obj/structure/window/paperframe,
/obj/machinery/door/poddoor{
	resistance_flags = 115
	},
/obj/structure/railing{
	dir = 1
	},
/turf/open/floor/wood,
/area/violence)
"Jd" = (
/obj/structure/railing/corner,
/turf/open/floor/bamboo,
/area/violence)
"JG" = (
/obj/structure/headpike/bamboo,
/turf/open/floor/plating/grass/jungle,
/area/violence)
"Kk" = (
/obj/structure/deployable_barricade/wooden{
	dir = 4
	},
/obj/effect/turf_decal/siding/wood{
	dir = 1
	},
/turf/open/floor/plasteel/grimy,
/area/violence)
"KB" = (
/obj/structure/punji_sticks,
/turf/open/water,
/area/violence)
"KI" = (
/obj/structure/flora/rock/jungle,
/turf/open/floor/plating/grass/jungle,
/area/violence)
"KQ" = (
/obj/effect/turf_decal/siding/wood/corner{
	dir = 1
	},
/turf/open/floor/plasteel/grimy,
/area/violence)
"LM" = (
/obj/structure/flora/rock/pile/largejungle,
/turf/open/floor/plating/grass/jungle,
/area/violence)
"MG" = (
/obj/effect/landmark/start/combatant/red,
/turf/open/floor/bamboo,
/area/violence)
"MJ" = (
/obj/item/katana,
/turf/open/floor/bamboo,
/area/violence)
"MW" = (
/obj/effect/turf_decal/box/red/corners{
	dir = 8
	},
/turf/open/floor/carpet/green,
/area/violence)
"Nm" = (
/obj/effect/landmark/observer_start,
/turf/open/floor/carpet/green,
/area/violence)
"Np" = (
/obj/structure/mineral_door/paperframe,
/obj/structure/railing/corner,
/turf/open/floor/bamboo,
/area/violence)
"Nw" = (
/turf/open/floor/plasteel/grimy,
/area/violence)
"OR" = (
/obj/effect/turf_decal/box/red,
/obj/effect/landmark/bomb_plant_location,
/turf/open/floor/carpet/green,
/area/violence)
"Pw" = (
/turf/open/floor/bamboo,
/area/violence)
"Rl" = (
/obj/structure/railing,
/obj/structure/lattice/catwalk,
/turf/open/water,
/area/violence)
"RK" = (
/obj/effect/turf_decal/box/red/corners{
	dir = 4
	},
/turf/open/floor/carpet/green,
/area/violence)
"St" = (
/obj/structure/mineral_door/paperframe,
/obj/structure/railing/corner{
	dir = 8
	},
/turf/open/floor/bamboo,
/area/violence)
"Ta" = (
/obj/structure/deployable_barricade/wooden{
	dir = 1
	},
/obj/effect/turf_decal/siding/wood{
	dir = 8
	},
/turf/open/floor/plasteel/grimy,
/area/violence)
"Tk" = (
/obj/structure/window/paperframe,
/obj/structure/railing{
	dir = 4
	},
/turf/open/floor/bamboo,
/area/violence)
"TH" = (
/obj/effect/turf_decal/siding/wood{
	dir = 8
	},
/turf/open/floor/plasteel/grimy,
/area/violence)
"TQ" = (
/obj/effect/turf_decal/siding/wood{
	dir = 4
	},
/turf/open/floor/plasteel/grimy,
/area/violence)
"Wd" = (
/obj/structure/railing{
	dir = 4
	},
/obj/structure/lattice/catwalk,
/turf/open/water,
/area/violence)
"Xl" = (
/obj/effect/turf_decal/siding/wood{
	dir = 6
	},
/turf/open/floor/plasteel/grimy,
/area/violence)
"Xv" = (
/obj/effect/turf_decal/box/red/corners{
	dir = 1
	},
/turf/open/floor/carpet/green,
/area/violence)
"XA" = (
/turf/open/floor/carpet/green,
/area/violence)
"ZA" = (
/obj/structure/window/paperframe,
/turf/open/floor/wood,
/area/violence)

(1,1,1) = {"
uj
rz
rz
rz
rz
rz
rz
rz
rz
rz
rz
rz
rz
rz
rz
rz
rz
rz
rz
rz
rz
rz
rz
rz
rz
rz
rz
rz
rz
rz
rz
rz
rz
rz
rz
rz
rz
rz
rz
rz
rz
rz
rz
rz
rz
rz
rz
rz
rz
rz
rz
rz
rz
rz
rz
rz
rz
rz
rz
rz
"}
(2,1,1) = {"
rz
EV
EV
EV
EV
EV
EV
EV
EV
EV
EV
EV
EV
EV
EV
EV
EV
EV
EV
EV
EV
EV
EV
EV
EV
EV
EV
EV
KB
EV
EV
KB
EV
EV
EV
EV
EV
EV
EV
EV
EV
EV
EV
EV
EV
EV
EV
EV
EV
EV
EV
EV
EV
EV
EV
EV
EV
EV
EV
rz
"}
(3,1,1) = {"
rz
EV
EV
EV
EV
EV
EV
EV
EV
EV
EV
EV
EV
EV
EV
EV
EV
EV
EV
EV
EV
EV
EV
EV
EV
EV
EV
EV
KB
EV
EV
KB
EV
EV
EV
EV
EV
EV
EV
EV
EV
EV
EV
EV
EV
EV
EV
EV
EV
EV
EV
EV
EV
EV
EV
EV
EV
EV
EV
rz
"}
(4,1,1) = {"
rz
EV
EV
EV
EV
EV
EV
EV
EV
EV
EV
EV
EV
jK
wf
rH
wf
wf
wf
wf
wf
wf
wf
wf
wf
wf
wf
EV
KB
EV
EV
KB
EV
wf
wf
wf
wf
wf
wf
wf
cD
rL
rL
rL
rL
rL
cD
EV
EV
EV
EV
EV
EV
EV
EV
EV
EV
EV
EV
rz
"}
(5,1,1) = {"
rz
EV
EV
EV
EV
EV
EV
EV
EV
EV
EV
EV
EV
wf
cD
rL
rL
rL
cD
ug
ug
ug
ug
ug
ug
ug
ug
ug
cD
rL
rL
cD
ug
ug
ug
ug
ug
ug
ug
ug
IW
Pw
Pw
Pw
Pw
Pw
iK
EV
EV
EV
EV
EV
EV
EV
EV
EV
EV
EV
EV
rz
"}
(6,1,1) = {"
rz
EV
EV
EV
EV
EV
EV
EV
EV
EV
EV
EV
EV
ll
mz
sf
TH
TH
DG
TH
TH
TH
TH
TH
TH
TH
TH
TH
Ta
TH
TH
TH
TH
TH
TH
TH
TH
TH
Ta
TH
TH
TH
TH
TH
Av
Pw
iK
EV
EV
EV
EV
EV
EV
EV
EV
EV
EV
EV
EV
rz
"}
(7,1,1) = {"
rz
EV
EV
EV
EV
EV
EV
EV
EV
EV
EV
EV
EV
wf
mz
sW
Nw
Nw
IJ
Nw
Nw
Nw
Nw
Nw
Nw
Nw
Nw
Nw
tX
Nw
Nw
Nw
Nw
Nw
Nw
Nw
tX
Nw
Nw
Nw
Nw
Nw
Nw
Nw
Ai
Pw
iK
EV
EV
EV
EV
EV
EV
EV
EV
EV
EV
EV
EV
rz
"}
(8,1,1) = {"
rz
EV
EV
EV
EV
EV
EV
EV
EV
EV
EV
EV
EV
wf
mz
sW
Nw
wX
Er
TQ
TQ
TQ
TQ
TQ
TQ
TQ
TQ
TQ
Ik
TQ
TQ
TQ
TQ
TQ
TQ
TQ
TQ
TQ
Ik
TQ
TQ
TQ
yP
Nw
Ai
Pw
iK
EV
EV
EV
EV
EV
EV
EV
EV
EV
EV
EV
EV
rz
"}
(9,1,1) = {"
rz
EV
EV
EV
EV
EV
EV
EV
EV
EV
EV
EV
EV
wf
cD
sW
Nw
Ai
cD
fj
fj
fj
fj
fj
fj
fj
fj
fj
cD
qQ
Np
cD
fj
fj
fj
fj
fj
fj
fj
fj
tI
Pw
sW
Nw
Ai
Pw
iK
EV
EV
EV
EV
EV
EV
EV
EV
EV
EV
EV
EV
rz
"}
(10,1,1) = {"
rz
EV
EV
EV
EV
EV
EV
EV
EV
EV
EV
EV
EV
wf
pt
sW
Nw
Ai
Ex
GO
ll
wf
wf
wf
wf
wf
EV
KB
EV
uy
Rl
EV
KB
EV
wf
wf
wf
wf
wf
wf
cD
tI
sW
Nw
Ai
Jd
cD
EV
EV
EV
EV
EV
EV
EV
EV
EV
EV
EV
EV
rz
"}
(11,1,1) = {"
rz
EV
EV
EV
EV
EV
EV
EV
EV
EV
EV
EV
EV
wf
pt
sW
Nw
Ai
Ex
hY
wf
wf
wf
wf
wf
wf
EV
KB
EV
uy
Rl
EV
KB
EV
EV
EV
EV
EV
EV
wf
wf
pt
sW
Nw
Ai
Ex
wf
EV
EV
EV
EV
EV
EV
EV
EV
EV
EV
EV
EV
rz
"}
(12,1,1) = {"
rz
EV
EV
EV
EV
EV
EV
EV
EV
EV
EV
EV
EV
wf
pt
sW
Nw
Ai
Ex
wf
wf
wf
wf
wf
wf
EV
EV
KB
EV
uy
Rl
EV
KB
EV
EV
wf
wf
wf
EV
wf
wf
pt
Kk
Nw
dX
Ex
wf
EV
EV
EV
EV
EV
EV
EV
EV
EV
EV
EV
EV
rz
"}
(13,1,1) = {"
rz
EV
EV
EV
EV
EV
EV
EV
EV
EV
EV
EV
EV
wf
pt
sW
Nw
Ai
Ex
wf
wf
wf
EV
EV
EV
EV
EV
JG
JG
uy
Rl
JG
JG
EV
EV
wf
LM
wf
EV
wf
wf
pt
sW
Nw
Ai
Ex
wf
EV
EV
EV
EV
EV
EV
EV
EV
EV
EV
EV
EV
rz
"}
(14,1,1) = {"
rz
EV
EV
EV
EV
EV
EV
EV
EV
EV
EV
EV
EV
wf
pt
sW
Nw
Ai
Ex
wf
wf
wf
EV
KI
wf
EV
cD
ZA
cD
nC
St
cD
ZA
cD
EV
wf
wf
wf
EV
wf
wf
pt
sW
oD
Ai
Ex
wf
EV
EV
EV
EV
EV
EV
EV
EV
EV
EV
EV
EV
rz
"}
(15,1,1) = {"
rz
EV
EV
EV
EV
EV
EV
EV
EV
EV
EV
EV
EV
wf
pt
sW
Nw
Ai
Ex
wf
wf
wf
EV
wf
wf
EV
ZA
Pw
Pw
Pw
Pw
Pw
Pw
ZA
EV
wf
wf
wf
EV
wf
wf
pt
sW
Nw
Ai
Ex
wf
EV
EV
EV
EV
EV
EV
EV
EV
EV
EV
EV
EV
rz
"}
(16,1,1) = {"
rz
EV
EV
EV
EV
EV
EV
EV
EV
EV
EV
EV
EV
wf
pt
sW
Nw
Ai
Ex
wf
wf
EV
EV
cD
ZA
ZA
cD
Pw
Pw
Pw
Pw
Pw
Pw
cD
ZA
ZA
cD
EV
EV
EV
wf
pt
sW
Nw
Ai
Ex
wf
EV
EV
EV
EV
EV
EV
EV
EV
EV
EV
EV
EV
rz
"}
(17,1,1) = {"
rz
EV
cD
bz
bz
it
bz
bz
it
cD
EV
EV
EV
wf
pt
sW
Nw
Ai
Ex
EV
EV
EV
EV
ZA
Pw
Pw
Pw
Pw
Pw
Pw
Pw
Pw
Pw
Pw
Pw
Pw
ZA
EV
EV
EV
EV
pt
sW
Nw
Ai
Ex
wf
EV
EV
EV
cD
bz
bz
it
bz
bz
it
cD
EV
rz
"}
(18,1,1) = {"
rz
EV
ao
dZ
dZ
dZ
dZ
dZ
dZ
iV
EV
EV
EV
EV
pt
sW
Nw
Ai
Ex
KB
KB
KB
JG
ZA
Pw
Pw
Pw
Pw
XA
XA
XA
XA
Pw
Pw
Pw
Pw
ZA
JG
KB
KB
KB
pt
sW
Nw
Ai
Ex
EV
EV
EV
EV
Jc
MG
MG
MG
MG
MG
MG
cQ
EV
rz
"}
(19,1,1) = {"
rz
EV
be
dZ
fx
fx
fx
fx
dZ
cD
KB
KB
KB
KB
cD
sW
Nw
Ai
cD
EV
EV
EV
JG
cD
Pw
Pw
Pw
XA
XA
XA
XA
XA
XA
Pw
Pw
Pw
cD
JG
EV
EV
EV
cD
sW
oD
dX
cD
KB
KB
KB
KB
cD
MG
tT
tT
tT
tT
MG
Ex
EV
rz
"}
(20,1,1) = {"
rz
EV
be
dZ
fx
fx
fx
fx
dZ
jA
kO
kO
kO
kO
nC
Nw
Nw
Ai
St
kO
kO
kO
kO
nC
Pw
MJ
Pw
XA
qT
Nm
RK
XA
XA
Pw
Pw
Pw
St
kO
kO
kO
kO
nC
sW
Nw
Ai
St
kO
kO
kO
kO
lx
MG
tT
tT
tT
tT
MG
Ex
EV
rz
"}
(21,1,1) = {"
rz
EV
ao
dZ
fx
fx
fx
fx
dZ
Np
Wd
Wd
Wd
Wd
qQ
Nw
Nw
Ai
Np
Wd
Wd
Wd
Wd
qQ
Pw
Pw
Pw
XA
XA
OR
XA
XA
XA
Pw
MJ
Pw
Np
Wd
Wd
Wd
Wd
qQ
sW
Nw
Ai
Np
Wd
Wd
Wd
Wd
qQ
MG
tT
tT
tT
tT
MG
cQ
EV
rz
"}
(22,1,1) = {"
rz
EV
be
dZ
fx
fx
fx
fx
dZ
cD
KB
KB
KB
KB
cD
vJ
wk
Ai
cD
EV
EV
EV
JG
cD
Pw
Pw
Pw
XA
MW
XA
Xv
XA
XA
Pw
Pw
Pw
cD
JG
EV
EV
EV
cD
sW
Nw
Ai
cD
KB
KB
KB
KB
cD
MG
tT
tT
tT
tT
MG
Ex
EV
rz
"}
(23,1,1) = {"
rz
EV
be
dZ
dZ
dZ
dZ
dZ
dZ
iV
EV
EV
EV
EV
pt
sW
Nw
Ai
Ex
KB
KB
KB
JG
ZA
Pw
Pw
Pw
Pw
XA
XA
XA
XA
Pw
Pw
Pw
Pw
ZA
JG
KB
KB
KB
pt
sW
Nw
Ai
Ex
EV
EV
EV
EV
Jc
MG
MG
MG
MG
MG
MG
Ex
EV
rz
"}
(24,1,1) = {"
rz
EV
cD
ez
ez
iy
ez
ez
iy
cD
EV
EV
EV
wf
pt
sW
Nw
Ai
Ex
EV
EV
EV
EV
ZA
Pw
Pw
Pw
Pw
Pw
Pw
Pw
Pw
Pw
Pw
Pw
Pw
ZA
EV
EV
EV
EV
pt
sW
Nw
Ai
Ex
wf
EV
EV
EV
cD
ez
ez
iy
ez
ez
iy
cD
EV
rz
"}
(25,1,1) = {"
rz
EV
EV
EV
EV
EV
EV
EV
EV
EV
EV
EV
EV
wf
pt
sW
Nw
Ai
Ex
wf
EV
EV
EV
cD
ZA
ZA
cD
Pw
Pw
Pw
Pw
Pw
Pw
cD
ZA
ZA
cD
EV
EV
wf
wf
pt
sW
Nw
Ai
Ex
wf
EV
EV
EV
EV
EV
EV
EV
EV
EV
EV
EV
EV
rz
"}
(26,1,1) = {"
rz
EV
EV
EV
EV
EV
EV
EV
EV
EV
EV
EV
EV
wf
pt
sW
Nw
Ai
Ex
wf
wf
EV
wf
wf
wf
EV
ZA
Pw
Pw
Pw
Pw
Pw
Pw
ZA
EV
wf
wf
EV
wf
wf
wf
pt
sW
Nw
Ai
Ex
wf
EV
EV
EV
EV
EV
EV
EV
EV
EV
EV
EV
EV
rz
"}
(27,1,1) = {"
rz
EV
EV
EV
EV
EV
EV
EV
EV
EV
EV
EV
EV
wf
pt
sW
wk
Ai
Ex
wf
wf
EV
wf
wf
wf
EV
cD
ZA
cD
qQ
Np
cD
ZA
cD
EV
wf
KI
EV
wf
wf
wf
pt
sW
Nw
Ai
Ex
wf
EV
EV
EV
EV
EV
EV
EV
EV
EV
EV
EV
EV
rz
"}
(28,1,1) = {"
rz
EV
EV
EV
EV
EV
EV
EV
EV
EV
EV
EV
EV
wf
pt
sW
Nw
Ai
Ex
wf
wf
EV
wf
LM
wf
EV
EV
JG
JG
uy
Rl
JG
JG
EV
EV
EV
EV
EV
wf
wf
wf
pt
sW
Nw
Ai
Ex
wf
EV
EV
EV
EV
EV
EV
EV
EV
EV
EV
EV
EV
rz
"}
(29,1,1) = {"
rz
EV
EV
EV
EV
EV
EV
EV
EV
EV
EV
EV
EV
wf
pt
vJ
Nw
AQ
Ex
wf
wf
EV
wf
wf
wf
EV
EV
KB
EV
uy
Rl
EV
KB
EV
EV
wf
wf
wf
wf
wf
wf
pt
sW
Nw
Ai
Ex
wf
EV
EV
EV
EV
EV
EV
EV
EV
EV
EV
EV
EV
rz
"}
(30,1,1) = {"
rz
EV
EV
EV
EV
EV
EV
EV
EV
EV
EV
EV
EV
wf
pt
sW
Nw
Ai
Ex
wf
wf
EV
EV
EV
EV
EV
EV
KB
EV
uy
Rl
EV
KB
EV
wf
wf
wf
wf
wf
wf
hY
pt
sW
Nw
Ai
Ex
wf
EV
EV
EV
EV
EV
EV
EV
EV
EV
EV
EV
EV
rz
"}
(31,1,1) = {"
rz
EV
EV
EV
EV
EV
EV
EV
EV
EV
EV
EV
EV
cD
IW
sW
Nw
Ai
FX
cD
wf
wf
wf
wf
wf
wf
EV
KB
EV
uy
Rl
EV
KB
EV
wf
wf
wf
wf
wf
wf
GO
pt
sW
Nw
Ai
Ex
wf
EV
EV
EV
EV
EV
EV
EV
EV
EV
EV
EV
EV
rz
"}
(32,1,1) = {"
rz
EV
EV
EV
EV
EV
EV
EV
EV
EV
EV
EV
EV
mz
Pw
sW
Nw
Ai
Pw
FX
ug
ug
ug
ug
ug
ug
ug
ug
cD
nC
St
cD
ug
ug
ug
ug
ug
ug
ug
ug
ug
cD
sW
Nw
Ai
cD
wf
EV
EV
EV
EV
EV
EV
EV
EV
EV
EV
EV
EV
rz
"}
(33,1,1) = {"
rz
EV
EV
EV
EV
EV
EV
EV
EV
EV
EV
EV
EV
mz
Pw
sW
Nw
BO
TH
TH
TH
DG
TH
TH
TH
TH
TH
TH
TH
TH
TH
DG
TH
TH
TH
TH
TH
TH
TH
TH
TH
Ta
KQ
Nw
Ai
iK
wf
EV
EV
EV
EV
EV
EV
EV
EV
EV
EV
EV
EV
rz
"}
(34,1,1) = {"
rz
EV
EV
EV
EV
EV
EV
EV
EV
EV
EV
EV
EV
mz
Pw
sW
Nw
Nw
Nw
Nw
Nw
Nw
Nw
IJ
Nw
Nw
Nw
Nw
Nw
Nw
Nw
IJ
Nw
Nw
Nw
Nw
Nw
Nw
Nw
Nw
Nw
tX
Nw
Nw
Ai
iK
wf
EV
EV
EV
EV
EV
EV
EV
EV
EV
EV
EV
EV
rz
"}
(35,1,1) = {"
rz
EV
EV
EV
EV
EV
EV
EV
EV
EV
EV
EV
EV
mz
Pw
vZ
TQ
TQ
TQ
TQ
TQ
Er
TQ
TQ
TQ
TQ
TQ
TQ
TQ
TQ
TQ
Er
TQ
TQ
TQ
TQ
TQ
TQ
TQ
TQ
TQ
Ik
TQ
TQ
Xl
iK
wf
EV
EV
EV
EV
EV
EV
EV
EV
EV
EV
EV
EV
rz
"}
(36,1,1) = {"
rz
EV
EV
EV
EV
EV
EV
EV
EV
EV
EV
EV
EV
mz
Pw
Pw
Pw
Pw
Pw
Jd
fj
fj
fj
fj
fj
fj
fj
fj
cD
Tk
Tk
cD
fj
fj
fj
fj
fj
fj
fj
fj
fj
cD
Tk
Tk
Tk
cD
ll
EV
EV
EV
EV
EV
EV
EV
EV
EV
EV
EV
EV
rz
"}
(37,1,1) = {"
rz
EV
EV
EV
EV
EV
EV
EV
EV
EV
EV
EV
EV
cD
Tk
Tk
Tk
Tk
Tk
cD
wf
wf
wf
wf
wf
wf
wf
EV
KB
EV
EV
KB
EV
wf
wf
wf
wf
wf
wf
wf
wf
wf
wf
wf
rH
wf
jK
EV
EV
EV
EV
EV
EV
EV
EV
EV
EV
EV
EV
rz
"}
(38,1,1) = {"
rz
EV
EV
EV
EV
EV
EV
EV
EV
EV
EV
EV
EV
EV
EV
EV
EV
EV
EV
EV
EV
EV
EV
EV
EV
EV
EV
EV
KB
EV
EV
KB
EV
EV
EV
EV
EV
EV
EV
EV
EV
EV
EV
EV
EV
EV
EV
EV
EV
EV
EV
EV
EV
EV
EV
EV
EV
EV
EV
rz
"}
(39,1,1) = {"
rz
EV
EV
EV
EV
EV
EV
EV
EV
EV
EV
EV
EV
EV
EV
EV
EV
EV
EV
EV
EV
EV
EV
EV
EV
EV
EV
EV
KB
EV
EV
KB
EV
EV
EV
EV
EV
EV
EV
EV
EV
EV
EV
EV
EV
EV
EV
EV
EV
EV
EV
EV
EV
EV
EV
EV
EV
EV
EV
rz
"}
(40,1,1) = {"
rz
rz
rz
rz
rz
rz
rz
rz
rz
rz
rz
rz
rz
rz
rz
rz
rz
rz
rz
rz
rz
rz
rz
rz
rz
rz
rz
rz
rz
rz
rz
rz
rz
rz
rz
rz
rz
rz
rz
rz
rz
rz
rz
rz
rz
rz
rz
rz
rz
rz
rz
rz
rz
rz
rz
rz
rz
rz
rz
rz
"}
