//MAP CONVERTED BY dmm2tgm.py THIS HEADER COMMENT PREVENTS RECONVERSION, DO NOT REMOVE
"aO" = (
/obj/effect/landmark/start/combatant/blue,
/obj/effect/particle_cyberspess,
/turf/open/floor/dz/cyber,
/area/violence)
"cC" = (
/turf/closed/dz/normal/cyber/ice/blue,
/area/violence)
"dr" = (
/obj/effect/turf_decal/box/red/corners{
	dir = 1
	},
/turf/open/floor/dz/green,
/area/violence)
"dG" = (
/obj/effect/powerup/health,
/turf/open/floor/dz/cyber,
/area/violence)
"jk" = (
/obj/effect/turf_decal/box/red/corners,
/turf/open/floor/dz/green,
/area/violence)
"jo" = (
/obj/structure/sign/dz/end,
/turf/closed/dz/normal/cyber,
/area/violence)
"jD" = (
/obj/machinery/door/poddoor/multi_tile/three_tile_ver{
	resistance_flags = 115
	},
/turf/open/floor/dz/cyber,
/area/violence)
"mj" = (
/obj/machinery/door/poddoor/multi_tile/three_tile_hor{
	resistance_flags = 115
	},
/turf/open/floor/dz/cyber,
/area/violence)
"mp" = (
/obj/effect/baseturf_helper/dune,
/turf/closed/dz/normal/cyber,
/area/violence)
"nd" = (
/obj/machinery/power/emitter/energycannon{
	dir = 8
	},
/turf/closed/dz/normal/cyber,
/area/violence)
"oE" = (
/obj/effect/landmark/bomb_plant_location,
/obj/effect/turf_decal/box/red,
/obj/effect/particle_cyberspess,
/turf/open/floor/dz/trippy_green,
/area/violence)
"sq" = (
/obj/effect/landmark/start/combatant/red,
/turf/open/floor/dz/cyber,
/area/violence)
"sR" = (
/obj/structure/sign/dz,
/turf/closed/dz/normal/cyber,
/area/violence)
"xw" = (
/turf/open/floor/dz/cyber,
/area/violence)
"zU" = (
/obj/effect/mapping_helpers/turf_rotation,
/turf/open/floor/dz/hot_plates,
/area/violence)
"Ab" = (
/obj/machinery/power/emitter/energycannon{
	dir = 4
	},
/turf/closed/dz/normal/cyber,
/area/violence)
"CQ" = (
/turf/closed/dz/normal/cyber,
/area/violence)
"GZ" = (
/obj/lab_monitor{
	what_pic = "survive"
	},
/turf/closed/dz/normal/cyber,
/area/violence)
"Hy" = (
/obj/effect/powerup/health/full,
/turf/open/floor/dz/cyber,
/area/violence)
"IU" = (
/obj/effect/turf_decal/box/red/corners{
	dir = 4
	},
/turf/open/floor/dz/green,
/area/violence)
"Js" = (
/obj/effect/powerup/ammo,
/turf/open/floor/dz/cyber,
/area/violence)
"JA" = (
/obj/structure/sign/poster/random,
/turf/closed/dz/normal/cyber,
/area/violence)
"JJ" = (
/obj/effect/landmark/start/combatant/red,
/obj/effect/particle_cyberspess,
/turf/open/floor/dz/cyber,
/area/violence)
"Kt" = (
/turf/closed/dz/normal/cyber/ice/green,
/area/violence)
"Li" = (
/obj/effect/landmark/start/combatant/blue,
/turf/open/floor/dz/cyber,
/area/violence)
"Lr" = (
/turf/closed/dz/normal/cyber/ice/yellow,
/area/violence)
"Nb" = (
/obj/effect/turf_decal/box/red/corners{
	dir = 8
	},
/turf/open/floor/dz/green,
/area/violence)
"Ss" = (
/obj/lab_monitor,
/turf/closed/dz/normal/cyber,
/area/violence)
"TI" = (
/turf/closed/dz/normal/cyber/ice/black,
/area/violence)
"UD" = (
/obj/effect/particle_cyberspess,
/turf/open/floor/dz/cyber,
/area/violence)
"VO" = (
/obj/structure/sign/dz/middle,
/turf/closed/dz/normal/cyber,
/area/violence)
"ZH" = (
/turf/open/floor/dz/green,
/area/violence)

(1,1,1) = {"
mp
CQ
CQ
CQ
CQ
CQ
CQ
CQ
CQ
CQ
CQ
CQ
CQ
CQ
CQ
CQ
Ab
CQ
CQ
Ab
CQ
CQ
CQ
CQ
CQ
CQ
CQ
CQ
CQ
CQ
CQ
CQ
CQ
CQ
CQ
CQ
CQ
CQ
CQ
"}
(2,1,1) = {"
CQ
Kt
Kt
Kt
Kt
Kt
CQ
Lr
Lr
Lr
Lr
Lr
Lr
Lr
Lr
Lr
TI
Lr
CQ
zU
zU
zU
zU
zU
zU
CQ
Lr
Lr
Lr
Lr
Lr
Lr
CQ
Kt
Kt
Kt
Kt
Kt
CQ
"}
(3,1,1) = {"
CQ
Kt
zU
zU
zU
zU
TI
xw
xw
xw
xw
xw
xw
xw
xw
xw
xw
xw
CQ
zU
zU
zU
zU
zU
zU
TI
xw
xw
xw
xw
xw
xw
TI
zU
zU
zU
zU
Kt
CQ
"}
(4,1,1) = {"
CQ
Kt
zU
zU
zU
zU
TI
xw
UD
xw
xw
xw
xw
xw
xw
xw
UD
xw
CQ
zU
zU
zU
zU
zU
zU
TI
xw
xw
xw
xw
xw
xw
TI
zU
zU
zU
zU
Kt
CQ
"}
(5,1,1) = {"
CQ
Kt
zU
zU
zU
Kt
CQ
xw
xw
xw
xw
xw
xw
xw
xw
xw
xw
xw
CQ
zU
zU
zU
zU
zU
zU
CQ
xw
xw
UD
xw
xw
xw
CQ
Kt
zU
zU
zU
Kt
CQ
"}
(6,1,1) = {"
CQ
Kt
zU
zU
zU
Kt
CQ
xw
xw
xw
CQ
CQ
CQ
CQ
CQ
CQ
TI
CQ
CQ
zU
zU
zU
zU
zU
zU
CQ
xw
xw
xw
xw
xw
xw
CQ
Kt
zU
zU
zU
Kt
CQ
"}
(7,1,1) = {"
CQ
Kt
zU
zU
zU
Kt
CQ
xw
xw
xw
CQ
cC
cC
cC
cC
CQ
xw
zU
zU
zU
zU
zU
zU
zU
zU
CQ
xw
xw
xw
xw
xw
xw
CQ
Kt
zU
zU
zU
Kt
CQ
"}
(8,1,1) = {"
CQ
Kt
zU
zU
zU
Kt
CQ
xw
xw
xw
CQ
cC
cC
cC
cC
GZ
xw
zU
zU
zU
zU
zU
zU
Ss
CQ
CQ
CQ
CQ
CQ
cC
cC
cC
CQ
Kt
zU
zU
zU
Kt
CQ
"}
(9,1,1) = {"
CQ
Kt
zU
zU
zU
Kt
CQ
xw
xw
xw
TI
cC
cC
cC
cC
TI
xw
zU
zU
zU
zU
zU
Hy
CQ
cC
cC
cC
cC
CQ
cC
cC
cC
CQ
Kt
zU
zU
zU
Kt
CQ
"}
(10,1,1) = {"
CQ
Kt
zU
zU
zU
Kt
CQ
xw
xw
xw
TI
cC
cC
cC
cC
TI
xw
zU
zU
zU
zU
zU
xw
CQ
cC
cC
cC
cC
CQ
cC
cC
cC
CQ
Kt
zU
zU
zU
Kt
CQ
"}
(11,1,1) = {"
CQ
Kt
zU
zU
zU
Kt
CQ
cC
cC
cC
CQ
cC
cC
cC
cC
GZ
xw
zU
zU
zU
zU
zU
xw
CQ
cC
cC
cC
cC
CQ
cC
cC
cC
CQ
Kt
zU
zU
zU
Kt
CQ
"}
(12,1,1) = {"
CQ
Kt
zU
zU
zU
Kt
CQ
cC
cC
cC
CQ
cC
cC
cC
cC
CQ
xw
zU
zU
zU
zU
zU
xw
CQ
cC
cC
cC
cC
CQ
cC
cC
cC
CQ
Kt
zU
zU
zU
Kt
CQ
"}
(13,1,1) = {"
CQ
CQ
xw
xw
jD
CQ
CQ
CQ
CQ
CQ
CQ
cC
cC
cC
cC
CQ
xw
zU
zU
zU
zU
zU
xw
CQ
cC
cC
cC
cC
CQ
CQ
CQ
CQ
CQ
CQ
xw
xw
jD
CQ
CQ
"}
(14,1,1) = {"
CQ
sq
sq
sq
sq
sq
GZ
dG
dG
dG
GZ
cC
cC
cC
cC
CQ
TI
CQ
JA
TI
JA
CQ
TI
CQ
cC
cC
cC
cC
GZ
Js
Js
Js
CQ
Li
Li
Li
Li
Li
CQ
"}
(15,1,1) = {"
sR
sq
sq
sq
sq
sq
mj
xw
xw
xw
TI
cC
cC
cC
cC
cC
xw
TI
jk
ZH
IU
TI
xw
cC
cC
cC
cC
cC
TI
xw
xw
xw
mj
Li
Li
Li
Li
Li
sR
"}
(16,1,1) = {"
VO
sq
sq
JJ
sq
sq
xw
xw
xw
xw
TI
cC
cC
cC
cC
cC
xw
TI
ZH
oE
ZH
TI
xw
cC
cC
cC
cC
cC
TI
xw
xw
xw
xw
Li
Li
aO
Li
Li
VO
"}
(17,1,1) = {"
jo
sq
sq
sq
sq
sq
xw
xw
xw
xw
TI
cC
cC
cC
cC
cC
xw
TI
Nb
ZH
dr
TI
xw
cC
cC
cC
cC
cC
TI
xw
xw
xw
xw
Li
Li
Li
Li
Li
jo
"}
(18,1,1) = {"
CQ
sq
sq
sq
sq
sq
CQ
Js
Js
Js
GZ
cC
cC
cC
cC
CQ
TI
CQ
JA
TI
JA
CQ
TI
CQ
cC
cC
cC
cC
GZ
dG
dG
dG
GZ
Li
Li
Li
Li
Li
CQ
"}
(19,1,1) = {"
CQ
CQ
xw
xw
jD
CQ
CQ
CQ
CQ
CQ
CQ
cC
cC
cC
cC
CQ
xw
zU
zU
zU
zU
zU
xw
CQ
cC
cC
cC
cC
CQ
CQ
CQ
CQ
CQ
CQ
xw
xw
jD
CQ
CQ
"}
(20,1,1) = {"
CQ
Kt
zU
zU
zU
Kt
CQ
cC
cC
cC
CQ
cC
cC
cC
cC
CQ
xw
zU
zU
zU
zU
zU
xw
CQ
cC
cC
cC
cC
CQ
cC
cC
cC
CQ
Kt
zU
zU
zU
Kt
CQ
"}
(21,1,1) = {"
CQ
Kt
zU
zU
zU
Kt
CQ
cC
cC
cC
CQ
cC
cC
cC
cC
CQ
xw
zU
zU
zU
zU
zU
xw
GZ
cC
cC
cC
cC
CQ
cC
cC
cC
CQ
Kt
zU
zU
zU
Kt
CQ
"}
(22,1,1) = {"
CQ
Kt
zU
zU
zU
Kt
CQ
cC
cC
cC
CQ
cC
cC
cC
cC
CQ
xw
zU
zU
zU
zU
zU
xw
TI
cC
cC
cC
cC
TI
xw
xw
xw
CQ
Kt
zU
zU
zU
Kt
CQ
"}
(23,1,1) = {"
CQ
Kt
zU
zU
zU
Kt
CQ
cC
cC
cC
CQ
cC
cC
cC
cC
CQ
Hy
zU
zU
zU
zU
zU
xw
TI
cC
cC
cC
cC
TI
xw
xw
xw
CQ
Kt
zU
zU
zU
Kt
CQ
"}
(24,1,1) = {"
CQ
Kt
zU
zU
zU
Kt
CQ
cC
cC
cC
CQ
CQ
CQ
CQ
CQ
Ss
zU
zU
zU
zU
zU
zU
xw
GZ
cC
cC
cC
cC
CQ
xw
xw
xw
CQ
Kt
zU
zU
zU
Kt
CQ
"}
(25,1,1) = {"
CQ
Kt
zU
zU
zU
Kt
CQ
xw
xw
xw
xw
xw
xw
CQ
zU
zU
zU
zU
zU
zU
zU
zU
xw
CQ
cC
cC
cC
cC
CQ
xw
xw
xw
CQ
Kt
zU
zU
zU
Kt
CQ
"}
(26,1,1) = {"
CQ
Kt
zU
zU
zU
Kt
CQ
xw
xw
xw
xw
xw
xw
CQ
zU
zU
zU
zU
zU
zU
CQ
CQ
xw
CQ
CQ
CQ
CQ
CQ
CQ
xw
xw
xw
CQ
Kt
zU
zU
zU
Kt
CQ
"}
(27,1,1) = {"
CQ
Kt
zU
zU
zU
Kt
CQ
xw
xw
xw
UD
xw
xw
CQ
zU
zU
zU
zU
zU
zU
CQ
xw
xw
xw
xw
xw
xw
xw
xw
xw
xw
xw
CQ
Kt
zU
zU
zU
Kt
CQ
"}
(28,1,1) = {"
CQ
Kt
zU
zU
zU
zU
TI
xw
xw
xw
xw
xw
xw
TI
zU
zU
zU
zU
zU
zU
CQ
xw
UD
xw
xw
xw
xw
xw
xw
xw
UD
xw
TI
zU
zU
zU
zU
Kt
CQ
"}
(29,1,1) = {"
CQ
Kt
zU
zU
zU
zU
TI
xw
xw
xw
xw
xw
xw
TI
zU
zU
zU
zU
zU
zU
CQ
xw
xw
xw
xw
xw
xw
xw
xw
xw
xw
xw
TI
zU
zU
zU
zU
Kt
CQ
"}
(30,1,1) = {"
CQ
Kt
Kt
Kt
Kt
Kt
CQ
Lr
Lr
Lr
Lr
Lr
Lr
CQ
zU
zU
zU
zU
zU
zU
CQ
Lr
TI
Lr
Lr
Lr
Lr
Lr
Lr
Lr
Lr
Lr
CQ
Kt
Kt
Kt
Kt
Kt
CQ
"}
(31,1,1) = {"
CQ
CQ
CQ
CQ
CQ
CQ
CQ
CQ
CQ
CQ
CQ
CQ
CQ
CQ
CQ
CQ
CQ
CQ
CQ
nd
CQ
CQ
nd
CQ
CQ
CQ
CQ
CQ
CQ
CQ
CQ
CQ
CQ
CQ
CQ
CQ
CQ
CQ
CQ
"}
