//MAP CONVERTED BY dmm2tgm.py THIS HEADER COMMENT PREVENTS RECONVERSION, DO NOT REMOVE
"ab" = (
/turf/template_noop,
/area/template_noop)
"ap" = (
/obj/machinery/door/firedoor,
/obj/machinery/door/airlock/command{
	name = "Bad Doggies Room";
	req_access_txt = "19"
	},
/turf/open/floor/plating,
/area/maintenance/bottom_station_maints/north)
"bo" = (
/obj/effect/spawner/random/structure/crate,
/turf/open/floor/plating,
/area/maintenance/bottom_station_maints)
"bw" = (
/obj/structure/lattice/catwalk,
/turf/open/space/basic,
/area/space/nearstation)
"gf" = (
/obj/structure/closet/crate/solarpanel_small,
/turf/open/floor/plating,
/area/maintenance/bottom_station_maints)
"gj" = (
/obj/effect/spawner/structure/window/reinforced,
/turf/open/floor/plating,
/area/cargo/meeting_room)
"gu" = (
/turf/open/floor/plating,
/area/maintenance/bottom_station_maints/north)
"jH" = (
/obj/structure/lattice,
/obj/structure/grille,
/turf/open/space/basic,
/area/space/nearstation)
"kA" = (
/obj/effect/spawner/random/trash/mess,
/turf/open/floor/plating,
/area/maintenance/bottom_station_maints)
"lr" = (
/obj/effect/spawner/structure/window/reinforced,
/turf/open/floor/plating,
/area/maintenance/bottom_station_maints/north)
"lH" = (
/obj/machinery/door/firedoor/border_only{
	dir = 4
	},
/obj/machinery/door/firedoor/border_only{
	dir = 8
	},
/obj/machinery/door/airlock/external{
	name = "External Access";
	req_access_txt = "13"
	},
/obj/structure/fans/tiny,
/turf/open/floor/plating,
/area/cargo/meeting_room)
"nT" = (
/obj/effect/spawner/random/trash/mess,
/obj/effect/spawner/random/trash/garbage,
/turf/open/floor/plating,
/area/maintenance/bottom_station_maints)
"oH" = (
/obj/structure/closet/emcloset/anchored,
/turf/open/floor/plating,
/area/maintenance/bottom_station_maints)
"oW" = (
/obj/structure/chair{
	dir = 1
	},
/turf/open/floor/plating,
/area/maintenance/bottom_station_maints)
"qx" = (
/obj/effect/spawner/structure/window/reinforced,
/turf/open/floor/plating,
/area/maintenance/bottom_station_maints)
"rg" = (
/obj/effect/turf_decal/tile/neutral{
	dir = 8
	},
/turf/open/floor/plasteel,
/area/hallway/primary/central/low_level_eva)
"sR" = (
/obj/effect/spawner/random/trash/food_packaging,
/turf/open/floor/plating,
/area/maintenance/bottom_station_maints)
"tZ" = (
/obj/effect/spawner/random/trash/garbage,
/turf/open/floor/plating,
/area/maintenance/bottom_station_maints)
"wm" = (
/obj/effect/spawner/random/trash/grille_or_waste,
/turf/open/floor/plating,
/area/maintenance/bottom_station_maints)
"xZ" = (
/obj/machinery/door/airlock/external{
	name = "External Access";
	req_access_txt = "13"
	},
/obj/structure/fans/tiny,
/turf/open/floor/plating,
/area/maintenance/bottom_station_maints)
"zC" = (
/obj/structure/cable,
/turf/open/floor/plasteel,
/area/hallway/primary/central/low_level_eva)
"BO" = (
/turf/closed/wall,
/area/maintenance/bottom_station_maints)
"BR" = (
/turf/open/floor/plating,
/area/maintenance/bottom_station_maints)
"DF" = (
/turf/closed/wall/r_wall,
/area/maintenance/bottom_station_maints)
"HY" = (
/obj/structure/lattice,
/obj/structure/grille/broken,
/turf/open/space/basic,
/area/space/nearstation)
"IV" = (
/obj/effect/spawner/structure/window/reinforced,
/obj/structure/cable,
/turf/open/floor/plating,
/area/hallway/primary/central/low_level_eva)
"LP" = (
/obj/machinery/door/firedoor,
/obj/machinery/door/airlock/command{
	name = "Bad Doggies Room";
	req_access_txt = "19"
	},
/turf/open/floor/plating,
/area/cargo/meeting_room)
"Pc" = (
/turf/closed/wall/r_wall,
/area/cargo/meeting_room)
"Rw" = (
/turf/closed/wall/r_wall,
/area/hallway/primary/central/low_level_eva)
"TL" = (
/obj/structure/table,
/obj/effect/spawner/random/food_or_drink/refreshing_beverage{
	pixel_y = 3
	},
/turf/open/floor/plating,
/area/maintenance/bottom_station_maints)
"UY" = (
/turf/open/floor/plating,
/area/cargo/meeting_room)
"Ws" = (
/turf/closed/wall/r_wall,
/area/maintenance/bottom_station_maints/north)
"WP" = (
/obj/machinery/door/firedoor,
/obj/machinery/door/airlock/maintenance{
	dir = 4;
	req_access_txt = "12"
	},
/turf/open/floor/plating,
/area/maintenance/bottom_station_maints)
"Xh" = (
/obj/structure/table,
/obj/effect/spawner/random/maintenance,
/turf/open/floor/plating,
/area/maintenance/bottom_station_maints)
"YS" = (
/turf/open/space/basic,
/area/space)
"Zl" = (
/obj/structure/lattice,
/turf/open/space/basic,
/area/space/nearstation)
"Zt" = (
/obj/effect/turf_decal/tile/neutral,
/turf/open/floor/plasteel,
/area/hallway/primary/central/low_level_eva)

(1,1,1) = {"
ab
ab
ab
ab
ab
ab
ab
YS
YS
YS
jH
YS
YS
YS
YS
Zl
YS
YS
YS
YS
YS
YS
Zl
YS
YS
YS
YS
Pc
UY
Pc
Zl
YS
YS
ab
ab
ab
"}
(2,1,1) = {"
ab
ab
ab
ab
ab
ab
ab
YS
YS
YS
jH
YS
YS
YS
YS
Zl
YS
YS
YS
YS
YS
YS
Zl
YS
YS
YS
YS
Pc
UY
Pc
Zl
YS
YS
ab
ab
ab
"}
(3,1,1) = {"
ab
ab
ab
ab
ab
ab
ab
YS
YS
YS
jH
YS
YS
YS
YS
Zl
Zl
Zl
Zl
Zl
Zl
Zl
Zl
Zl
Zl
Zl
Zl
lH
UY
lH
Zl
Zl
Zl
ab
ab
ab
"}
(4,1,1) = {"
ab
ab
ab
ab
ab
ab
ab
YS
YS
YS
YS
YS
YS
YS
YS
jH
YS
YS
YS
YS
YS
YS
Zl
YS
YS
Pc
gj
Pc
LP
Pc
gj
Pc
YS
ab
ab
ab
"}
(5,1,1) = {"
ab
ab
ab
ab
ab
ab
ab
YS
YS
YS
YS
YS
YS
YS
YS
jH
YS
YS
YS
YS
YS
YS
Zl
YS
Pc
Pc
UY
UY
UY
UY
UY
Pc
YS
ab
ab
ab
"}
(6,1,1) = {"
ab
ab
ab
ab
ab
ab
ab
YS
YS
YS
YS
YS
YS
YS
YS
jH
YS
YS
YS
YS
YS
YS
Zl
YS
Pc
UY
UY
UY
UY
UY
UY
Pc
YS
ab
ab
ab
"}
(7,1,1) = {"
ab
ab
ab
ab
ab
ab
ab
YS
YS
YS
YS
YS
YS
YS
YS
jH
YS
YS
YS
YS
YS
YS
Zl
YS
Pc
gj
gj
gj
Pc
gj
gj
Pc
YS
ab
ab
ab
"}
(8,1,1) = {"
ab
ab
ab
ab
ab
ab
ab
Zl
jH
Zl
Zl
Zl
Zl
Zl
Zl
jH
YS
YS
YS
YS
YS
YS
Zl
YS
YS
YS
YS
YS
Zl
Zl
Zl
Zl
Zl
ab
ab
ab
"}
(9,1,1) = {"
ab
ab
ab
ab
ab
ab
ab
YS
YS
YS
YS
YS
YS
YS
YS
jH
YS
YS
YS
YS
YS
YS
Zl
YS
YS
YS
YS
YS
Zl
YS
Zl
YS
YS
ab
ab
ab
"}
(10,1,1) = {"
ab
ab
ab
ab
ab
ab
ab
YS
YS
YS
YS
YS
YS
YS
YS
jH
YS
YS
YS
YS
YS
YS
Zl
YS
YS
YS
YS
YS
YS
YS
Zl
YS
YS
ab
ab
ab
"}
(11,1,1) = {"
ab
ab
ab
ab
ab
rg
IV
YS
YS
YS
YS
YS
YS
YS
YS
jH
HY
Zl
YS
HY
jH
jH
jH
jH
jH
jH
jH
jH
jH
jH
Zl
YS
YS
ab
ab
ab
"}
(12,1,1) = {"
ab
ab
ab
ab
ab
zC
IV
YS
YS
YS
YS
YS
YS
YS
YS
jH
YS
YS
YS
YS
YS
YS
Zl
YS
YS
YS
YS
YS
YS
YS
Zl
YS
YS
ab
ab
ab
"}
(13,1,1) = {"
ab
ab
ab
ab
ab
Zt
IV
YS
YS
YS
Zl
YS
YS
YS
YS
jH
YS
YS
YS
YS
YS
YS
Zl
YS
YS
YS
YS
YS
YS
YS
Zl
YS
YS
ab
ab
ab
"}
(14,1,1) = {"
ab
ab
ab
ab
ab
ab
Rw
YS
YS
YS
Zl
YS
YS
YS
YS
jH
YS
YS
YS
YS
YS
YS
Zl
YS
YS
YS
YS
YS
YS
YS
Zl
Zl
Zl
ab
ab
ab
"}
(15,1,1) = {"
ab
ab
ab
ab
ab
ab
Ws
Zl
Zl
Zl
Zl
Zl
Zl
Zl
Zl
Zl
Zl
Zl
Zl
Zl
Zl
Zl
Zl
Zl
Zl
Zl
Zl
Zl
Zl
Zl
Zl
YS
Zl
YS
YS
ab
"}
(16,1,1) = {"
ab
ab
ab
ab
ab
ab
Ws
YS
YS
YS
Zl
YS
YS
YS
YS
Zl
YS
YS
YS
YS
YS
YS
Zl
YS
YS
YS
YS
YS
YS
YS
Zl
YS
Zl
YS
YS
ab
"}
(17,1,1) = {"
ab
ab
ab
ab
ab
ab
Ws
YS
YS
YS
Zl
YS
YS
YS
YS
Zl
YS
YS
YS
YS
YS
YS
Zl
YS
YS
YS
YS
YS
YS
YS
Zl
YS
DF
qx
qx
ab
"}
(18,1,1) = {"
ab
ab
ab
ab
ab
ab
Ws
YS
YS
YS
Zl
YS
YS
Zl
Zl
Zl
Zl
Zl
Zl
Zl
Zl
Zl
Zl
Zl
Zl
YS
YS
Zl
Zl
Zl
Zl
DF
DF
Xh
Xh
ab
"}
(19,1,1) = {"
ab
ab
ab
ab
ab
ab
Ws
YS
YS
YS
Zl
YS
YS
YS
YS
Zl
YS
YS
YS
YS
YS
YS
Zl
YS
YS
YS
YS
YS
YS
YS
Zl
qx
BR
BR
BR
ab
"}
(20,1,1) = {"
ab
ab
ab
ab
ab
ab
Ws
YS
YS
YS
Zl
YS
YS
YS
YS
Zl
YS
YS
YS
YS
YS
YS
Zl
YS
YS
YS
YS
YS
YS
YS
Zl
qx
oW
BR
BR
ab
"}
(21,1,1) = {"
ab
ab
ab
ab
ab
ab
Ws
YS
YS
YS
Zl
YS
YS
YS
YS
Zl
YS
YS
YS
YS
YS
YS
Zl
YS
YS
YS
YS
YS
YS
YS
Zl
qx
TL
BR
BR
ab
"}
(22,1,1) = {"
ab
ab
ab
ab
ab
ab
Ws
YS
YS
YS
Zl
YS
YS
YS
YS
Zl
Zl
Zl
Zl
YS
YS
Zl
Zl
Zl
Zl
Zl
Zl
YS
Zl
Zl
Zl
DF
DF
Xh
Xh
ab
"}
(23,1,1) = {"
ab
ab
ab
ab
ab
ab
Ws
YS
YS
YS
Zl
YS
YS
YS
YS
Zl
YS
YS
YS
YS
YS
YS
Zl
YS
YS
YS
YS
YS
YS
YS
Zl
YS
DF
qx
qx
ab
"}
(24,1,1) = {"
ab
ab
ab
ab
ab
ab
Ws
YS
YS
YS
Zl
YS
YS
YS
YS
Zl
YS
YS
YS
YS
YS
YS
Zl
YS
YS
YS
YS
YS
YS
YS
Zl
YS
Zl
bw
bw
ab
"}
(25,1,1) = {"
ab
ab
ab
ab
ab
ab
Ws
Ws
Ws
Ws
Ws
Zl
Zl
Zl
Zl
Zl
Zl
Zl
Zl
Zl
Zl
Zl
Zl
Zl
Zl
Zl
Zl
Zl
Zl
Zl
Zl
Zl
Zl
bw
bw
ab
"}
(26,1,1) = {"
ab
ab
ab
ab
ab
ab
Ws
gu
gu
gu
Ws
YS
YS
YS
YS
Zl
YS
YS
YS
YS
YS
YS
Zl
YS
YS
YS
YS
YS
YS
YS
Zl
YS
Zl
DF
xZ
ab
"}
(27,1,1) = {"
ab
ab
ab
ab
ab
ab
ap
gu
gu
gu
Ws
YS
YS
YS
YS
Zl
YS
YS
YS
YS
YS
YS
Zl
YS
YS
YS
YS
YS
YS
YS
Zl
YS
DF
DF
BR
ab
"}
(28,1,1) = {"
ab
ab
ab
ab
ab
ab
Ws
Ws
Ws
Ws
Ws
YS
YS
YS
YS
Zl
YS
YS
YS
YS
YS
YS
Zl
YS
YS
YS
YS
YS
YS
YS
Zl
YS
DF
gf
BR
ab
"}
(29,1,1) = {"
ab
ab
ab
ab
ab
ab
Ws
Zl
YS
YS
YS
YS
YS
YS
YS
Zl
YS
YS
YS
YS
YS
YS
Zl
YS
YS
YS
YS
YS
YS
YS
Zl
YS
DF
oH
BR
ab
"}
(30,1,1) = {"
ab
ab
ab
ab
ab
ab
Ws
Zl
YS
YS
YS
YS
YS
YS
YS
Zl
YS
YS
YS
YS
YS
YS
Zl
YS
YS
YS
YS
YS
DF
DF
qx
qx
DF
DF
WP
ab
"}
(31,1,1) = {"
ab
ab
ab
ab
ab
ab
Ws
Zl
YS
YS
YS
YS
YS
YS
YS
Zl
YS
YS
YS
YS
YS
YS
Zl
YS
YS
YS
YS
DF
DF
Xh
tZ
tZ
wm
tZ
BR
ab
"}
(32,1,1) = {"
ab
ab
ab
ab
ab
ab
Ws
jH
jH
jH
jH
jH
jH
jH
Zl
Zl
Zl
Zl
Zl
Zl
Zl
Zl
Zl
Zl
Zl
Zl
Zl
DF
Xh
sR
BR
BR
wm
BR
BR
ab
"}
(33,1,1) = {"
ab
ab
ab
ab
ab
ab
Ws
lr
lr
lr
lr
lr
lr
lr
Ws
Zl
YS
YS
YS
YS
YS
YS
Zl
YS
YS
YS
YS
qx
BR
BR
BR
BR
BR
BR
BR
ab
"}
(34,1,1) = {"
ab
ab
ab
ab
ab
ab
ab
ab
ab
ab
ab
ab
ab
ab
Ws
Zl
YS
YS
YS
YS
YS
YS
Zl
YS
YS
YS
YS
qx
kA
BR
tZ
BR
wm
wm
wm
ab
"}
(35,1,1) = {"
ab
ab
ab
ab
ab
ab
ab
ab
ab
ab
ab
ab
ab
ab
Ws
Zl
YS
YS
YS
YS
YS
YS
Zl
YS
YS
YS
YS
qx
sR
BR
BR
BR
wm
tZ
tZ
ab
"}
(36,1,1) = {"
ab
ab
ab
ab
ab
ab
ab
ab
ab
ab
ab
ab
ab
ab
Ws
Zl
YS
YS
YS
YS
YS
YS
Zl
YS
YS
YS
YS
DF
Xh
nT
wm
BR
wm
tZ
bo
ab
"}
(37,1,1) = {"
ab
ab
ab
ab
ab
ab
ab
ab
ab
ab
ab
ab
ab
ab
Ws
Ws
Ws
Ws
Ws
lr
lr
lr
Ws
lr
lr
lr
Ws
DF
BO
BO
BO
WP
BO
BO
BO
ab
"}
