"aa" = (/turf/template_noop,/area/space)
"ab" = (/turf/open/floor/plating,/area/space)
"ac" = (/obj/structure/lattice,/turf/template_noop,/area/space)
"ad" = (/turf/closed/wall,/area/space)
"ae" = (/obj/structure/window/reinforced/spawner/north,/obj/structure/shuttle/engine/heater,/turf/open/floor/plating,/area/space)
"af" = (/obj/structure/shuttle/engine/propulsion,/turf/open/floor/plating,/area/space)
"ag" = (/turf/open/floor/plasteel,/area/space)
"ah" = (/turf/closed/wall/r_wall,/area/space)
"ai" = (/obj/effect/spawner/structure/window/reinforced,/turf/open/floor/plating,/area/space)
"aj" = (/obj/effect/spawner/structure/window/plasma/reinforced,/turf/open/floor/plating/airless,/area/space)
"ak" = (/turf/open/floor/engine,/area/space)
"al" = (/obj/machinery/air_sensor/atmos/mix_tank,/turf/open/floor/engine/vacuum,/area/space)
"am" = (/obj/machinery/atmospherics/components/unary/vent_pump/siphon/atmos/mix_output,/turf/open/floor/engine/vacuum,/area/space)
"an" = (/obj/machinery/atmospherics/components/unary/outlet_injector/on/layer3/atmos/mix_input,/turf/open/floor/engine/vacuum,/area/space)
"ao" = (/obj/machinery/atmospherics/pipe/simple/green/visible/layer3{icon_state = "pipe11-3"; dir = 4},/obj/machinery/atmospherics/components/binary/pump{icon_state = "pump_map-2"; dir = 8},/turf/open/floor/plasteel,/area/space)
"ap" = (/obj/machinery/air_sensor/atmos/nitrous_tank,/turf/open/floor/engine/n2o,/area/space)
"aq" = (/obj/machinery/atmospherics/components/trinary/filter/on/layer3/atmos/n2o{icon_state = "filter_on_map-3"; dir = 1},/obj/machinery/atmospherics/pipe/simple/yellow/visible{icon_state = "pipe11-2"; dir = 8},/turf/open/floor/plasteel,/area/space)
"ar" = (/obj/machinery/portable_atmospherics/canister/nitrous_oxide,/obj/machinery/atmospherics/components/unary/vent_pump/siphon/atmos/nitrous_output,/turf/open/floor/engine/n2o,/area/space)
"as" = (/obj/machinery/atmospherics/components/unary/outlet_injector/on/layer3/atmos/nitrous_input,/turf/open/floor/engine/n2o,/area/space)
"at" = (/obj/machinery/air_sensor/atmos/carbon_tank,/turf/open/floor/engine/co2,/area/space)
"au" = (/obj/effect/spawner/structure/window/plasma/reinforced,/obj/machinery/atmospherics/pipe/simple/green/visible/layer3{icon_state = "pipe11-3"; dir = 4},/obj/machinery/atmospherics/pipe/simple/yellow/visible{icon_state = "pipe11-2"; dir = 8},/turf/open/floor/plating/airless,/area/space)
"av" = (/obj/machinery/portable_atmospherics/canister/carbon_dioxide,/obj/machinery/atmospherics/components/unary/vent_pump/siphon/atmos/carbon_output,/turf/open/floor/engine/co2,/area/space)
"aw" = (/obj/machinery/atmospherics/components/unary/outlet_injector/on/layer3/atmos/carbon_input,/turf/open/floor/engine/co2,/area/space)
"ax" = (/obj/machinery/air_sensor/atmos/oxygen_tank,/obj/machinery/atmospherics/pipe/simple/green/visible/layer3{icon_state = "pipe11-3"; dir = 4},/obj/machinery/atmospherics/pipe/simple/yellow/visible{icon_state = "pipe11-2"; dir = 8},/turf/open/floor/engine/o2,/area/space)
"ay" = (/obj/machinery/portable_atmospherics/canister/oxygen,/obj/machinery/atmospherics/components/unary/vent_pump/siphon/atmos/oxygen_output,/obj/machinery/atmospherics/pipe/simple/green/visible/layer3{icon_state = "pipe11-3"; dir = 4},/obj/machinery/atmospherics/pipe/simple/yellow/visible{icon_state = "pipe11-2"; dir = 8},/turf/open/floor/engine/o2,/area/space)
"az" = (/obj/machinery/atmospherics/components/unary/outlet_injector/on/layer3/atmos/oxygen_input,/obj/machinery/atmospherics/pipe/simple/green/visible/layer3{icon_state = "pipe11-3"; dir = 4},/obj/machinery/atmospherics/pipe/simple/yellow/visible{icon_state = "pipe11-2"; dir = 8},/turf/open/floor/engine/o2,/area/space)
"aA" = (/obj/machinery/air_sensor/atmos/nitrogen_tank,/turf/open/floor/engine/n2,/area/space)
"aB" = (/obj/machinery/portable_atmospherics/canister/nitrogen,/obj/machinery/atmospherics/components/unary/vent_pump/siphon/atmos/nitrogen_output,/turf/open/floor/engine/n2,/area/space)
"aC" = (/obj/machinery/atmospherics/components/unary/outlet_injector/on/layer3/atmos/nitrogen_input,/turf/open/floor/engine/n2,/area/space)
"aD" = (/obj/machinery/air_sensor/atmos/toxin_tank,/obj/machinery/atmospherics/pipe/simple/green/visible/layer3{icon_state = "pipe11-3"; dir = 4},/obj/machinery/atmospherics/pipe/simple/yellow/visible{icon_state = "pipe11-2"; dir = 8},/turf/open/floor/engine/plasma,/area/space)
"aE" = (/obj/machinery/portable_atmospherics/canister/toxins,/obj/machinery/atmospherics/components/unary/vent_pump/siphon/atmos/toxin_output,/obj/machinery/atmospherics/pipe/simple/green/visible/layer3{icon_state = "pipe11-3"; dir = 4},/obj/machinery/atmospherics/pipe/simple/yellow/visible{icon_state = "pipe11-2"; dir = 8},/turf/open/floor/engine/plasma,/area/space)
"aF" = (/obj/machinery/atmospherics/components/unary/outlet_injector/on/layer3/atmos/toxin_input,/obj/machinery/atmospherics/pipe/simple/green/visible/layer3{icon_state = "pipe11-3"; dir = 4},/obj/machinery/atmospherics/pipe/simple/yellow/visible{icon_state = "pipe11-2"; dir = 8},/turf/open/floor/engine/plasma,/area/space)
"aG" = (/obj/machinery/atmospherics/pipe/layer_manifold/visible,/turf/closed/wall,/area/space)
"aH" = (/obj/machinery/atmospherics/pipe/simple/general/visible/layer1,/obj/machinery/atmospherics/pipe/simple/general/visible/layer3{icon_state = "pipe11-3"; dir = 5},/obj/machinery/atmospherics/components/unary/outlet_injector/on{dir = 1; icon_state = "inje_map-2"; volume_rate = 200},/turf/open/floor/engine,/area/space)
"aI" = (/obj/machinery/atmospherics/components/unary/outlet_injector/on/layer3{dir = 8; icon_state = "inje_map-3"; volume_rate = 200},/obj/machinery/atmospherics/pipe/heat_exchanging/junction,/turf/open/floor/engine,/area/space)
"aJ" = (/obj/machinery/atmospherics/components/unary/vent_scrubber/layer3{icon_state = "scrub_map-3"; dir = 4},/obj/machinery/atmospherics/pipe/heat_exchanging/simple,/turf/open/floor/engine,/area/space)
"aK" = (/obj/machinery/atmospherics/components/unary/outlet_injector/on/layer1{dir = 1; icon_state = "inje_map-1"; volume_rate = 200},/turf/open/floor/engine,/area/space)
"aL" = (/obj/machinery/atmospherics/pipe/layer_manifold/visible{icon_state = "manifoldlayer"; dir = 8},/turf/closed/wall,/area/space)
"aM" = (/obj/machinery/atmospherics/components/unary/outlet_injector/on{dir = 8; icon_state = "inje_map-2"; volume_rate = 200},/turf/open/floor/engine,/area/space)
"aN" = (/obj/machinery/atmospherics/pipe/simple/green/visible/layer3{icon_state = "pipe11-3"; dir = 9},/turf/closed/wall/r_wall,/area/space)
"aO" = (/obj/machinery/atmospherics/components/trinary/filter/on/layer3/atmos/co2{icon_state = "filter_on_map-3"; dir = 1},/obj/machinery/atmospherics/pipe/simple/yellow/visible{icon_state = "pipe11-2"; dir = 8},/turf/open/floor/plasteel,/area/space)
"aP" = (/obj/machinery/atmospherics/components/trinary/filter/on/layer3/atmos/o2{icon_state = "filter_on_map-3"; dir = 1},/obj/machinery/atmospherics/pipe/simple/yellow/visible{icon_state = "pipe11-2"; dir = 8},/turf/open/floor/plasteel,/area/space)
"aQ" = (/obj/machinery/air_sensor/atmos/air_tank,/turf/open/floor/engine/air,/area/space)
"aR" = (/obj/machinery/portable_atmospherics/canister/air,/obj/machinery/atmospherics/components/unary/vent_pump/siphon/atmos/mix_output,/turf/open/floor/engine/air,/area/space)
"aS" = (/obj/machinery/atmospherics/components/unary/outlet_injector/on/layer3/atmos/air_input,/turf/open/floor/engine/air,/area/space)
"aT" = (/obj/machinery/atmospherics/components/trinary/filter/on/layer3/atmos/n2{icon_state = "filter_on_map-3"; dir = 1},/obj/machinery/atmospherics/pipe/simple/yellow/visible{icon_state = "pipe11-2"; dir = 8},/turf/open/floor/plasteel,/area/space)
"aU" = (/obj/structure/lattice,/obj/machinery/atmospherics/pipe/simple/scrubbers/visible,/turf/template_noop,/area/space)
"aV" = (/obj/machinery/atmospherics/pipe/simple/cyan/visible/layer3{icon_state = "pipe11-3"; dir = 9},/turf/closed/wall/r_wall,/area/space)
"aW" = (/obj/structure/window/reinforced/spawner/east,/turf/open/floor/plasteel,/area/space)
"aX" = (/obj/structure/lattice,/obj/machinery/atmospherics/pipe/simple/cyan/visible/layer3{icon_state = "pipe11-3"; dir = 4},/obj/machinery/atmospherics/pipe/simple/cyan/visible{dir = 4},/turf/template_noop,/area/space)
"aY" = (/obj/machinery/atmospherics/pipe/simple/cyan/visible/layer3{icon_state = "pipe11-3"; dir = 4},/obj/machinery/atmospherics/pipe/simple/cyan/visible{dir = 4},/turf/closed/wall/r_wall,/area/space)
"aZ" = (/obj/machinery/atmospherics/pipe/simple/cyan/visible/layer3{icon_state = "pipe11-3"; dir = 4},/obj/machinery/atmospherics/pipe/simple/cyan/visible{dir = 9},/turf/closed/wall/r_wall,/area/space)
"ba" = (/obj/machinery/atmospherics/pipe/simple/scrubbers/visible/layer3,/turf/closed/wall,/area/space)
"bb" = (/obj/machinery/atmospherics/components/trinary/filter/on/layer3/atmos/plasma{icon_state = "filter_on_map-3"; dir = 1},/obj/machinery/atmospherics/pipe/simple/yellow/visible{icon_state = "pipe11-2"; dir = 8},/turf/open/floor/plasteel,/area/space)
"bc" = (/obj/machinery/atmospherics/pipe/simple/green/visible/layer3{icon_state = "pipe11-3"; dir = 4},/obj/machinery/atmospherics/pipe/simple/yellow/visible{icon_state = "pipe11-2"; dir = 8},/obj/structure/window/reinforced/spawner/east,/obj/machinery/computer/atmos_control/tank/mix_tank{dir = 8},/turf/open/floor/plasteel,/area/space)
"bd" = (/obj/structure/lattice,/obj/machinery/atmospherics/pipe/simple/green/visible/layer3{icon_state = "pipe11-3"; dir = 4},/obj/machinery/atmospherics/pipe/simple/yellow/visible{icon_state = "pipe11-2"; dir = 8},/turf/template_noop,/area/space)
"be" = (/obj/machinery/atmospherics/pipe/simple/green/visible/layer3{icon_state = "pipe11-3"; dir = 4},/obj/machinery/atmospherics/pipe/simple/yellow/visible{icon_state = "pipe11-2"; dir = 8},/turf/closed/wall/r_wall,/area/space)
"bf" = (/obj/machinery/atmospherics/pipe/simple/green/visible/layer3{icon_state = "pipe11-3"; dir = 4},/obj/machinery/atmospherics/pipe/simple/yellow/visible{icon_state = "pipe11-2"; dir = 9},/turf/closed/wall/r_wall,/area/space)
"bg" = (/obj/machinery/atmospherics/pipe/simple/scrubbers/visible,/obj/structure/lattice,/turf/template_noop,/area/space)
"bh" = (/obj/structure/lattice,/obj/machinery/atmospherics/pipe/simple/supply/visible,/turf/template_noop,/area/space)
"bi" = (/obj/machinery/atmospherics/pipe/simple/scrubbers/visible/layer3{icon_state = "pipe11-3"; dir = 6},/turf/closed/wall,/area/space)
"bj" = (/obj/machinery/atmospherics/pipe/simple/scrubbers/visible/layer3{icon_state = "pipe11-3"; dir = 8},/turf/closed/wall,/area/space)
"bk" = (/obj/machinery/atmospherics/pipe/simple/scrubbers/visible/layer3{icon_state = "pipe11-3"; dir = 8},/turf/open/floor/plating,/area/space)
"bl" = (/obj/machinery/atmospherics/pipe/simple/scrubbers/visible/layer3{icon_state = "pipe11-3"; dir = 9},/turf/closed/wall,/area/space)
"bm" = (/obj/machinery/atmospherics/pipe/simple/general/visible,/turf/closed/wall,/area/space)
"bn" = (/obj/machinery/atmospherics/pipe/layer_manifold/visible{icon_state = "manifoldlayer"; dir = 8},/turf/open/floor/plasteel,/area/space)
"bo" = (/obj/machinery/atmospherics/pipe/simple/scrubbers/visible/layer3{icon_state = "pipe11-3"; dir = 5},/turf/closed/wall/r_wall,/area/space)
"bp" = (/obj/machinery/atmospherics/pipe/simple/cyan/visible/layer3{icon_state = "pipe11-3"; dir = 5},/turf/open/floor/plasteel,/area/space)
"bq" = (/obj/machinery/atmospherics/pipe/simple/scrubbers/visible/layer3{icon_state = "pipe11-3"; dir = 5},/turf/open/floor/plating,/area/space)
"br" = (/obj/machinery/atmospherics/pipe/simple/scrubbers/visible/layer3{icon_state = "pipe11-3"; dir = 8},/turf/open/floor/plasteel,/area/space)
"bs" = (/obj/machinery/atmospherics/pipe/simple/cyan/visible/layer3{icon_state = "pipe11-3"; dir = 8},/obj/machinery/atmospherics/pipe/simple/scrubbers/visible/layer3,/turf/open/floor/plasteel,/area/space)
"bt" = (/obj/machinery/atmospherics/pipe/simple/scrubbers/visible/layer3{icon_state = "pipe11-3"; dir = 9},/turf/closed/wall/r_wall,/area/space)
"bu" = (/obj/machinery/atmospherics/components/binary/pump/layer3{icon_state = "pump_map-3"; dir = 4},/obj/machinery/atmospherics/components/binary/pump{icon_state = "pump_map-2"; dir = 8},/turf/open/floor/plasteel,/area/space)
"bv" = (/obj/machinery/atmospherics/pipe/simple/green/visible/layer3{icon_state = "pipe11-3"; dir = 4},/obj/machinery/atmospherics/pipe/simple/yellow/visible{icon_state = "pipe11-2"; dir = 8},/obj/structure/window/reinforced/spawner/east,/obj/machinery/computer/atmos_control/tank/toxin_tank{dir = 8},/turf/open/floor/plasteel,/area/space)
"bw" = (/obj/machinery/atmospherics/pipe/simple/scrubbers/visible/layer3{icon_state = "pipe11-3"; dir = 10},/turf/closed/wall/r_wall,/area/space)
"bx" = (/obj/machinery/atmospherics/pipe/simple/general/visible{dir = 4},/turf/closed/wall,/area/space)
"by" = (/obj/machinery/atmospherics/pipe/simple/cyan/visible/layer3{icon_state = "pipe11-3"; dir = 4},/obj/machinery/atmospherics/pipe/simple/cyan/visible{dir = 4},/obj/structure/window/reinforced/spawner/east,/obj/machinery/computer/atmos_control/tank/air_tank{icon_state = "computer"; dir = 8},/turf/open/floor/plasteel,/area/space)
"bz" = (/obj/machinery/atmospherics/pipe/simple/green/visible/layer3{icon_state = "pipe11-3"; dir = 4},/obj/machinery/atmospherics/pipe/simple/yellow/visible{icon_state = "pipe11-2"; dir = 8},/obj/structure/window/reinforced/spawner/east,/obj/machinery/computer/atmos_control/tank/oxygen_tank{icon_state = "computer"; dir = 8},/turf/open/floor/plasteel,/area/space)
"bA" = (/obj/machinery/atmospherics/pipe/simple/green/visible/layer3{icon_state = "pipe11-3"; dir = 4},/obj/machinery/atmospherics/pipe/simple/yellow/visible{icon_state = "pipe11-2"; dir = 8},/obj/structure/window/reinforced/spawner/east,/obj/machinery/computer/atmos_control/tank/nitrogen_tank{icon_state = "computer"; dir = 8},/turf/open/floor/plasteel,/area/space)
"bB" = (/obj/machinery/atmospherics/pipe/simple/green/visible/layer3{icon_state = "pipe11-3"; dir = 4},/obj/machinery/atmospherics/pipe/simple/yellow/visible{icon_state = "pipe11-2"; dir = 8},/obj/structure/window/reinforced/spawner/east,/obj/machinery/computer/atmos_control/tank/carbon_tank{dir = 8},/turf/open/floor/plasteel,/area/space)
"bC" = (/obj/machinery/atmospherics/pipe/simple/green/visible/layer3{icon_state = "pipe11-3"; dir = 4},/obj/machinery/atmospherics/pipe/simple/yellow/visible{icon_state = "pipe11-2"; dir = 8},/obj/structure/window/reinforced/spawner/east,/obj/machinery/computer/atmos_control/tank/nitrous_tank{dir = 8},/turf/open/floor/plasteel,/area/space)
"bD" = (/obj/machinery/atmospherics/pipe/simple/cyan/visible/layer3{icon_state = "pipe11-3"; dir = 8},/turf/closed/wall/r_wall,/area/space)
"bE" = (/obj/machinery/atmospherics/pipe/manifold/yellow/visible{icon_state = "manifold-2"; dir = 8},/turf/open/floor/plasteel,/area/space)
"bF" = (/obj/machinery/atmospherics/pipe/simple/cyan/visible/layer3{icon_state = "pipe11-3"; dir = 6},/obj/machinery/atmospherics/components/trinary/mixer{icon_state = "mixer_off"; dir = 1},/turf/open/floor/plasteel,/area/space)
"bG" = (/obj/machinery/atmospherics/components/trinary/mixer/flipped/layer3{icon_state = "mixer_off_f_map-3"; dir = 1},/obj/machinery/atmospherics/pipe/manifold/yellow/visible{icon_state = "manifold-2"; dir = 8},/turf/open/floor/plasteel,/area/space)
"bH" = (/obj/machinery/atmospherics/pipe/simple/cyan/visible/layer3,/obj/machinery/atmospherics/pipe/simple/yellow/visible{icon_state = "pipe11-2"; dir = 5},/turf/open/floor/plasteel,/area/space)
"bI" = (/obj/machinery/atmospherics/pipe/manifold/green/visible/layer3{icon_state = "manifold-3"; dir = 1},/turf/open/floor/plasteel,/area/space)

(1,1,1) = {"
aaaaaaaaaabgaabhaaaaaaaaaaaaaaaaaaaaaa
aaaaaaaaaaaUadadadadadaiaiaiaiaiadaaaa
aaaaaaaaaaaGadagagagadagagagagagadadaa
aaaaaaadabbaagagagagagagagagagagagadaa
aaaabibjbkblagagagadadadadadadadagadaa
aaaabaadabadagagadadacacacacacadadadaa
aaaabaagagagagagaWacacahahahacacacacaa
aabiblagagagagagaWacajalamanahacacacaa
aabaagagagagbIaobcbdbdbebfaNacacacacaa
aabaagagagagagagaWacajaparasajahahacaa
aabaagagbEbnaqaobCbdbdbebfaNatavawahaa
aabaagagbEbnaOaobBbdauaxayazaubfaNacaa
aabaagagbFbnaPaobzbdbdbebfaNaAaBaCahaa
aabaagagbGbnaTaobAbdauaDaEaFaubfaNacaa
aabaagagbHbnbbaobvbdbdbebfaNaQaRaSahaa
aabobwagbpbDbsbubyaXaXaXaXaXaYaZaVacaa
aaahbqbrbrbkbtahahahahahahacacacacacaa
aaahababababababababababahahahahahahaa
aaahababadaGbmabababababababababababaa
aaahababadaHaIadabababadadababahahahaa
aaahababadaKaJaLababbxaMakbxabababahaa
aaahahababadadadabababadadabababahahaa
aaaaahahabababababababababababahahaaaa
aaaaaaahahahahaeaeaeaeaeahahahahaaaaaa
aaaaaaaaaaahahafafafafafahahaaaaaaaaaa
"}
