"aa" = (/obj/structure/window/reinforced/spawner/north,/obj/structure/window/reinforced/spawner,/turf/open/floor/plasteel,/area/space)
"ab" = (/turf/template_noop,/area/space)
"ac" = (/obj/structure/lattice,/turf/template_noop,/area/space)
"ad" = (/obj/machinery/door/airlock/atmos{name = "Atmospherics"; req_access_txt = "24"},/obj/machinery/door/firedoor/heavy,/obj/structure/window/reinforced/spawner/west,/obj/structure/window/reinforced/spawner/east,/turf/open/floor/plasteel,/area/space)
"ae" = (/obj/machinery/atmospherics/pipe/simple/scrubbers/visible,/obj/structure/lattice,/turf/template_noop,/area/space)
"af" = (/obj/structure/lattice,/obj/machinery/atmospherics/pipe/simple/supply/visible,/turf/template_noop,/area/space)
"ag" = (/obj/machinery/atmospherics/pipe/simple/yellow/visible{icon_state = "pipe11-2"; dir = 8},/obj/structure/lattice,/turf/template_noop,/area/space)
"ah" = (/obj/structure/window/reinforced/spawner/west,/obj/structure/window/reinforced/spawner/east,/turf/open/floor/plasteel,/area/space)
"ai" = (/obj/structure/lattice,/obj/machinery/atmospherics/pipe/simple/scrubbers/visible,/turf/template_noop,/area/space)
"aj" = (/turf/closed/wall,/area/space)
"ak" = (/obj/machinery/atmospherics/pipe/simple/supply/visible,/turf/closed/wall,/area/space)
"al" = (/obj/effect/spawner/structure/window/reinforced,/turf/open/floor/plating,/area/space)
"am" = (/obj/structure/window/reinforced/spawner/west,/obj/structure/window/reinforced/spawner,/turf/open/floor/plasteel,/area/space)
"an" = (/obj/structure/window/reinforced/spawner/north,/obj/structure/window/reinforced/spawner/east,/turf/open/floor/plasteel,/area/space)
"ao" = (/obj/machinery/atmospherics/pipe/layer_manifold/visible,/turf/closed/wall,/area/space)
"ap" = (/obj/machinery/atmospherics/components/binary/pump{icon_state = "pump_map-2"; dir = 8},/turf/closed/wall,/area/space)
"aq" = (/turf/open/floor/plasteel,/area/space)
"ar" = (/obj/machinery/door/airlock/external{name = "Atmospherics External Airlock"; req_access_txt = "24"},/obj/effect/mapping_helpers/airlock/cyclelink_helper,/turf/open/floor/plating,/area/space)
"as" = (/obj/machinery/atmospherics/pipe/simple/brown/visible,/obj/effect/spawner/structure/window/reinforced,/turf/open/floor/plating,/area/space)
"at" = (/obj/machinery/atmospherics/pipe/simple/scrubbers/visible,/turf/closed/wall,/area/space)
"au" = (/obj/machinery/atmospherics/pipe/simple/scrubbers/visible{dir = 6},/turf/closed/wall,/area/space)
"av" = (/obj/machinery/atmospherics/pipe/simple/scrubbers/visible{dir = 4},/turf/open/floor/plating,/area/space)
"aw" = (/obj/machinery/atmospherics/pipe/simple/scrubbers/visible{dir = 9},/turf/closed/wall,/area/space)
"ax" = (/obj/machinery/door/airlock/external{name = "Atmospherics External Airlock"; req_access_txt = "24"},/obj/effect/mapping_helpers/airlock/cyclelink_helper{dir = 1},/turf/open/floor/plating,/area/space)
"ay" = (/obj/machinery/atmospherics/components/binary/pump/on{dir = 8},/turf/open/floor/plasteel,/area/space)
"az" = (/turf/closed/wall/r_wall,/area/space)
"aA" = (/obj/machinery/atmospherics/pipe/simple/brown/visible,/turf/closed/wall,/area/space)
"aB" = (/obj/effect/spawner/structure/window/plasma/reinforced,/turf/open/floor/plating/airless,/area/space)
"aC" = (/obj/machinery/air_sensor/atmos/mix_tank,/turf/open/floor/engine/vacuum,/area/space)
"aD" = (/obj/machinery/atmospherics/components/unary/vent_pump/siphon/atmos/mix_output,/turf/open/floor/engine/vacuum,/area/space)
"aE" = (/obj/machinery/atmospherics/components/unary/outlet_injector/on/layer3/atmos/mix_input,/turf/open/floor/engine/vacuum,/area/space)
"aF" = (/obj/machinery/atmospherics/pipe/manifold/green/visible/layer3{icon_state = "manifold-3"; dir = 1},/obj/machinery/atmospherics/pipe/simple/yellow/visible{icon_state = "pipe11-2"; dir = 5},/turf/open/floor/plasteel,/area/space)
"aG" = (/obj/machinery/atmospherics/pipe/simple/green/visible/layer3{icon_state = "pipe11-3"; dir = 4},/obj/machinery/atmospherics/components/binary/pump{icon_state = "pump_map-2"; dir = 8},/turf/open/floor/plasteel,/area/space)
"aH" = (/obj/machinery/atmospherics/pipe/simple/yellow/visible{icon_state = "pipe11-2"; dir = 8},/obj/machinery/atmospherics/pipe/simple/cyan/visible,/turf/open/floor/plasteel,/area/space)
"aI" = (/obj/structure/lattice,/obj/machinery/atmospherics/pipe/simple/green/visible/layer3{icon_state = "pipe11-3"; dir = 4},/obj/machinery/atmospherics/pipe/simple/yellow/visible{icon_state = "pipe11-2"; dir = 8},/turf/template_noop,/area/space)
"aJ" = (/obj/machinery/atmospherics/pipe/simple/green/visible/layer3{icon_state = "pipe11-3"; dir = 4},/obj/machinery/atmospherics/pipe/simple/yellow/visible{icon_state = "pipe11-2"; dir = 8},/turf/closed/wall/r_wall,/area/space)
"aK" = (/obj/machinery/atmospherics/pipe/simple/green/visible/layer3{icon_state = "pipe11-3"; dir = 4},/obj/machinery/atmospherics/pipe/simple/yellow/visible{icon_state = "pipe11-2"; dir = 9},/turf/closed/wall/r_wall,/area/space)
"aL" = (/obj/machinery/atmospherics/pipe/simple/green/visible/layer3{icon_state = "pipe11-3"; dir = 9},/turf/closed/wall/r_wall,/area/space)
"aM" = (/obj/machinery/atmospherics/pipe/simple/green/visible/layer3,/turf/open/floor/plasteel,/area/space)
"aN" = (/obj/machinery/atmospherics/components/binary/pump{dir = 1; icon_state = "pump_map-2"},/obj/machinery/atmospherics/pipe/simple/scrubbers/visible{dir = 4},/turf/open/floor/plasteel,/area/space)
"aO" = (/obj/machinery/air_sensor/atmos/nitrous_tank,/turf/open/floor/engine/n2o,/area/space)
"aP" = (/obj/machinery/portable_atmospherics/canister/nitrous_oxide,/obj/machinery/atmospherics/components/unary/vent_pump/siphon/atmos/nitrous_output,/turf/open/floor/engine/n2o,/area/space)
"aQ" = (/obj/machinery/atmospherics/components/unary/outlet_injector/on/layer3/atmos/nitrous_input,/turf/open/floor/engine/n2o,/area/space)
"aR" = (/obj/machinery/atmospherics/pipe/manifold/yellow/visible{icon_state = "manifold-2"; dir = 8},/turf/open/floor/plasteel,/area/space)
"aS" = (/obj/machinery/atmospherics/pipe/layer_manifold/visible{icon_state = "manifoldlayer"; dir = 8},/turf/open/floor/plasteel,/area/space)
"aT" = (/obj/machinery/atmospherics/components/trinary/filter/on/layer3/atmos/n2o{icon_state = "filter_on_map-3"; dir = 1},/obj/machinery/atmospherics/pipe/simple/yellow/visible{icon_state = "pipe11-2"; dir = 8},/turf/open/floor/plasteel,/area/space)
"aU" = (/obj/machinery/atmospherics/pipe/simple/cyan/visible,/turf/closed/wall,/area/space)
"aV" = (/obj/machinery/air_sensor/atmos/carbon_tank,/turf/open/floor/engine/co2,/area/space)
"aW" = (/obj/machinery/portable_atmospherics/canister/carbon_dioxide,/obj/machinery/atmospherics/components/unary/vent_pump/siphon/atmos/carbon_output,/turf/open/floor/engine/co2,/area/space)
"aX" = (/obj/machinery/atmospherics/components/unary/outlet_injector/on/layer3/atmos/carbon_input,/turf/open/floor/engine/co2,/area/space)
"aY" = (/obj/machinery/atmospherics/components/trinary/filter/on/layer3/atmos/co2{icon_state = "filter_on_map-3"; dir = 1},/obj/machinery/atmospherics/pipe/simple/yellow/visible{icon_state = "pipe11-2"; dir = 8},/turf/open/floor/plasteel,/area/space)
"aZ" = (/obj/structure/window/reinforced/spawner/east,/obj/machinery/atmospherics/pipe/simple/cyan/visible,/turf/open/floor/plasteel,/area/space)
"ba" = (/obj/effect/spawner/structure/window/plasma/reinforced,/obj/machinery/atmospherics/pipe/simple/green/visible/layer3{icon_state = "pipe11-3"; dir = 4},/obj/machinery/atmospherics/pipe/simple/yellow/visible{icon_state = "pipe11-2"; dir = 8},/turf/open/floor/plating/airless,/area/space)
"bb" = (/obj/machinery/air_sensor/atmos/oxygen_tank,/obj/machinery/atmospherics/pipe/simple/green/visible/layer3{icon_state = "pipe11-3"; dir = 4},/obj/machinery/atmospherics/pipe/simple/yellow/visible{icon_state = "pipe11-2"; dir = 8},/turf/open/floor/engine/o2,/area/space)
"bc" = (/obj/machinery/portable_atmospherics/canister/oxygen,/obj/machinery/atmospherics/components/unary/vent_pump/siphon/atmos/oxygen_output,/obj/machinery/atmospherics/pipe/simple/green/visible/layer3{icon_state = "pipe11-3"; dir = 4},/obj/machinery/atmospherics/pipe/simple/yellow/visible{icon_state = "pipe11-2"; dir = 8},/turf/open/floor/engine/o2,/area/space)
"bd" = (/obj/machinery/atmospherics/components/unary/outlet_injector/on/layer3/atmos/oxygen_input,/obj/machinery/atmospherics/pipe/simple/green/visible/layer3{icon_state = "pipe11-3"; dir = 4},/obj/machinery/atmospherics/pipe/simple/yellow/visible{icon_state = "pipe11-2"; dir = 8},/turf/open/floor/engine/o2,/area/space)
"be" = (/obj/machinery/atmospherics/pipe/simple/cyan/visible/layer3{icon_state = "pipe11-3"; dir = 6},/obj/machinery/atmospherics/components/trinary/mixer{icon_state = "mixer_off"; dir = 1},/turf/open/floor/plasteel,/area/space)
"bf" = (/obj/machinery/atmospherics/components/trinary/filter/on/layer3/atmos/o2{icon_state = "filter_on_map-3"; dir = 1},/obj/machinery/atmospherics/pipe/simple/yellow/visible{icon_state = "pipe11-2"; dir = 8},/turf/open/floor/plasteel,/area/space)
"bg" = (/obj/machinery/atmospherics/pipe/simple/green/visible/layer3{icon_state = "pipe11-3"; dir = 4},/obj/machinery/atmospherics/pipe/simple/yellow/visible{icon_state = "pipe11-2"; dir = 8},/obj/structure/window/reinforced/spawner/east,/obj/machinery/computer/atmos_control/tank/mix_tank{dir = 8},/obj/machinery/atmospherics/pipe/simple/cyan/visible,/turf/open/floor/plasteel,/area/space)
"bh" = (/obj/machinery/air_sensor/atmos/nitrogen_tank,/turf/open/floor/engine/n2,/area/space)
"bi" = (/obj/machinery/portable_atmospherics/canister/nitrogen,/obj/machinery/atmospherics/components/unary/vent_pump/siphon/atmos/nitrogen_output,/turf/open/floor/engine/n2,/area/space)
"bj" = (/obj/machinery/atmospherics/components/unary/outlet_injector/on/layer3/atmos/nitrogen_input,/turf/open/floor/engine/n2,/area/space)
"bk" = (/obj/machinery/atmospherics/components/trinary/mixer/flipped/layer3{icon_state = "mixer_off_f_map-3"; dir = 1},/obj/machinery/atmospherics/pipe/manifold/yellow/visible{icon_state = "manifold-2"; dir = 8},/turf/open/floor/plasteel,/area/space)
"bl" = (/obj/machinery/atmospherics/components/trinary/filter/on/layer3/atmos/n2{icon_state = "filter_on_map-3"; dir = 1},/obj/machinery/atmospherics/pipe/simple/yellow/visible{icon_state = "pipe11-2"; dir = 8},/turf/open/floor/plasteel,/area/space)
"bm" = (/obj/structure/window/reinforced/spawner/east,/obj/structure/table,/obj/item/twohanded/binoculars,/obj/machinery/atmospherics/pipe/simple/cyan/visible,/turf/open/floor/plasteel,/area/space)
"bn" = (/obj/machinery/air_sensor/atmos/toxin_tank,/obj/machinery/atmospherics/pipe/simple/green/visible/layer3{icon_state = "pipe11-3"; dir = 4},/obj/machinery/atmospherics/pipe/simple/yellow/visible{icon_state = "pipe11-2"; dir = 8},/turf/open/floor/engine/plasma,/area/space)
"bo" = (/obj/machinery/portable_atmospherics/canister/toxins,/obj/machinery/atmospherics/components/unary/vent_pump/siphon/atmos/toxin_output,/obj/machinery/atmospherics/pipe/simple/green/visible/layer3{icon_state = "pipe11-3"; dir = 4},/obj/machinery/atmospherics/pipe/simple/yellow/visible{icon_state = "pipe11-2"; dir = 8},/turf/open/floor/engine/plasma,/area/space)
"bp" = (/obj/machinery/atmospherics/components/unary/outlet_injector/on/layer3/atmos/toxin_input,/obj/machinery/atmospherics/pipe/simple/green/visible/layer3{icon_state = "pipe11-3"; dir = 4},/obj/machinery/atmospherics/pipe/simple/yellow/visible{icon_state = "pipe11-2"; dir = 8},/turf/open/floor/engine/plasma,/area/space)
"bq" = (/obj/machinery/atmospherics/pipe/simple/cyan/visible/layer3,/obj/machinery/atmospherics/pipe/simple/yellow/visible{icon_state = "pipe11-2"; dir = 5},/turf/open/floor/plasteel,/area/space)
"br" = (/obj/machinery/atmospherics/components/trinary/filter/on/layer3/atmos/plasma{icon_state = "filter_on_map-3"; dir = 1},/obj/machinery/atmospherics/pipe/simple/yellow/visible{icon_state = "pipe11-2"; dir = 8},/turf/open/floor/plasteel,/area/space)
"bs" = (/obj/machinery/atmospherics/pipe/simple/green/visible/layer3{icon_state = "pipe11-3"; dir = 4},/obj/machinery/atmospherics/pipe/simple/yellow/visible{icon_state = "pipe11-2"; dir = 8},/obj/structure/window/reinforced/spawner/east,/obj/machinery/computer/atmos_control/tank/nitrous_tank{dir = 8},/obj/machinery/atmospherics/pipe/simple/cyan/visible,/turf/open/floor/plasteel,/area/space)
"bt" = (/obj/machinery/air_sensor/atmos/air_tank,/turf/open/floor/engine/air,/area/space)
"bu" = (/obj/machinery/portable_atmospherics/canister/air,/obj/machinery/atmospherics/components/unary/vent_pump/siphon/atmos/mix_output,/turf/open/floor/engine/air,/area/space)
"bv" = (/obj/machinery/atmospherics/components/unary/outlet_injector/on/layer3/atmos/air_input,/turf/open/floor/engine/air,/area/space)
"bw" = (/obj/machinery/atmospherics/pipe/simple/yellow/visible,/turf/open/floor/plasteel,/area/space)
"bx" = (/obj/machinery/atmospherics/pipe/manifold/yellow/visible{dir = 4},/turf/open/floor/plasteel,/area/space)
"by" = (/obj/machinery/door/airlock/atmos{name = "Atmospherics"; req_access_txt = "24"},/turf/open/floor/plasteel,/area/space)
"bz" = (/obj/machinery/atmospherics/pipe/simple/cyan/visible/layer3{icon_state = "pipe11-3"; dir = 5},/obj/machinery/door/airlock/atmos{name = "Atmospherics"; req_access_txt = "24"},/turf/open/floor/plasteel,/area/space)
"bA" = (/obj/machinery/atmospherics/pipe/simple/cyan/visible/layer3{icon_state = "pipe11-3"; dir = 8},/turf/closed/wall/r_wall,/area/space)
"bB" = (/obj/machinery/atmospherics/pipe/simple/green/visible/layer3{icon_state = "pipe11-3"; dir = 4},/obj/machinery/atmospherics/pipe/simple/yellow/visible{icon_state = "pipe11-2"; dir = 8},/obj/structure/window/reinforced/spawner/east,/obj/machinery/computer/atmos_control/tank/carbon_tank{dir = 8},/obj/machinery/atmospherics/pipe/simple/cyan/visible,/turf/open/floor/plasteel,/area/space)
"bC" = (/obj/machinery/atmospherics/components/binary/pump/layer3{icon_state = "pump_map-3"; dir = 4},/obj/machinery/atmospherics/components/binary/pump/on{dir = 8},/turf/open/floor/plasteel,/area/space)
"bD" = (/obj/machinery/atmospherics/pipe/simple/cyan/visible/layer3{icon_state = "pipe11-3"; dir = 4},/obj/machinery/atmospherics/pipe/simple/cyan/visible{dir = 4},/obj/structure/window/reinforced/spawner/east,/obj/machinery/computer/atmos_control/tank/air_tank{icon_state = "computer"; dir = 8},/turf/open/floor/plasteel,/area/space)
"bE" = (/obj/structure/lattice,/obj/machinery/atmospherics/pipe/simple/cyan/visible/layer3{icon_state = "pipe11-3"; dir = 4},/obj/machinery/atmospherics/pipe/simple/cyan/visible{dir = 4},/turf/template_noop,/area/space)
"bF" = (/obj/machinery/atmospherics/pipe/simple/cyan/visible/layer3{icon_state = "pipe11-3"; dir = 4},/obj/machinery/atmospherics/pipe/simple/cyan/visible{dir = 4},/turf/closed/wall/r_wall,/area/space)
"bG" = (/obj/machinery/atmospherics/pipe/simple/cyan/visible/layer3{icon_state = "pipe11-3"; dir = 4},/obj/machinery/atmospherics/pipe/simple/cyan/visible{dir = 9},/turf/closed/wall/r_wall,/area/space)
"bH" = (/obj/machinery/atmospherics/pipe/simple/cyan/visible/layer3{icon_state = "pipe11-3"; dir = 9},/turf/closed/wall/r_wall,/area/space)
"bI" = (/obj/machinery/atmospherics/pipe/simple/yellow/visible,/turf/closed/wall,/area/space)
"bJ" = (/obj/machinery/atmospherics/pipe/simple/yellow/visible{dir = 10},/turf/open/floor/plasteel,/area/space)
"bK" = (/obj/machinery/atmospherics/pipe/simple/green/visible/layer3{icon_state = "pipe11-3"; dir = 4},/obj/machinery/atmospherics/pipe/simple/yellow/visible{icon_state = "pipe11-2"; dir = 8},/obj/structure/window/reinforced/spawner/east,/obj/machinery/computer/atmos_control/tank/oxygen_tank{icon_state = "computer"; dir = 8},/obj/machinery/atmospherics/pipe/simple/cyan/visible,/turf/open/floor/plasteel,/area/space)
"bL" = (/turf/open/floor/plating,/area/space)
"bM" = (/obj/machinery/atmospherics/pipe/simple/general/visible,/turf/closed/wall,/area/space)
"bN" = (/obj/effect/mapping_helpers/airlock/cyclelink_helper{dir = 4},/obj/machinery/door/airlock/external{name = "Atmospherics External Airlock"; req_access_txt = "24"},/turf/open/floor/plating,/area/space)
"bO" = (/obj/structure/lattice/catwalk,/obj/machinery/atmospherics/pipe/simple/brown/visible,/turf/template_noop,/area/space)
"bP" = (/obj/machinery/atmospherics/pipe/simple/general/visible/layer1,/obj/machinery/atmospherics/pipe/simple/general/visible/layer3{icon_state = "pipe11-3"; dir = 5},/obj/machinery/atmospherics/components/unary/outlet_injector/on{dir = 1; icon_state = "inje_map-2"; volume_rate = 200},/turf/open/floor/engine,/area/space)
"bQ" = (/obj/machinery/atmospherics/components/unary/outlet_injector/on/layer3{dir = 8; icon_state = "inje_map-3"; volume_rate = 200},/obj/machinery/atmospherics/pipe/heat_exchanging/junction,/turf/open/floor/engine,/area/space)
"bR" = (/obj/machinery/atmospherics/components/unary/outlet_injector/on/layer1{dir = 1; icon_state = "inje_map-1"; volume_rate = 200},/turf/open/floor/engine,/area/space)
"bS" = (/obj/machinery/atmospherics/components/unary/vent_scrubber/layer3{icon_state = "scrub_map-3"; dir = 4},/obj/machinery/atmospherics/pipe/heat_exchanging/simple,/turf/open/floor/engine,/area/space)
"bT" = (/obj/machinery/atmospherics/pipe/layer_manifold/visible{icon_state = "manifoldlayer"; dir = 8},/turf/closed/wall,/area/space)
"bU" = (/obj/machinery/atmospherics/pipe/simple/general/visible{dir = 4},/turf/closed/wall,/area/space)
"bV" = (/obj/machinery/atmospherics/components/unary/outlet_injector/on{dir = 8; icon_state = "inje_map-2"; volume_rate = 200},/turf/open/floor/engine,/area/space)
"bW" = (/turf/open/floor/engine,/area/space)
"bX" = (/obj/structure/window/reinforced/spawner/north,/obj/structure/shuttle/engine/heater,/turf/open/floor/plating,/area/space)
"bY" = (/obj/structure/shuttle/engine/propulsion,/turf/open/floor/plating,/area/space)
"bZ" = (/obj/machinery/atmospherics/pipe/simple/cyan/visible,/obj/machinery/atmospherics/pipe/simple/scrubbers/visible{dir = 4},/turf/open/floor/plasteel,/area/space)
"ca" = (/obj/structure/lattice,/obj/machinery/atmospherics/pipe/simple/brown/visible,/turf/template_noop,/area/space)
"cb" = (/obj/machinery/atmospherics/components/binary/pump{dir = 1; icon_state = "pump_map-2"},/turf/closed/wall,/area/space)
"cc" = (/obj/machinery/atmospherics/pipe/simple/yellow/visible{icon_state = "pipe11-2"; dir = 8},/turf/open/floor/plasteel,/area/space)
"cd" = (/obj/machinery/atmospherics/pipe/simple/yellow/visible{icon_state = "pipe11-2"; dir = 8},/turf/closed/wall,/area/space)
"ce" = (/obj/machinery/atmospherics/pipe/manifold/yellow/visible{dir = 4},/turf/closed/wall,/area/space)
"cf" = (/obj/machinery/atmospherics/components/binary/pump{dir = 2; icon_state = "pump_map-2"},/turf/closed/wall,/area/space)
"cg" = (/obj/structure/lattice,/obj/machinery/atmospherics/pipe/simple/yellow/visible{dir = 6},/turf/template_noop,/area/space)
"ch" = (/obj/machinery/atmospherics/pipe/simple/yellow/visible{icon_state = "pipe11-2"; dir = 5},/turf/open/floor/plasteel,/area/space)
"ci" = (/obj/machinery/atmospherics/pipe/simple/yellow/visible{dir = 6},/turf/open/floor/plasteel,/area/space)
"cj" = (/obj/machinery/atmospherics/pipe/simple/yellow/visible{dir = 9},/turf/open/floor/plasteel,/area/space)
"ck" = (/obj/machinery/atmospherics/pipe/simple/brown/visible,/turf/closed/wall/r_wall,/area/space)
"cl" = (/obj/effect/mapping_helpers/airlock/cyclelink_helper{dir = 8},/obj/machinery/door/airlock/external{name = "Atmospherics External Airlock"; req_access_txt = "24"},/obj/machinery/atmospherics/pipe/simple/brown/visible,/turf/open/floor/plating,/area/space)
"cm" = (/obj/machinery/atmospherics/pipe/simple/brown/visible{icon_state = "pipe11-2"; dir = 6},/turf/closed/wall/r_wall,/area/space)
"cn" = (/obj/machinery/atmospherics/pipe/simple/brown/visible{icon_state = "pipe11-2"; dir = 9},/turf/closed/wall/r_wall,/area/space)
"co" = (/obj/machinery/atmospherics/pipe/simple/brown/visible{icon_state = "pipe11-2"; dir = 1},/turf/closed/wall/r_wall,/area/space)
"cp" = (/obj/structure/lattice,/obj/machinery/atmospherics/pipe/simple/brown/visible{icon_state = "pipe11-2"; dir = 1},/turf/template_noop,/area/space)
"cq" = (/obj/machinery/atmospherics/components/binary/pump{dir = 4; layer = 2.4},/turf/open/floor/plasteel,/area/space)
"cr" = (/obj/structure/table,/turf/open/floor/plasteel,/area/space)
"cs" = (/obj/structure/lattice,/obj/machinery/atmospherics/pipe/simple/yellow/visible,/turf/template_noop,/area/space)
"ct" = (/obj/machinery/atmospherics/pipe/manifold4w/supply,/turf/open/floor/plasteel,/area/space)
"cu" = (/obj/machinery/atmospherics/pipe/manifold/scrubbers/visible{dir = 8},/turf/closed/wall,/area/space)
"cv" = (/obj/machinery/atmospherics/pipe/simple/scrubbers/visible,/obj/structure/window/reinforced/spawner/north,/obj/machinery/portable_atmospherics/scrubber,/turf/open/floor/plasteel,/area/space)
"cw" = (/obj/machinery/atmospherics/pipe/simple/scrubbers/visible,/turf/closed/wall/r_wall,/area/space)
"cx" = (/obj/structure/lattice,/obj/structure/lattice/catwalk,/obj/machinery/atmospherics/components/unary/outlet_injector/atmos/atmos_waste{dir = 1},/turf/template_noop,/area/space)
"cy" = (/obj/machinery/atmospherics/pipe/simple/scrubbers/visible{dir = 4},/turf/open/floor/plasteel,/area/space)
"cz" = (/obj/machinery/atmospherics/pipe/simple/cyan/visible{dir = 10},/turf/open/floor/plasteel,/area/space)
"cA" = (/obj/structure/lattice,/obj/machinery/atmospherics/pipe/simple/scrubbers/visible{dir = 6},/turf/template_noop,/area/space)
"cB" = (/obj/effect/spawner/structure/window/reinforced,/obj/machinery/atmospherics/pipe/simple/scrubbers/visible{dir = 4},/turf/open/floor/plating,/area/space)
"cC" = (/obj/machinery/atmospherics/pipe/simple/scrubbers/visible{dir = 9},/turf/open/floor/plating,/area/space)
"cD" = (/obj/machinery/atmospherics/pipe/layer_manifold/visible{icon_state = "manifoldlayer"; dir = 8},/turf/open/floor/plating,/area/space)
"cE" = (/obj/machinery/atmospherics/pipe/manifold/scrubbers/visible{dir = 8},/turf/open/floor/plating,/area/space)
"cF" = (/obj/machinery/atmospherics/components/binary/valve/digital,/turf/open/floor/plating,/area/space)
"cG" = (/obj/machinery/atmospherics/pipe/simple/green/visible/layer3{icon_state = "pipe11-3"; dir = 4},/obj/machinery/atmospherics/pipe/simple/yellow/visible{icon_state = "pipe11-2"; dir = 8},/obj/structure/window/reinforced/spawner/east,/obj/machinery/computer/atmos_control/tank/nitrogen_tank{icon_state = "computer"; dir = 8},/obj/machinery/atmospherics/pipe/simple/cyan/visible,/turf/open/floor/plasteel,/area/space)
"cH" = (/obj/machinery/atmospherics/pipe/simple/green/visible/layer3{icon_state = "pipe11-3"; dir = 4},/obj/machinery/atmospherics/pipe/simple/yellow/visible{icon_state = "pipe11-2"; dir = 8},/obj/structure/window/reinforced/spawner/east,/obj/machinery/computer/atmos_control/tank/toxin_tank{dir = 8},/obj/machinery/atmospherics/pipe/simple/cyan/visible,/turf/open/floor/plasteel,/area/space)
"cI" = (/obj/machinery/atmospherics/pipe/simple/cyan/visible/layer3{icon_state = "pipe11-3"; dir = 8},/obj/machinery/atmospherics/pipe/simple/scrubbers/visible/layer3,/obj/machinery/atmospherics/pipe/simple/cyan/visible{dir = 6},/turf/open/floor/plasteel,/area/space)
"cJ" = (/obj/machinery/atmospherics/pipe/simple/scrubbers/visible/layer3{icon_state = "pipe11-3"; dir = 9},/obj/machinery/atmospherics/pipe/simple/cyan/visible{icon_state = "pipe11-2"; dir = 5},/turf/closed/wall/r_wall,/area/space)
"cK" = (/obj/machinery/atmospherics/pipe/simple/cyan/visible{icon_state = "pipe11-2"; dir = 8},/turf/closed/wall/r_wall,/area/space)
"cL" = (/obj/machinery/atmospherics/pipe/manifold/cyan/visible,/turf/closed/wall,/area/space)
"cM" = (/obj/machinery/atmospherics/pipe/simple/cyan/visible{dir = 6},/turf/open/floor/plasteel,/area/space)
"cN" = (/obj/machinery/atmospherics/components/binary/pump/on,/turf/closed/wall,/area/space)
"cO" = (/obj/machinery/atmospherics/components/binary/pump/on{dir = 4},/turf/open/floor/plasteel,/area/space)
"cP" = (/obj/machinery/atmospherics/pipe/simple/cyan/visible{dir = 4},/turf/closed/wall,/area/space)
"cQ" = (/obj/machinery/atmospherics/pipe/manifold/cyan/visible{dir = 4},/turf/closed/wall/r_wall,/area/space)
"cR" = (/obj/machinery/atmospherics/pipe/manifold/cyan/visible{dir = 4},/obj/structure/window/reinforced/spawner/east,/turf/open/floor/plasteel,/area/space)
"cS" = (/obj/machinery/atmospherics/pipe/simple/yellow/visible,/obj/machinery/door/airlock/atmos{name = "Atmospherics"; req_access_txt = "24"},/turf/open/floor/plasteel,/area/space)
"cT" = (/obj/machinery/atmospherics/pipe/simple/cyan/visible{dir = 9},/turf/closed/wall,/area/space)
"cU" = (/obj/machinery/atmospherics/pipe/manifold/scrubbers/visible{dir = 8},/obj/machinery/portable_atmospherics/scrubber,/turf/open/floor/plasteel,/area/space)
"cV" = (/obj/machinery/atmospherics/components/unary/vent_scrubber/on{dir = 8},/turf/open/floor/plasteel,/area/space)
"cW" = (/obj/machinery/atmospherics/components/unary/vent_pump/on,/turf/open/floor/plasteel,/area/space)
"cX" = (/obj/machinery/atmospherics/components/unary/vent_pump/on{dir = 4},/turf/open/floor/plasteel,/area/space)
"cY" = (/obj/machinery/atmospherics/components/unary/vent_scrubber/on{dir = 8},/turf/open/floor/plating,/area/space)
"cZ" = (/obj/machinery/atmospherics/components/unary/vent_pump/on{dir = 1},/turf/open/floor/plating,/area/space)
"da" = (/obj/structure/lattice,/turf/closed/wall,/area/space)
"db" = (/obj/effect/mapping_helpers/airlock/cyclelink_helper{dir = 8},/obj/machinery/door/airlock/external{name = "Atmospherics External Airlock"; req_access_txt = "24"},/obj/machinery/atmospherics/pipe/simple/scrubbers/visible,/turf/open/floor/plating,/area/space)
"dc" = (/obj/machinery/atmospherics/pipe/simple/yellow/visible{dir = 6},/turf/closed/wall,/area/space)
"dd" = (/obj/machinery/atmospherics/pipe/simple/scrubbers/visible,/obj/machinery/suit_storage_unit/atmos,/turf/open/floor/plasteel,/area/space)
"de" = (/obj/machinery/atmospherics/pipe/simple/scrubbers/visible,/obj/machinery/portable_atmospherics/pump,/turf/open/floor/plasteel,/area/space)
"df" = (/obj/machinery/atmospherics/pipe/simple/scrubbers/visible,/obj/structure/closet/secure_closet/atmospherics,/turf/open/floor/plasteel,/area/space)
"dg" = (/obj/structure/fireaxecabinet{pixel_x = -32},/obj/machinery/atmospherics/pipe/simple/scrubbers/visible,/obj/machinery/portable_atmospherics/pump,/turf/open/floor/plasteel,/area/space)

(1,1,1) = {"
acacadacabaeabafababababababababaccgag
acacahacacaiajakajajajalalalalalajcsac
acacamaaancuapctayczajaqaqaqaqaqajbIac
acacacacahcucyaNcybZcycycVcWaqaqaqcbac
acacacajarcNaqaRcqaHcdccccaHccccccceac
acacacauavawcicjcMcLcPcPcPcTajajcrcfab
acdaauawaxajcSbyaUajacacacacacajajaAab
aabNbLdbcicqbxaqaZacacazazazacacacbOab
acajatdccjaqbwcXcRacaBaCaDaEazacacbOab
abdaddaRcqaSaFaGbgaIaIaJaKaLacacacbOab
abajdfchbJaqaMaqbmacaBaOaPaQaBazazbOab
abaldfaqaRaSaTaGbsaIaIaJaKaLaVaWaXckab
abalcvaqaRaSaYaGbBaIbabbbcbdbaaKaLbOab
abalcUcVbeaSbfaGbKaIaIaJaKaLbhbibjckab
abaldeaqbkaSblaGcGaIbabnbobpbaaKaLbOab
abajdgaqbqaSbraGcHaIaIaJaKaLbtbubvckab
abazcwbybzbAcIbCbDbEbEbEbEbEbFbGbHbOab
abazcEcOcycDcJcKcQazazazazacacacacbOab
abalcEcYbLbLbLbLcZbLbLbLazazazazazckab
abalcFbLbLbLbLbLbLbLbLbLbLbLbLbNbLclab
cAcBcCbLajaobMbLbLbLbLbLbLbLbLazazckab
aiazbLbLajbPbQajbLbLbLajajbLbLbLbLasab
cxazbLbLajbRbSbTbLbLbUbVbWbUbLbLbLasab
acazazbLbLajajajbLbLbLajajbLbLbLcmcnab
acacazazbLbLbLbLbLbLbLbLbLbLbLcmcnabab
acacacazazazazbXbXbXbXbXazazazcoacacac
acacacacacazazbYbYbYbYbYazazabcpababab
acacacacacacacababababababababcaababab
"}
