//MAP CONVERTED BY dmm2tgm.py THIS HEADER COMMENT PREVENTS RECONVERSION, DO NOT REMOVE
"a" = (
/obj/structure/lattice,
/turf/template_noop,
/area/template_noop)
"b" = (
/obj/docking_port/stationary/diy/big,
/obj/docking_port/mobile/diy/big,
/turf/open/floor/plating,
/area/shuttle/diy)
"e" = (
/obj/machinery/computer/camera_advanced/shuttle_docker/adv/diy,
/turf/open/floor/plating,
/area/shuttle/diy)
"f" = (
/obj/machinery/computer/shuttle/diy,
/turf/open/floor/plating,
/area/shuttle/diy)
"g" = (
/turf/open/floor/plating,
/area/shuttle/diy)
"h" = (
/turf/template_noop,
/area/shuttle/diy)
"i" = (
/obj/structure/shuttle/engine/propulsion/burst,
/turf/closed/wall,
/area/shuttle/diy)
"j" = (
/obj/structure/lattice,
/turf/template_noop,
/area/shuttle/diy)

(1,1,1) = {"
a
a
a
a
a
a
a
a
a
a
a
a
a
a
a
a
a
a
a
a
a
a
"}
(2,1,1) = {"
a
h
h
h
h
h
h
h
h
h
h
h
j
h
h
h
h
h
h
h
h
a
"}
(3,1,1) = {"
a
h
h
h
h
h
h
h
h
h
h
h
j
h
h
h
h
h
i
h
h
a
"}
(4,1,1) = {"
a
h
h
h
h
h
h
h
h
h
h
h
j
h
h
h
h
h
g
i
h
a
"}
(5,1,1) = {"
a
h
h
h
h
h
h
h
h
h
h
h
j
h
h
h
h
h
g
g
i
a
"}
(6,1,1) = {"
a
h
h
h
h
h
h
h
h
h
h
h
j
h
h
h
h
h
g
h
h
a
"}
(7,1,1) = {"
a
h
h
h
h
h
h
h
h
h
h
h
e
g
h
h
h
h
g
h
h
a
"}
(8,1,1) = {"
a
b
g
g
g
g
g
g
g
g
g
g
g
g
g
g
g
g
g
h
h
a
"}
(9,1,1) = {"
a
h
h
h
h
h
h
h
h
h
h
h
f
g
h
h
h
h
g
h
h
a
"}
(10,1,1) = {"
a
h
h
h
h
h
h
h
h
h
h
h
j
h
h
h
h
h
g
h
h
a
"}
(11,1,1) = {"
a
h
h
h
h
h
h
h
h
h
h
h
j
h
h
h
h
h
g
g
i
a
"}
(12,1,1) = {"
a
h
h
h
h
h
h
h
h
h
h
h
j
h
h
h
h
h
g
i
h
a
"}
(13,1,1) = {"
a
h
h
h
h
h
h
h
h
h
h
h
j
h
h
h
h
h
i
h
h
a
"}
(14,1,1) = {"
a
h
h
h
h
h
h
h
h
h
h
h
j
h
h
h
h
h
h
h
h
a
"}
(15,1,1) = {"
a
a
a
a
a
a
a
a
a
a
a
a
a
a
a
a
a
a
a
a
a
a
"}
