//MAP CONVERTED BY dmm2tgm.py THIS HEADER COMMENT PREVENTS RECONVERSION, DO NOT REMOVE
"a" = (
/turf/open/floor/plasteel/tile/monofloor/alt2,
/area/ruin/unpowered)
"e" = (
/obj/structure/cataclysmdda/arcade,
/turf/open/floor/plasteel/tile/monofloor/alt2,
/area/ruin/unpowered)
"o" = (
/obj/structure/mineral_door/wood,
/turf/open/floor/plasteel/tile/monofloor/alt2,
/area/ruin/unpowered)
"p" = (
/obj/effect/abstract/doorway_marker,
/turf/open/floor/plasteel/tile/monofloor/alt2,
/area/ruin/unpowered)
"x" = (
/obj/effect/abstract/open_area_marker{
	dir = 8
	},
/obj/effect/turf_decal/cataclysmdda/asphaltpaint,
/turf/open/floor/asphalt,
/area/ruin/unpowered)
"A" = (
/turf/open/floor/asphalt,
/area/ruin/unpowered)
"F" = (
/obj/structure/rack/cataclysmdda/metal/alt,
/turf/open/floor/plasteel/tile/monofloor/alt2,
/area/ruin/unpowered)
"G" = (
/obj/effect/abstract/doorway_marker{
	dir = 1
	},
/turf/open/floor/plasteel/tile/monofloor/alt2,
/area/ruin/unpowered)
"K" = (
/obj/structure/cataclysmdda/bassboost,
/turf/open/floor/plasteel/tile/monofloor/alt2,
/area/ruin/unpowered)
"N" = (
/obj/structure/curtain/cataclysmdda,
/turf/open/floor/plasteel/tile/monofloor/alt2,
/area/ruin/unpowered)
"Q" = (
/obj/effect/turf_decal/cataclysmdda/asphaltpaint,
/turf/open/floor/asphalt,
/area/ruin/unpowered)
"S" = (
/obj/effect/abstract/open_area_marker{
	dir = 4
	},
/obj/effect/turf_decal/cataclysmdda/asphaltpaint,
/turf/open/floor/asphalt,
/area/ruin/unpowered)
"U" = (
/turf/closed/wall/cataclysmdda,
/area/ruin/unpowered)

(1,1,1) = {"
U
U
U
U
U
a
A
x
A
a
"}
(2,1,1) = {"
U
a
a
a
U
a
A
Q
A
a
"}
(3,1,1) = {"
G
a
F
a
o
a
A
Q
A
p
"}
(4,1,1) = {"
U
a
F
a
U
a
A
Q
A
a
"}
(5,1,1) = {"
U
a
F
a
U
a
A
Q
A
a
"}
(6,1,1) = {"
U
a
F
a
U
a
A
Q
A
a
"}
(7,1,1) = {"
U
a
F
a
U
a
A
Q
A
a
"}
(8,1,1) = {"
G
a
a
a
N
a
A
Q
A
p
"}
(9,1,1) = {"
U
K
a
e
U
a
A
Q
A
a
"}
(10,1,1) = {"
U
U
U
U
U
a
A
S
A
a
"}
