//MAP CONVERTED BY dmm2tgm.py THIS HEADER COMMENT PREVENTS RECONVERSION, DO NOT REMOVE
"a" = (
/turf/open/floor/plasteel/tile/monofloor/alt2,
/area/ruin/unpowered)
"e" = (
/obj/effect/turf_decal/cataclysmdda/asphaltpaint,
/turf/open/floor/asphalt,
/area/ruin/unpowered)
"g" = (
/obj/effect/abstract/doorway_marker{
	dir = 4
	},
/turf/open/floor/plasteel/tile/monofloor/alt2,
/area/ruin/unpowered)
"h" = (
/turf/open/floor/asphalt,
/area/ruin/unpowered)
"r" = (
/obj/effect/abstract/open_area_marker,
/obj/effect/turf_decal/cataclysmdda/asphaltpaint,
/turf/open/floor/asphalt,
/area/ruin/unpowered)
"w" = (
/obj/effect/abstract/open_area_marker{
	dir = 1
	},
/obj/effect/turf_decal/cataclysmdda/asphaltpaint,
/turf/open/floor/asphalt,
/area/ruin/unpowered)
"P" = (
/obj/effect/abstract/doorway_marker{
	dir = 8
	},
/turf/open/floor/plasteel/tile/monofloor/alt2,
/area/ruin/unpowered)

(1,1,1) = {"
a
a
P
a
a
"}
(2,1,1) = {"
h
h
h
h
h
"}
(3,1,1) = {"
w
e
e
e
r
"}
(4,1,1) = {"
h
h
h
h
h
"}
(5,1,1) = {"
a
a
g
a
a
"}
