//MAP CONVERTED BY dmm2tgm.py THIS HEADER COMMENT PREVENTS RECONVERSION, DO NOT REMOVE
"a" = (
/obj/structure/rospilovo/tree,
/turf/open/floor/grass/rospilovo,
/area/awaymission/rainy)
"b" = (
/obj/structure/rospilovo/tree,
/obj/effect/random_mob_placer/xen/zombie,
/turf/open/floor/grass/rospilovo,
/area/awaymission/rainy)
"c" = (
/turf/open/floor/plating/is12/wood,
/area/awaymission/rainy)
"d" = (
/turf/closed/indestructible/black,
/area/awaymission/rainy)
"e" = (
/obj/effect/turf_decal/weather/side{
	dir = 8
	},
/turf/open/floor/grass/gensgrass/dirty,
/area/awaymission/rainy)
"f" = (
/obj/effect/turf_decal/weather/side/corner{
	dir = 1
	},
/turf/open/floor/grass/gensgrass/dirty,
/area/awaymission/rainy)
"g" = (
/obj/structure/bed/double,
/turf/open/floor/plating/is12/wood,
/area/awaymission/rainy)
"h" = (
/obj/effect/random_mob_placer/xen/zombie,
/turf/open/floor/grass/gensgrass/dirty,
/area/awaymission/rainy)
"i" = (
/obj/structure/rospilovo/tree{
	icon_state = "derevo2"
	},
/turf/open/floor/grass/rospilovo,
/area/awaymission/rainy)
"j" = (
/obj/structure/rospilovo/tree{
	icon_state = "derevo5"
	},
/obj/effect/random_mob_placer/xen/zombie,
/turf/open/floor/grass/rospilovo,
/area/awaymission/rainy)
"k" = (
/obj/structure/grille/rospilovo/wood{
	icon_state = "zabor_povorot_up"
	},
/turf/open/floor/grass/gensgrass/dirty,
/area/awaymission/rainy)
"l" = (
/obj/structure/rospilovo/krest,
/turf/open/floor/grass/gensgrass/dirty,
/area/awaymission/rainy)
"m" = (
/obj/structure/chair/sofa/left,
/turf/open/floor/plating/is12/wood,
/area/awaymission/rainy)
"n" = (
/obj/structure/grille/rospilovo/wood{
	icon_state = "zabor_horizontal"
	},
/turf/open/floor/grass/gensgrass/dirty,
/area/awaymission/rainy)
"p" = (
/obj/structure/grille/rospilovo/wood,
/turf/open/floor/grass/gensgrass/dirty,
/area/awaymission/rainy)
"q" = (
/turf/open/floor/grass/gensgrass/dirty,
/area/awaymission/rainy)
"r" = (
/obj/structure/chair/sofa,
/turf/open/floor/plating/is12/wood,
/area/awaymission/rainy)
"s" = (
/obj/structure/rospilovo/tree{
	icon_state = "derevo3"
	},
/turf/open/floor/grass/rospilovo,
/area/awaymission/rainy)
"t" = (
/turf/open/floor/grass/rospilovo,
/area/awaymission/rainy)
"u" = (
/obj/effect/random_mob_placer/xen/zombie,
/turf/open/floor/plating/is12/wood,
/area/awaymission/rainy)
"x" = (
/obj/structure/table/rospilovo,
/obj/structure/rospilovo/televizor/broken,
/turf/open/floor/plating/is12/wood,
/area/awaymission/rainy)
"y" = (
/turf/closed/wall/mineral/wood/nonmetal,
/area/awaymission/rainy)
"z" = (
/obj/structure/grille/rospilovo/wood{
	icon_state = "zabor_povorot_upr"
	},
/turf/open/floor/grass/gensgrass/dirty,
/area/awaymission/rainy)
"B" = (
/obj/structure/rospilovo/tree{
	icon_state = "derevo2"
	},
/obj/effect/random_mob_placer/xen/zombie,
/turf/open/floor/grass/rospilovo,
/area/awaymission/rainy)
"C" = (
/obj/effect/turf_decal/weather/side{
	dir = 4
	},
/turf/open/floor/grass/gensgrass/dirty,
/area/awaymission/rainy)
"D" = (
/obj/structure/table/rospilovo,
/turf/open/floor/plating/is12/wood,
/area/awaymission/rainy)
"E" = (
/obj/structure/rospilovo/tree{
	icon_state = "derevo4"
	},
/obj/effect/random_mob_placer/xen/zombie,
/turf/open/floor/grass/rospilovo,
/area/awaymission/rainy)
"F" = (
/obj/effect/random_mob_placer/hev_zombie,
/turf/open/floor/grass/rospilovo,
/area/awaymission/rainy)
"G" = (
/obj/structure/chair/sofa/right,
/turf/open/floor/plating/is12/wood,
/area/awaymission/rainy)
"H" = (
/obj/machinery/gateway/away/required_key,
/turf/open/floor/plating/is12/wood,
/area/awaymission/rainy)
"I" = (
/obj/structure/rospilovo/tree{
	icon_state = "derevo4"
	},
/turf/open/floor/grass/rospilovo,
/area/awaymission/rainy)
"J" = (
/obj/item/flashlight,
/turf/open/floor/grass/gensgrass/dirty,
/area/awaymission/rainy)
"K" = (
/obj/effect/turf_decal/weather/side/corner,
/turf/open/floor/grass/gensgrass/dirty,
/area/awaymission/rainy)
"L" = (
/obj/item/gun/ballistic/shotgun/fallout/huntingshot,
/turf/open/floor/grass/gensgrass/dirty,
/area/awaymission/rainy)
"M" = (
/obj/effect/turf_decal/weather/side,
/turf/open/floor/grass/gensgrass/dirty,
/area/awaymission/rainy)
"N" = (
/obj/effect/random_mob_placer/xen/zombie,
/turf/open/floor/grass/rospilovo,
/area/awaymission/rainy)
"O" = (
/obj/structure/table/rospilovo,
/obj/item/flashlight/lantern,
/turf/open/floor/plating/is12/wood,
/area/awaymission/rainy)
"Q" = (
/obj/item/key/gateway,
/turf/open/floor/grass/rospilovo,
/area/awaymission/rainy)
"R" = (
/obj/structure/bonfire/prelit,
/turf/open/floor/grass/gensgrass/dirty,
/area/awaymission/rainy)
"S" = (
/obj/structure/mineral_door/wood,
/turf/open/floor/plating/is12/wood,
/area/awaymission/rainy)
"T" = (
/obj/structure/table/rospilovo,
/obj/item/storage/belt/shotgun/bullet,
/turf/open/floor/plating/is12/wood,
/area/awaymission/rainy)
"U" = (
/obj/structure/rospilovo/krest/bereza,
/turf/open/floor/grass/gensgrass/dirty,
/area/awaymission/rainy)
"V" = (
/obj/effect/landmark/awaystart,
/turf/open/floor/grass/gensgrass/dirty,
/area/awaymission/rainy)
"X" = (
/obj/structure/rospilovo/tree{
	icon_state = "derevo5"
	},
/turf/open/floor/grass/rospilovo,
/area/awaymission/rainy)
"Y" = (
/obj/effect/spawner/structure/window/reinforced,
/turf/open/floor/plating/is12/trenchcenter,
/area/awaymission/rainy)
"Z" = (
/obj/item/storage/belt/shotgun/buckshot,
/turf/open/floor/grass/gensgrass/dirty,
/area/awaymission/rainy)

(1,1,1) = {"
d
d
d
d
d
d
d
d
d
d
d
d
d
d
d
d
d
d
d
d
d
d
d
d
d
d
d
d
d
d
d
d
d
d
d
d
d
d
d
d
d
d
d
d
d
d
d
d
d
d
d
d
d
d
d
d
d
d
d
d
d
d
d
d
d
d
d
d
d
d
"}
(2,1,1) = {"
d
t
t
t
t
t
t
t
t
t
t
t
t
t
t
t
t
t
t
t
t
t
t
t
t
t
t
t
t
t
t
t
t
t
t
t
t
t
t
t
t
t
t
t
t
t
t
t
t
t
t
t
t
t
t
t
t
t
t
t
t
t
t
t
t
t
t
t
t
d
"}
(3,1,1) = {"
d
t
t
t
t
a
t
t
t
t
a
t
t
t
a
t
t
t
t
a
t
t
t
t
t
t
t
t
t
a
t
t
t
t
t
t
t
t
t
t
t
t
t
t
t
t
t
t
t
t
t
t
t
t
t
a
t
t
t
t
a
t
t
t
t
a
t
t
t
d
"}
(4,1,1) = {"
d
t
t
i
t
t
t
t
t
t
t
t
t
t
t
t
t
i
t
t
t
t
t
b
t
t
t
t
t
t
t
t
i
t
t
t
a
t
t
t
t
a
t
t
N
t
a
t
t
t
t
a
t
t
t
t
t
t
t
t
t
t
t
i
t
t
t
N
t
d
"}
(5,1,1) = {"
d
t
t
t
t
t
b
N
t
a
t
t
t
t
E
t
t
t
t
I
t
t
t
t
t
t
i
t
t
I
t
t
t
t
t
t
t
t
t
i
t
t
t
t
t
t
t
t
t
i
t
t
t
t
t
I
t
a
t
t
I
t
t
t
t
I
t
a
t
d
"}
(6,1,1) = {"
d
t
s
t
Q
t
N
N
t
t
t
t
t
t
t
a
s
t
X
t
t
t
t
I
t
t
t
t
t
t
a
s
t
X
t
t
I
t
t
t
t
I
t
a
t
t
I
t
t
t
t
I
N
b
t
t
t
t
t
t
t
a
s
t
X
t
t
t
t
d
"}
(7,1,1) = {"
d
t
t
t
t
t
E
N
t
I
t
t
t
i
t
t
t
t
X
t
t
t
t
t
a
s
t
t
i
t
t
t
t
X
t
t
t
a
s
t
X
t
t
t
t
t
t
a
s
t
X
t
N
N
t
t
t
t
t
t
s
t
X
t
t
t
t
I
t
d
"}
(8,1,1) = {"
d
t
t
t
t
t
t
t
t
t
a
s
t
t
t
I
t
t
t
t
t
t
i
t
t
t
t
t
t
t
E
t
t
t
t
i
t
t
t
N
X
t
t
t
t
t
s
N
X
t
t
t
N
E
t
t
t
t
t
t
t
I
t
t
s
t
X
t
t
d
"}
(9,1,1) = {"
d
t
t
t
F
i
t
t
i
t
t
t
t
t
X
t
t
t
t
s
t
t
t
t
I
t
t
t
t
X
t
t
t
t
t
t
t
I
t
t
t
t
t
t
t
t
t
I
t
t
s
t
X
t
t
s
t
t
t
i
t
t
I
t
t
t
t
t
t
d
"}
(10,1,1) = {"
d
t
t
a
t
t
t
t
t
t
I
t
t
t
t
t
t
a
t
t
t
t
t
X
t
t
t
t
t
t
t
t
a
t
t
t
X
t
t
t
t
s
t
t
t
i
t
t
I
t
t
t
t
t
t
t
t
i
t
t
N
t
t
t
t
t
t
t
a
d
"}
(11,1,1) = {"
d
t
t
t
t
t
X
t
t
X
t
t
t
t
t
t
t
t
s
t
j
t
t
t
t
t
a
t
t
t
t
t
t
s
t
t
t
t
t
a
t
t
t
i
t
t
t
t
t
t
t
t
t
t
a
t
X
t
t
t
t
t
t
t
t
t
i
t
t
d
"}
(12,1,1) = {"
d
t
t
I
t
t
t
t
t
t
t
t
t
t
t
t
t
I
t
t
t
t
t
t
t
t
t
t
t
t
t
t
I
t
t
t
t
t
t
t
s
t
X
t
t
N
t
t
t
t
t
t
i
t
t
t
t
I
t
t
t
t
t
i
t
t
t
t
t
d
"}
(13,1,1) = {"
d
t
t
t
t
t
t
t
t
t
t
N
t
t
a
t
t
t
X
t
t
t
t
t
t
t
I
t
t
a
t
t
t
X
t
t
t
t
t
I
t
t
t
I
t
t
t
t
t
i
t
t
t
t
t
t
t
t
t
t
t
t
t
t
t
a
t
t
t
d
"}
(14,1,1) = {"
d
t
t
t
t
t
t
t
t
t
t
t
t
t
t
t
t
t
t
t
t
t
t
a
t
t
t
t
N
t
t
t
t
t
t
t
a
t
t
t
X
t
t
t
t
t
t
t
t
t
t
a
t
t
t
t
t
t
t
t
t
s
t
t
t
t
t
t
t
d
"}
(15,1,1) = {"
d
t
t
t
t
t
a
t
t
a
t
t
t
t
I
t
t
t
s
t
X
t
t
t
t
t
t
t
N
I
t
t
t
s
t
N
t
t
t
t
t
t
t
t
t
N
t
s
t
t
t
t
N
t
t
t
X
t
t
t
t
t
t
t
t
I
t
a
t
d
"}
(16,1,1) = {"
d
t
s
a
t
t
t
t
t
t
t
t
t
t
t
t
t
t
t
t
t
t
t
t
t
t
t
t
t
t
a
s
a
t
t
t
I
t
t
t
s
t
X
t
t
t
t
t
t
t
t
I
t
a
t
t
t
t
I
t
s
t
X
t
X
t
t
t
t
d
"}
(17,1,1) = {"
d
t
t
t
t
t
I
t
t
I
t
t
t
t
t
y
y
Y
y
y
y
Y
y
y
t
t
t
t
i
t
t
t
t
t
t
t
t
a
s
a
t
t
t
t
I
t
s
t
X
t
X
t
t
t
t
t
t
X
t
t
t
N
t
t
t
t
t
I
t
d
"}
(18,1,1) = {"
d
t
t
E
t
t
t
t
t
t
a
s
t
t
y
y
c
c
c
y
c
c
c
y
y
n
n
n
n
n
n
n
n
n
z
i
t
t
t
t
t
t
t
X
t
t
t
t
t
t
t
t
t
I
t
t
i
t
t
t
X
t
t
t
s
t
X
t
t
d
"}
(19,1,1) = {"
d
t
t
t
t
i
t
t
i
t
t
t
t
t
y
G
c
c
c
S
u
c
c
D
Y
U
q
U
q
l
q
l
q
l
p
t
t
I
t
I
t
t
i
t
t
t
X
t
t
t
s
t
X
t
t
t
t
t
t
i
t
t
t
t
t
t
t
t
t
d
"}
(20,1,1) = {"
d
t
t
t
t
t
t
t
t
t
I
t
t
t
Y
r
c
c
O
y
u
g
c
O
Y
e
f
q
q
q
q
q
q
q
p
t
X
t
t
t
N
t
t
t
t
i
t
t
t
t
t
t
t
t
t
t
t
t
t
t
t
t
t
t
t
t
t
t
a
d
"}
(21,1,1) = {"
d
t
t
I
t
t
X
t
t
X
t
t
t
t
Y
r
u
c
x
y
y
y
y
y
y
c
M
l
q
l
q
U
q
l
p
t
t
t
t
t
t
t
t
t
a
t
t
t
t
t
t
t
t
t
a
t
t
t
t
a
t
t
t
N
a
t
t
t
t
d
"}
(22,1,1) = {"
d
t
t
t
t
t
t
t
t
t
t
t
t
t
y
m
c
c
c
y
c
c
c
c
Y
c
M
q
q
q
q
q
q
q
p
t
t
t
t
I
t
t
i
t
t
t
t
t
t
I
t
t
i
t
t
t
t
t
t
t
t
t
i
t
t
t
t
t
t
d
"}
(23,1,1) = {"
d
t
t
t
t
N
t
t
t
t
t
t
N
t
y
y
y
y
S
y
c
O
D
c
y
c
M
q
q
q
h
q
q
q
q
q
q
q
t
t
t
t
t
t
t
t
t
t
t
t
t
t
t
t
t
t
a
t
t
I
t
t
t
t
I
t
a
t
t
d
"}
(24,1,1) = {"
d
t
t
t
t
t
t
t
t
t
t
t
t
t
y
c
c
c
c
y
c
c
c
c
S
c
M
q
q
q
q
q
q
q
q
q
q
q
t
t
t
t
t
t
t
t
t
t
t
t
a
s
t
X
t
t
t
t
t
t
a
s
t
X
t
t
t
t
t
d
"}
(25,1,1) = {"
d
t
t
t
t
t
t
t
t
i
t
t
t
t
y
c
H
c
c
S
c
c
u
c
y
c
M
q
q
q
q
q
q
q
q
q
q
q
q
q
t
t
t
a
t
t
t
t
i
t
t
t
t
X
t
t
t
t
t
s
t
X
t
t
t
t
I
t
t
d
"}
(26,1,1) = {"
d
t
t
t
t
t
t
t
a
t
t
t
t
t
y
c
c
c
c
y
c
c
c
c
Y
c
M
q
q
q
q
q
q
q
p
t
s
t
q
q
t
t
t
t
t
t
i
t
t
t
I
t
t
t
t
N
t
t
t
t
I
t
t
s
t
X
t
t
t
d
"}
(27,1,1) = {"
d
t
t
I
t
t
i
t
t
t
t
t
t
t
y
y
y
y
S
y
y
y
y
y
y
c
M
l
q
U
q
l
q
l
p
t
t
t
q
q
q
q
t
I
t
t
t
t
t
j
t
t
t
t
s
t
t
t
i
t
t
I
t
t
t
t
t
t
t
d
"}
(28,1,1) = {"
d
t
t
t
t
t
t
t
t
t
N
t
t
t
Y
c
c
c
c
y
c
g
c
O
Y
C
K
q
q
q
q
q
q
q
p
I
t
I
t
q
q
q
t
t
a
s
t
t
t
t
t
t
a
t
t
t
i
t
t
t
t
t
N
t
t
t
t
a
t
d
"}
(29,1,1) = {"
d
t
t
t
t
t
t
I
t
t
i
t
t
t
Y
c
u
c
c
S
c
c
c
T
Y
U
q
l
q
l
q
l
q
l
p
t
t
t
t
N
q
q
q
t
t
t
t
t
t
t
t
t
t
s
t
X
t
t
t
t
t
t
t
t
t
i
t
t
t
d
"}
(30,1,1) = {"
d
t
t
t
t
t
t
t
t
t
t
t
t
t
y
y
c
c
c
y
c
u
c
y
y
n
n
n
n
n
n
n
n
n
k
t
t
t
t
N
q
q
q
q
I
t
t
t
t
t
t
t
I
t
t
t
I
t
t
t
t
t
i
t
t
t
t
t
t
d
"}
(31,1,1) = {"
d
t
t
t
t
t
t
t
t
t
t
t
t
t
t
y
y
Y
y
y
y
Y
y
y
t
t
t
t
t
a
t
t
t
t
t
t
t
I
t
t
i
q
q
q
t
t
t
t
t
a
t
t
t
X
t
t
t
t
t
t
t
t
t
t
a
t
t
t
a
d
"}
(32,1,1) = {"
d
t
I
t
t
t
s
t
X
t
t
t
t
t
t
t
t
I
t
a
t
t
a
t
t
t
t
t
t
t
t
t
t
t
t
t
t
t
t
t
t
t
q
q
q
t
t
t
t
t
t
t
t
t
t
t
t
t
t
t
s
t
t
t
t
t
t
t
t
d
"}
(33,1,1) = {"
d
t
t
a
s
a
t
t
t
t
I
t
s
t
X
t
X
t
t
t
t
t
t
t
t
t
t
a
t
I
t
a
t
t
t
t
t
t
t
t
t
t
t
q
q
q
q
t
t
t
t
t
t
t
t
q
q
q
q
t
t
t
t
t
t
t
t
t
t
d
"}
(34,1,1) = {"
d
t
t
t
t
t
t
t
t
X
t
t
t
t
t
t
t
t
t
I
t
t
I
t
a
t
t
t
t
t
t
t
t
t
t
t
a
t
t
t
t
a
t
t
t
q
q
q
t
t
t
a
t
t
q
q
q
q
q
q
q
a
t
t
t
t
a
t
t
d
"}
(35,1,1) = {"
d
t
t
I
t
I
t
t
i
t
t
t
X
t
t
t
s
t
X
t
t
X
t
t
t
t
t
I
t
t
t
I
t
t
B
t
t
t
t
t
t
t
t
t
i
q
h
q
t
t
t
t
t
t
q
q
q
q
q
q
q
t
t
t
i
t
t
t
t
d
"}
(36,1,1) = {"
d
t
X
t
t
t
t
t
t
t
t
i
t
t
t
t
t
t
t
t
t
t
t
t
I
t
X
t
t
t
X
t
t
t
t
t
I
t
a
t
t
I
t
t
t
q
q
q
q
t
t
I
t
q
q
q
V
q
J
q
q
t
t
t
t
t
I
t
a
d
"}
(37,1,1) = {"
d
t
t
t
N
t
t
t
t
N
a
t
t
t
t
t
t
t
t
t
a
s
t
X
t
t
t
t
t
t
t
t
t
s
t
X
t
t
t
t
t
t
a
s
t
X
t
q
q
q
q
t
t
q
q
J
q
q
q
q
q
t
a
s
t
X
t
t
t
d
"}
(38,1,1) = {"
d
t
t
t
t
I
t
t
i
t
t
t
t
t
t
I
t
t
i
t
t
t
t
t
t
t
t
t
a
t
t
t
a
t
t
X
t
t
t
t
t
s
t
X
t
t
t
t
q
q
q
q
q
q
q
q
L
R
q
q
q
q
t
X
t
t
t
t
I
d
"}
(39,1,1) = {"
d
t
t
t
t
t
t
t
t
t
t
t
t
t
t
t
t
t
t
t
t
t
t
t
t
a
i
t
t
t
i
t
t
t
t
t
t
t
t
t
t
t
I
t
t
s
t
X
t
t
q
q
q
q
q
Z
q
q
q
q
q
q
q
t
t
s
t
X
t
d
"}
(40,1,1) = {"
d
t
t
t
t
t
t
t
t
t
t
i
t
t
t
t
t
I
t
t
I
N
t
i
t
t
t
t
t
t
t
t
t
t
t
t
s
t
t
t
i
t
t
I
t
t
t
t
t
t
a
q
q
q
q
q
q
q
q
q
q
t
t
I
t
t
t
t
t
d
"}
(41,1,1) = {"
d
t
t
I
t
a
t
t
I
t
t
t
t
I
t
a
t
t
t
t
t
t
t
t
t
t
t
t
t
a
t
t
t
t
a
t
t
t
i
t
t
t
t
t
t
t
t
t
t
a
t
t
t
t
q
q
q
q
q
q
q
t
t
t
t
t
t
t
t
d
"}
(42,1,1) = {"
d
t
X
t
t
t
t
t
t
a
s
t
X
t
t
t
t
t
t
X
t
X
t
t
t
t
t
t
t
t
t
t
t
t
t
s
t
X
t
t
t
t
t
t
t
t
t
i
t
t
t
t
t
t
q
q
q
q
q
q
q
t
t
t
t
t
N
i
t
d
"}
(43,1,1) = {"
d
t
X
t
t
t
t
t
s
t
X
t
t
t
t
I
t
t
a
t
t
t
t
t
I
t
t
a
t
E
t
a
t
t
I
t
t
t
I
t
t
t
t
t
i
t
t
t
t
t
t
t
t
t
I
t
q
q
q
q
t
t
t
t
i
t
t
t
t
d
"}
(44,1,1) = {"
d
t
t
t
t
t
t
t
t
I
t
t
s
t
X
t
t
t
t
t
t
s
t
X
t
t
t
t
t
t
t
t
t
t
t
X
t
t
t
t
t
t
t
t
t
t
a
t
t
t
t
a
t
t
t
X
t
t
t
t
t
t
t
t
t
t
a
t
t
d
"}
(45,1,1) = {"
d
t
t
s
t
t
t
i
t
t
I
t
t
N
t
t
t
t
t
t
t
t
t
t
t
t
t
I
t
t
t
I
t
t
t
t
t
t
t
t
N
t
s
t
t
t
t
t
t
t
N
t
t
t
t
t
t
t
t
t
t
t
s
t
t
t
t
t
t
d
"}
(46,1,1) = {"
d
t
t
t
t
i
t
t
t
t
t
t
t
t
t
t
a
t
t
t
t
t
t
t
t
a
X
t
t
t
X
t
t
t
t
s
t
X
t
t
t
t
t
t
t
t
I
t
a
t
t
I
t
t
t
s
t
X
t
t
t
N
t
t
t
t
I
t
a
d
"}
(47,1,1) = {"
d
t
s
t
X
t
t
t
t
t
t
t
t
t
i
t
t
t
t
t
I
t
t
i
t
t
t
t
t
t
t
t
t
s
a
t
t
t
t
I
t
s
t
X
t
X
t
t
t
t
t
t
a
s
a
t
t
t
t
I
t
s
t
X
t
X
t
t
t
d
"}
(48,1,1) = {"
d
t
t
t
t
I
t
t
t
t
t
i
t
t
t
t
t
a
t
t
t
t
t
t
t
t
t
t
a
t
t
t
a
t
t
t
t
t
X
t
t
t
t
t
t
t
t
t
I
t
t
t
t
t
t
t
t
t
X
t
t
t
t
t
t
t
t
t
I
d
"}
(49,1,1) = {"
d
t
t
t
t
t
t
t
t
t
t
t
t
t
t
t
t
t
t
t
t
t
t
t
t
t
t
t
t
t
t
t
t
t
t
t
t
t
t
t
t
t
t
t
t
t
t
t
t
t
t
t
t
t
t
t
t
t
t
t
t
t
t
t
t
t
t
t
t
d
"}
(50,1,1) = {"
d
d
d
d
d
d
d
d
d
d
d
d
d
d
d
d
d
d
d
d
d
d
d
d
d
d
d
d
d
d
d
d
d
d
d
d
d
d
d
d
d
d
d
d
d
d
d
d
d
d
d
d
d
d
d
d
d
d
d
d
d
d
d
d
d
d
d
d
d
d
"}
