//MAP CONVERTED BY dmm2tgm.py THIS HEADER COMMENT PREVENTS RECONVERSION, DO NOT REMOVE
"c" = (
/obj/structure/table/wood,
/obj/item/flashlight/lamp/green{
	pixel_x = 1;
	pixel_y = 5
	},
/turf/open/floor/plasteel/grimy,
/area/ruin/unpowered)
"e" = (
/turf/open/floor/plasteel,
/area/ruin/unpowered)
"h" = (
/obj/machinery/door/poddoor/shutters{
	dir = 8;
	id = "exploration_ex_cargo1";
	name = "Cargo Shutters"
	},
/obj/structure/fans/tiny,
/obj/machinery/button/door{
	id = "exploration_ex_cargo1";
	name = "Cargo Shutters Control";
	pixel_y = 32;
	req_access_txt = "49"
	},
/turf/open/floor/plasteel,
/area/ruin/unpowered)
"j" = (
/obj/effect/abstract/open_area_marker{
	dir = 4
	},
/turf/open/floor/plasteel,
/area/ruin/unpowered)
"l" = (
/obj/effect/turf_decal/tile/yellow{
	dir = 1
	},
/obj/effect/turf_decal/tile/yellow,
/obj/effect/turf_decal/tile/dark{
	dir = 8
	},
/obj/effect/turf_decal/tile/dark{
	dir = 4
	},
/obj/structure/lattice,
/turf/open/floor/plating/asteroid/no_generation,
/area/ruin/unpowered)
"n" = (
/obj/effect/turf_decal/tile/yellow,
/obj/effect/turf_decal/tile/yellow{
	dir = 4
	},
/obj/effect/turf_decal/tile/yellow{
	dir = 1
	},
/turf/open/floor/plating/asteroid/no_generation,
/area/ruin/unpowered)
"o" = (
/obj/effect/spawner/structure/window/reinforced/derelict,
/turf/open/floor/circuit,
/area/ruin/unpowered)
"q" = (
/obj/structure/chair/sofa/right{
	dir = 8
	},
/turf/open/floor/plasteel/grimy,
/area/ruin/unpowered)
"s" = (
/obj/item/radio/intercom/directional/east,
/obj/structure/chair/sofa/left{
	dir = 8
	},
/turf/open/floor/plasteel/grimy,
/area/ruin/unpowered)
"t" = (
/obj/effect/spawner/random/vending/snackvend,
/turf/open/floor/plasteel,
/area/ruin/unpowered)
"u" = (
/obj/item/kirbyplants/random,
/turf/open/floor/plasteel,
/area/ruin/unpowered)
"v" = (
/obj/effect/spawner/random/vending/colavend,
/turf/open/floor/plasteel,
/area/ruin/unpowered)
"y" = (
/obj/effect/turf_decal/stripes/corner{
	dir = 1
	},
/turf/open/floor/plasteel,
/area/ruin/unpowered)
"z" = (
/obj/effect/turf_decal/tile/yellow{
	dir = 1
	},
/obj/effect/turf_decal/tile/dark{
	dir = 8
	},
/obj/effect/turf_decal/tile/dark{
	dir = 4
	},
/turf/open/floor/plating/asteroid/no_generation,
/area/ruin/unpowered)
"A" = (
/obj/effect/turf_decal/tile/yellow{
	dir = 8
	},
/obj/effect/turf_decal/tile/yellow,
/obj/effect/turf_decal/tile/yellow{
	dir = 4
	},
/obj/effect/turf_decal/tile/yellow{
	dir = 1
	},
/turf/open/floor/plating/asteroid/no_generation,
/area/ruin/unpowered)
"C" = (
/obj/effect/turf_decal/stripes/corner{
	dir = 8
	},
/obj/machinery/light/red{
	dir = 8
	},
/turf/open/floor/plasteel,
/area/ruin/unpowered)
"D" = (
/obj/machinery/door/poddoor/shutters{
	dir = 8;
	id = "exploration_ex_cargo1";
	name = "Cargo Shutters"
	},
/obj/structure/fans/tiny,
/turf/open/floor/plasteel,
/area/ruin/unpowered)
"H" = (
/obj/effect/turf_decal/stripes/line{
	dir = 8
	},
/turf/open/floor/plasteel,
/area/ruin/unpowered)
"I" = (
/turf/closed/wall/riveted_wall,
/area/ruin/unpowered)
"J" = (
/obj/effect/abstract/open_area_marker{
	dir = 8
	},
/turf/open/floor/plasteel,
/area/ruin/unpowered)
"K" = (
/obj/effect/turf_decal/tile/yellow{
	dir = 1
	},
/obj/effect/turf_decal/tile/yellow,
/obj/effect/turf_decal/tile/dark{
	dir = 4
	},
/turf/open/floor/plating/asteroid/no_generation,
/area/ruin/unpowered)
"M" = (
/obj/effect/turf_decal/tile/yellow{
	dir = 4
	},
/obj/effect/turf_decal/tile/yellow{
	dir = 1
	},
/obj/effect/turf_decal/tile/yellow{
	dir = 8
	},
/turf/open/floor/plating/asteroid/no_generation,
/area/ruin/unpowered)
"N" = (
/obj/effect/turf_decal/tile/yellow{
	dir = 1
	},
/obj/effect/turf_decal/tile/yellow{
	dir = 8
	},
/obj/effect/turf_decal/tile/yellow,
/obj/effect/turf_decal/tile/yellow{
	dir = 4
	},
/turf/open/floor/plating/asteroid/no_generation,
/area/ruin/unpowered)
"O" = (
/obj/effect/turf_decal/stripes/corner{
	dir = 1
	},
/obj/structure/closet/emcloset,
/obj/machinery/light/red{
	dir = 8
	},
/turf/open/floor/plasteel,
/area/ruin/unpowered)
"Q" = (
/obj/effect/turf_decal/tile/yellow{
	dir = 1
	},
/obj/effect/turf_decal/tile/yellow{
	dir = 4
	},
/turf/open/floor/plating/asteroid/no_generation,
/area/ruin/unpowered)
"R" = (
/turf/closed/wall/r_wall,
/area/ruin/unpowered)
"S" = (
/obj/effect/abstract/doorway_marker,
/turf/open/floor/plasteel,
/area/ruin/unpowered)
"T" = (
/obj/machinery/door/airlock/external,
/obj/structure/fans/tiny,
/turf/open/floor/plasteel,
/area/ruin/unpowered)
"V" = (
/obj/effect/turf_decal/tile/yellow{
	dir = 1
	},
/obj/effect/turf_decal/tile/yellow,
/obj/effect/turf_decal/tile/dark{
	dir = 8
	},
/turf/open/floor/plating/asteroid/no_generation,
/area/ruin/unpowered)
"W" = (
/obj/effect/abstract/open_area_marker,
/turf/open/floor/plasteel,
/area/ruin/unpowered)
"X" = (
/obj/effect/turf_decal/stripes/corner{
	dir = 8
	},
/obj/structure/closet/firecloset,
/turf/open/floor/plasteel,
/area/ruin/unpowered)
"Y" = (
/obj/effect/turf_decal/tile/yellow,
/obj/effect/turf_decal/tile/dark{
	dir = 8
	},
/obj/effect/turf_decal/tile/dark{
	dir = 4
	},
/turf/open/floor/plating/asteroid/no_generation,
/area/ruin/unpowered)
"Z" = (
/turf/open/floor/plating/asteroid/no_generation,
/area/ruin/unpowered)

(1,1,1) = {"
R
R
R
R
R
R
R
R
R
R
R
R
R
R
e
J
e
I
"}
(2,1,1) = {"
l
z
Z
Z
Z
Z
Z
Z
Z
Z
Z
V
l
R
e
e
e
I
"}
(3,1,1) = {"
z
Z
Z
Z
Z
Z
Z
Z
Z
Z
Z
Z
V
o
e
e
e
S
"}
(4,1,1) = {"
Z
Z
Z
Z
Z
Z
Z
n
Z
Z
Z
Z
Z
o
e
e
e
I
"}
(5,1,1) = {"
Z
Z
Z
Z
Z
A
N
N
Q
Z
Z
Z
Z
o
e
e
e
I
"}
(6,1,1) = {"
Z
Z
Z
Z
Z
Z
Z
M
Z
Z
Z
Z
Z
o
e
e
e
I
"}
(7,1,1) = {"
K
Z
Z
Z
Z
Z
Z
Z
Z
Z
Z
Z
Y
o
e
e
e
I
"}
(8,1,1) = {"
l
K
Z
Z
Z
Z
Z
Z
Z
Z
Z
Y
l
R
e
e
e
I
"}
(9,1,1) = {"
R
R
R
h
D
R
R
T
R
R
o
o
R
R
e
e
e
I
"}
(10,1,1) = {"
I
t
C
H
H
O
X
H
y
e
e
e
e
e
e
e
e
e
"}
(11,1,1) = {"
I
u
e
e
e
e
e
e
e
e
e
e
e
e
e
e
e
W
"}
(12,1,1) = {"
I
v
e
e
e
e
e
e
e
c
q
s
c
u
e
e
e
e
"}
(13,1,1) = {"
I
I
I
I
I
I
I
I
I
I
I
I
I
I
e
j
e
I
"}
