//MAP CONVERTED BY dmm2tgm.py THIS HEADER COMMENT PREVENTS RECONVERSION, DO NOT REMOVE
"bz" = (
/obj/effect/turf_decal/box/corners{
	dir = 1
	},
/obj/structure/closet/crate,
/turf/open/floor/plasteel,
/area/ruin/unpowered)
"bD" = (
/obj/effect/turf_decal/stripes/line,
/obj/effect/turf_decal/trimline/yellow/filled/line{
	dir = 1
	},
/turf/open/floor/plasteel/dark/side,
/area/ruin/unpowered)
"cK" = (
/turf/open/floor/plasteel/dark/side{
	dir = 8
	},
/area/ruin/unpowered)
"dx" = (
/obj/effect/turf_decal/delivery,
/turf/open/floor/plasteel/monofloor/dark,
/area/ruin/unpowered)
"dL" = (
/turf/open/floor/plasteel/dark/side{
	dir = 5
	},
/area/ruin/unpowered)
"en" = (
/obj/effect/turf_decal/box/corners{
	dir = 8
	},
/turf/open/floor/plasteel,
/area/ruin/unpowered)
"fG" = (
/obj/effect/turf_decal/box/corners{
	dir = 1
	},
/obj/effect/decal/cleanable/plasma,
/turf/open/floor/plasteel,
/area/ruin/unpowered)
"gh" = (
/obj/effect/turf_decal/stripes/line,
/obj/effect/turf_decal/loading_area,
/obj/effect/decal/cleanable/greenglow/filled,
/turf/open/floor/plasteel/dark/side,
/area/ruin/unpowered)
"gk" = (
/obj/structure/ore_box,
/turf/open/floor/plasteel/dark,
/area/ruin/unpowered)
"gr" = (
/obj/effect/turf_decal/trimline/yellow/filled/corner{
	dir = 1
	},
/obj/effect/turf_decal/trimline/yellow/filled/corner{
	dir = 4
	},
/turf/open/floor/plasteel,
/area/ruin/unpowered)
"gR" = (
/obj/effect/turf_decal/trimline/yellow/line,
/turf/open/floor/plasteel/dark/side,
/area/ruin/unpowered)
"hB" = (
/obj/effect/turf_decal/trimline/yellow/filled/line{
	dir = 1
	},
/turf/open/floor/plasteel,
/area/ruin/unpowered)
"hK" = (
/obj/structure/railing{
	dir = 1
	},
/obj/machinery/conveyor,
/obj/effect/turf_decal/tile/hex/yellow{
	dir = 1
	},
/obj/effect/turf_decal/tile/hex/yellow{
	dir = 4
	},
/turf/open/floor/engine,
/area/ruin/unpowered)
"im" = (
/obj/machinery/conveyor,
/turf/open/floor/plasteel/dark,
/area/ruin/unpowered)
"iv" = (
/obj/structure/railing/right{
	dir = 8
	},
/obj/effect/turf_decal/trimline/yellow/line{
	dir = 8
	},
/obj/effect/turf_decal/stripes/line{
	dir = 1
	},
/obj/machinery/conveyor_switch,
/turf/open/floor/plasteel/dark,
/area/ruin/unpowered)
"iI" = (
/obj/effect/abstract/doorway_marker{
	dir = 4
	},
/turf/open/floor/plasteel,
/area/ruin/unpowered)
"iO" = (
/obj/structure/railing/right{
	dir = 1
	},
/obj/effect/turf_decal/tile/hex/yellow{
	dir = 1
	},
/obj/effect/turf_decal/tile/hex/yellow{
	dir = 4
	},
/obj/effect/turf_decal/tile/hex/yellow,
/turf/open/floor/engine,
/area/ruin/unpowered)
"jl" = (
/turf/open/floor/plasteel/dark/side{
	dir = 9
	},
/area/ruin/unpowered)
"jR" = (
/obj/machinery/conveyor{
	dir = 4
	},
/obj/structure/plasticflaps,
/turf/open/floor/engine,
/area/ruin/unpowered)
"ke" = (
/obj/structure/railing,
/obj/effect/turf_decal/tile/hex/yellow{
	dir = 8
	},
/obj/effect/turf_decal/tile/hex/yellow,
/obj/effect/turf_decal/tile/hex/yellow{
	dir = 1
	},
/turf/open/floor/engine,
/area/ruin/unpowered)
"kt" = (
/obj/structure/plasticflaps,
/obj/machinery/conveyor{
	dir = 4
	},
/turf/open/floor/engine,
/area/ruin/unpowered)
"kN" = (
/turf/open/floor/plasteel/dark/side{
	dir = 1
	},
/area/ruin/unpowered)
"lp" = (
/obj/effect/turf_decal/stripes/line,
/obj/effect/turf_decal/trimline/yellow/filled/arrow_cw{
	dir = 1
	},
/turf/open/floor/plasteel/dark/side,
/area/ruin/unpowered)
"lA" = (
/obj/effect/decal/cleanable/greenglow/filled,
/turf/open/floor/plasteel,
/area/ruin/unpowered)
"mn" = (
/obj/effect/turf_decal/trimline/yellow/line{
	dir = 1
	},
/turf/open/floor/plasteel/dark/side{
	dir = 1
	},
/area/ruin/unpowered)
"mv" = (
/obj/effect/turf_decal/trimline/yellow/corner{
	dir = 4
	},
/turf/open/floor/plasteel/dark/side{
	dir = 10
	},
/area/ruin/unpowered)
"mF" = (
/obj/effect/turf_decal/trimline/yellow/filled/line{
	dir = 5
	},
/turf/open/floor/plasteel,
/area/ruin/unpowered)
"mQ" = (
/obj/effect/turf_decal/box/corners{
	dir = 4
	},
/obj/structure/closet/crate,
/turf/open/floor/plasteel,
/area/ruin/unpowered)
"oa" = (
/obj/structure/closet/crate{
	icon_state = "crateopen"
	},
/turf/open/floor/plasteel,
/area/ruin/unpowered)
"pk" = (
/obj/effect/turf_decal/trimline/yellow/corner{
	dir = 1
	},
/turf/open/floor/plasteel/dark/corner{
	dir = 1
	},
/area/ruin/unpowered)
"pn" = (
/turf/open/floor/plasteel/dark/side{
	dir = 4
	},
/area/ruin/unpowered)
"rD" = (
/obj/effect/turf_decal/trimline/yellow/corner{
	dir = 8
	},
/obj/machinery/conveyor_switch,
/obj/effect/decal/cleanable/plasma,
/turf/open/floor/plasteel/dark/side{
	dir = 5
	},
/area/ruin/unpowered)
"rP" = (
/obj/effect/turf_decal/box/corners,
/turf/open/floor/plasteel,
/area/ruin/unpowered)
"sJ" = (
/obj/machinery/conveyor{
	dir = 4
	},
/turf/open/floor/plasteel/monofloor/dark,
/area/ruin/unpowered)
"th" = (
/obj/effect/turf_decal/box/corners{
	dir = 8
	},
/obj/structure/closet/crate,
/turf/open/floor/plasteel,
/area/ruin/unpowered)
"ug" = (
/obj/machinery/conveyor{
	dir = 4
	},
/turf/open/floor/engine,
/area/ruin/unpowered)
"uC" = (
/obj/effect/turf_decal/stripes/line{
	dir = 1
	},
/obj/effect/turf_decal/trimline/yellow/filled/arrow_ccw,
/turf/open/floor/plasteel/dark/side{
	dir = 1
	},
/area/ruin/unpowered)
"uI" = (
/obj/machinery/conveyor{
	dir = 6
	},
/turf/open/floor/engine,
/area/ruin/unpowered)
"we" = (
/obj/structure/railing/right{
	dir = 8
	},
/obj/effect/turf_decal/trimline/yellow/line{
	dir = 8
	},
/turf/open/floor/plasteel/dark,
/area/ruin/unpowered)
"wo" = (
/turf/open/floor/plasteel/dark/side,
/area/ruin/unpowered)
"wH" = (
/obj/structure/railing/left{
	dir = 8
	},
/obj/effect/turf_decal/trimline/yellow/line{
	dir = 8
	},
/obj/effect/turf_decal/stripes/line,
/turf/open/floor/plasteel/dark,
/area/ruin/unpowered)
"xq" = (
/obj/effect/turf_decal/trimline/yellow/filled/corner,
/obj/effect/turf_decal/trimline/yellow/filled/corner{
	dir = 4
	},
/turf/open/floor/plasteel,
/area/ruin/unpowered)
"xY" = (
/obj/effect/turf_decal/box,
/turf/open/floor/plasteel,
/area/ruin/unpowered)
"yt" = (
/obj/effect/turf_decal/trimline/yellow/corner,
/obj/machinery/conveyor_switch,
/obj/effect/decal/cleanable/plasma,
/turf/open/floor/plasteel/dark/side{
	dir = 9
	},
/area/ruin/unpowered)
"AO" = (
/obj/machinery/button/door{
	id = "exploration_ex_cargo2";
	name = "Cargo Shutters Control";
	pixel_x = 32;
	req_access_txt = "49"
	},
/turf/closed/wall/riveted_wall,
/area/ruin/unpowered)
"Bl" = (
/obj/effect/abstract/open_area_marker{
	dir = 8
	},
/turf/open/floor/plasteel,
/area/ruin/unpowered)
"BS" = (
/obj/effect/turf_decal/stripes/line,
/obj/effect/turf_decal/loading_area,
/turf/open/floor/plasteel/dark/side,
/area/ruin/unpowered)
"Ca" = (
/obj/machinery/door/airlock/public,
/turf/open/floor/plasteel,
/area/ruin/unpowered)
"Cz" = (
/obj/effect/decal/cleanable/wrapping,
/turf/open/floor/plasteel/dark,
/area/ruin/unpowered)
"CK" = (
/obj/machinery/door/airlock/engineering,
/turf/open/floor/plasteel/dark,
/area/ruin/unpowered)
"DW" = (
/obj/structure/railing/left{
	dir = 8
	},
/obj/effect/turf_decal/trimline/yellow/line{
	dir = 8
	},
/turf/open/floor/plasteel/dark,
/area/ruin/unpowered)
"Ed" = (
/obj/effect/decal/cleanable/oil,
/turf/open/floor/plasteel/dark/side{
	dir = 9
	},
/area/ruin/unpowered)
"Ej" = (
/obj/effect/turf_decal/stripes/line{
	dir = 1
	},
/obj/effect/turf_decal/arrows,
/obj/effect/turf_decal/trimline/yellow/line{
	dir = 1
	},
/turf/open/floor/plasteel/dark/side{
	dir = 1
	},
/area/ruin/unpowered)
"EK" = (
/turf/open/floor/plasteel/dark/side{
	dir = 6
	},
/area/ruin/unpowered)
"Fn" = (
/obj/machinery/conveyor{
	dir = 1
	},
/obj/effect/turf_decal/tile/hex/yellow{
	dir = 8
	},
/obj/effect/turf_decal/tile/hex/yellow{
	dir = 1
	},
/turf/open/floor/engine,
/area/ruin/unpowered)
"Fo" = (
/obj/effect/turf_decal/box/corners{
	dir = 4
	},
/obj/structure/closet/crate{
	icon_state = "crateopen"
	},
/turf/open/floor/plasteel,
/area/ruin/unpowered)
"GA" = (
/turf/open/floor/plasteel/dark/side{
	dir = 10
	},
/area/ruin/unpowered)
"GH" = (
/obj/machinery/conveyor{
	dir = 1
	},
/turf/open/floor/engine,
/area/ruin/unpowered)
"GI" = (
/obj/effect/turf_decal/trimline/yellow/filled/line{
	dir = 9
	},
/turf/open/floor/plasteel,
/area/ruin/unpowered)
"Hd" = (
/obj/machinery/door/poddoor/shutters{
	id = "exploration_ex_cargo2"
	},
/turf/open/floor/plasteel/monofloor,
/area/ruin/unpowered)
"Hi" = (
/obj/structure/railing/left{
	dir = 1
	},
/obj/effect/turf_decal/tile/hex/yellow{
	dir = 1
	},
/obj/effect/turf_decal/tile/hex/yellow{
	dir = 4
	},
/obj/effect/turf_decal/tile/hex/yellow{
	dir = 8
	},
/turf/open/floor/engine,
/area/ruin/unpowered)
"Jv" = (
/obj/structure/railing,
/obj/effect/turf_decal/tile/hex/yellow{
	dir = 8
	},
/obj/effect/turf_decal/tile/hex/yellow,
/turf/open/floor/engine,
/area/ruin/unpowered)
"JC" = (
/obj/effect/spawner/structure/window/reinforced/derelict,
/turf/open/floor/circuit,
/area/ruin/unpowered)
"Ka" = (
/obj/effect/turf_decal/trimline/yellow/filled/corner{
	dir = 1
	},
/obj/effect/turf_decal/trimline/yellow/filled/corner{
	dir = 8
	},
/turf/open/floor/plasteel,
/area/ruin/unpowered)
"Ki" = (
/obj/effect/turf_decal/stripes/line,
/turf/open/floor/plasteel/dark,
/area/ruin/unpowered)
"Kx" = (
/obj/effect/turf_decal/stripes/corner{
	dir = 4
	},
/obj/effect/turf_decal/box/corners{
	dir = 1
	},
/obj/effect/decal/cleanable/greenglow/filled,
/obj/effect/turf_decal/trimline/yellow/corner{
	dir = 4
	},
/turf/open/floor/plasteel/dark/corner{
	dir = 4
	},
/area/ruin/unpowered)
"KL" = (
/obj/effect/turf_decal/stripes/line{
	dir = 1
	},
/obj/effect/turf_decal/trimline/yellow/filled/line,
/turf/open/floor/plasteel/dark/side{
	dir = 1
	},
/area/ruin/unpowered)
"KT" = (
/turf/closed/wall/riveted_wall,
/area/ruin/unpowered)
"NZ" = (
/obj/effect/turf_decal/trimline/yellow/corner{
	dir = 1
	},
/obj/effect/decal/cleanable/robot_debris,
/obj/effect/decal/cleanable/plastic,
/turf/open/floor/plasteel/dark/side{
	dir = 6
	},
/area/ruin/unpowered)
"OH" = (
/obj/machinery/conveyor,
/turf/open/floor/engine,
/area/ruin/unpowered)
"OJ" = (
/obj/effect/turf_decal/trimline/yellow/corner{
	dir = 4
	},
/turf/open/floor/plasteel/dark/corner{
	dir = 4
	},
/area/ruin/unpowered)
"OV" = (
/obj/effect/abstract/doorway_marker{
	dir = 1
	},
/turf/open/floor/plasteel,
/area/ruin/unpowered)
"Pc" = (
/obj/effect/turf_decal/stripes/line{
	dir = 1
	},
/obj/effect/turf_decal/loading_area{
	dir = 1
	},
/turf/open/floor/plasteel/dark/side{
	dir = 1
	},
/area/ruin/unpowered)
"Pv" = (
/obj/structure/railing{
	dir = 1
	},
/obj/effect/turf_decal/tile/hex/yellow{
	dir = 1
	},
/obj/effect/turf_decal/tile/hex/yellow{
	dir = 4
	},
/turf/open/floor/engine,
/area/ruin/unpowered)
"PE" = (
/turf/open/floor/engine,
/area/ruin/unpowered)
"PM" = (
/obj/effect/decal/cleanable/insectguts,
/turf/open/floor/plasteel/dark/side,
/area/ruin/unpowered)
"Qg" = (
/obj/effect/turf_decal/trimline/yellow/filled/line{
	dir = 8
	},
/obj/effect/turf_decal/trimline/yellow/corner,
/turf/open/floor/plasteel/dark/corner,
/area/ruin/unpowered)
"Ri" = (
/obj/effect/turf_decal/stripes/line{
	dir = 1
	},
/obj/machinery/conveyor_switch,
/turf/open/floor/plasteel/dark,
/area/ruin/unpowered)
"Sw" = (
/obj/machinery/portable_atmospherics/canister/oxygen,
/turf/open/floor/plasteel,
/area/ruin/unpowered)
"SG" = (
/obj/effect/turf_decal/trimline/yellow/filled/line{
	dir = 4
	},
/obj/effect/turf_decal/trimline/yellow/corner{
	dir = 8
	},
/turf/open/floor/plasteel/dark/corner{
	dir = 8
	},
/area/ruin/unpowered)
"TB" = (
/obj/effect/decal/cleanable/plasma,
/turf/open/floor/plasteel/dark/side{
	dir = 6
	},
/area/ruin/unpowered)
"Ua" = (
/obj/structure/railing{
	dir = 8
	},
/obj/effect/turf_decal/trimline/yellow/line{
	dir = 8
	},
/turf/open/floor/plasteel/dark,
/area/ruin/unpowered)
"UP" = (
/turf/open/floor/plasteel,
/area/ruin/unpowered)
"Vn" = (
/obj/structure/closet/crate,
/turf/open/floor/plasteel,
/area/ruin/unpowered)
"Vw" = (
/obj/effect/turf_decal/stripes/corner{
	dir = 1
	},
/obj/machinery/button/door{
	id = "exploration_ex_cargo1";
	name = "Cargo Shutters Control";
	pixel_x = 32;
	req_access_txt = "49"
	},
/obj/effect/turf_decal/box/corners{
	dir = 4
	},
/obj/effect/turf_decal/trimline/yellow/corner{
	dir = 1
	},
/turf/open/floor/plasteel/dark/corner{
	dir = 1
	},
/area/ruin/unpowered)
"WD" = (
/obj/effect/abstract/open_area_marker{
	dir = 4
	},
/turf/open/floor/plasteel,
/area/ruin/unpowered)
"WY" = (
/obj/structure/railing/left{
	dir = 6
	},
/obj/effect/turf_decal/tile/hex/yellow{
	dir = 8
	},
/obj/effect/turf_decal/tile/hex/yellow,
/obj/effect/turf_decal/tile/hex/yellow{
	dir = 4
	},
/turf/open/floor/engine,
/area/ruin/unpowered)
"Yb" = (
/obj/machinery/conveyor,
/obj/structure/plasticflaps,
/turf/open/floor/engine,
/area/ruin/unpowered)
"YW" = (
/obj/effect/turf_decal/box/corners,
/obj/effect/decal/cleanable/oil,
/turf/open/floor/plasteel,
/area/ruin/unpowered)
"Zs" = (
/turf/open/floor/plasteel/dark,
/area/ruin/unpowered)
"Zt" = (
/obj/effect/decal/cleanable/oil,
/turf/open/floor/plasteel/dark/side{
	dir = 1
	},
/area/ruin/unpowered)

(1,1,1) = {"
KT
KT
KT
KT
KT
KT
KT
KT
KT
KT
KT
KT
KT
UP
Bl
UP
KT
"}
(2,1,1) = {"
KT
Zs
Zs
Zs
Zs
Zs
Zs
Zs
Zs
Zs
Zs
Zs
KT
OJ
UP
UP
KT
"}
(3,1,1) = {"
KT
Zs
PE
PE
PE
PE
PE
PE
PE
PE
PE
Zs
JC
mn
UP
UP
KT
"}
(4,1,1) = {"
KT
Zs
PE
OH
OH
OH
ug
PE
PE
PE
PE
Zs
JC
mn
Sw
UP
KT
"}
(5,1,1) = {"
KT
Zs
PE
PE
PE
PE
ug
GH
GH
GH
PE
Zs
JC
mn
lA
UP
KT
"}
(6,1,1) = {"
KT
Zs
PE
OH
OH
OH
ug
PE
PE
PE
PE
Zs
JC
mn
UP
UP
KT
"}
(7,1,1) = {"
KT
Zs
KT
JC
JC
KT
jR
KT
JC
JC
KT
Zs
KT
pk
UP
UP
KT
"}
(8,1,1) = {"
KT
Zs
we
Ua
Ua
wH
sJ
iv
Ua
Ua
DW
Zs
KT
UP
UP
UP
KT
"}
(9,1,1) = {"
KT
jl
cK
cK
GA
lp
sJ
uC
jl
cK
cK
cK
AO
Kx
UP
en
KT
"}
(10,1,1) = {"
KT
kN
bz
th
wo
BS
sJ
Pc
kN
fG
UP
en
Hd
Ej
UP
UP
KT
"}
(11,1,1) = {"
KT
kN
Vn
oa
wo
bD
dx
KL
kN
UP
xY
UP
Hd
Ej
UP
UP
KT
"}
(12,1,1) = {"
KT
kN
Fo
rP
PM
gh
sJ
Pc
Zt
mQ
UP
rP
Hd
Ej
UP
UP
KT
"}
(13,1,1) = {"
KT
dL
pn
pn
EK
lp
sJ
uC
dL
pn
pn
pn
KT
Vw
UP
YW
KT
"}
(14,1,1) = {"
KT
gk
Zs
gk
gk
Ki
sJ
Ri
gk
Ed
cK
GA
KT
UP
UP
UP
KT
"}
(15,1,1) = {"
KT
KT
CK
KT
KT
KT
kt
KT
KT
JC
Ca
JC
KT
OJ
UP
UP
KT
"}
(16,1,1) = {"
KT
GI
Ka
Qg
KT
Hi
ug
Fn
ke
dL
UP
TB
JC
mn
UP
UP
KT
"}
(17,1,1) = {"
KT
hB
UP
gR
JC
hK
ug
PE
Jv
yt
UP
mv
JC
mn
UP
UP
KT
"}
(18,1,1) = {"
OV
gr
UP
gR
JC
Pv
ug
GH
Jv
kN
UP
wo
JC
mn
UP
UP
KT
"}
(19,1,1) = {"
KT
hB
UP
gR
JC
hK
ug
PE
WY
rD
UP
NZ
JC
mn
UP
UP
KT
"}
(20,1,1) = {"
KT
mF
xq
SG
KT
iO
uI
OH
Yb
im
dx
Cz
KT
pk
UP
UP
KT
"}
(21,1,1) = {"
KT
KT
iI
KT
KT
KT
KT
KT
KT
KT
KT
KT
KT
UP
WD
UP
KT
"}
