//MAP CONVERTED BY dmm2tgm.py THIS HEADER COMMENT PREVENTS RECONVERSION, DO NOT REMOVE
"a" = (
/obj/effect/turf_decal/tile/yellow{
	dir = 8
	},
/obj/effect/turf_decal/tile/yellow,
/turf/open/floor/plasteel/white,
/area/ruin/unpowered)
"b" = (
/turf/open/floor/plasteel,
/area/ruin/unpowered)
"c" = (
/obj/structure/table/glass,
/obj/effect/spawner/random/maintenance,
/turf/open/floor/plasteel/white,
/area/ruin/unpowered)
"d" = (
/obj/effect/turf_decal/tile/yellow{
	dir = 8
	},
/obj/effect/turf_decal/tile/yellow{
	dir = 4
	},
/obj/effect/turf_decal/tile/yellow,
/obj/machinery/chem_heater,
/turf/open/floor/plasteel/white,
/area/ruin/unpowered)
"e" = (
/obj/effect/turf_decal/tile/yellow{
	dir = 4
	},
/obj/effect/turf_decal/tile/yellow,
/obj/machinery/camera/autoname{
	dir = 8
	},
/obj/structure/rack,
/obj/item/storage/box/beakers,
/turf/open/floor/plasteel/white,
/area/ruin/unpowered)
"f" = (
/obj/effect/turf_decal/tile/blue{
	dir = 8
	},
/obj/effect/turf_decal/tile/blue{
	dir = 1
	},
/turf/open/floor/plasteel/white,
/area/ruin/unpowered)
"g" = (
/obj/effect/turf_decal/tile/yellow{
	dir = 8
	},
/obj/effect/turf_decal/tile/yellow{
	dir = 1
	},
/turf/open/floor/plasteel/white,
/area/ruin/unpowered)
"i" = (
/obj/effect/turf_decal/tile/blue,
/obj/effect/turf_decal/tile/blue{
	dir = 1
	},
/obj/effect/turf_decal/tile/blue{
	dir = 4
	},
/turf/open/floor/plasteel/white,
/area/ruin/unpowered)
"j" = (
/obj/effect/turf_decal/tile/yellow{
	dir = 4
	},
/obj/effect/turf_decal/tile/yellow{
	dir = 1
	},
/obj/structure/table/glass,
/obj/machinery/reagentgrinder{
	pixel_x = -1;
	pixel_y = 7
	},
/turf/open/floor/plasteel/white,
/area/ruin/unpowered)
"k" = (
/turf/open/floor/plasteel/white,
/area/ruin/unpowered)
"m" = (
/obj/effect/turf_decal/tile/blue,
/obj/effect/turf_decal/tile/blue{
	dir = 4
	},
/turf/open/floor/plasteel/white,
/area/ruin/unpowered)
"n" = (
/obj/effect/abstract/open_area_marker,
/turf/open/floor/plasteel,
/area/ruin/unpowered)
"p" = (
/obj/effect/turf_decal/tile/yellow{
	dir = 8
	},
/obj/effect/turf_decal/tile/yellow,
/obj/machinery/light_switch{
	pixel_x = 1;
	pixel_y = -25
	},
/turf/open/floor/plasteel/white,
/area/ruin/unpowered)
"q" = (
/obj/effect/turf_decal/tile/yellow{
	dir = 8
	},
/obj/effect/turf_decal/tile/yellow{
	dir = 1
	},
/obj/machinery/chem_dispenser{
	layer = 2.7
	},
/turf/open/floor/plasteel/white,
/area/ruin/unpowered)
"s" = (
/obj/effect/spawner/structure/window/reinforced/derelict,
/turf/open/floor/circuit,
/area/ruin/unpowered)
"t" = (
/obj/effect/turf_decal/tile/yellow{
	dir = 4
	},
/obj/effect/turf_decal/tile/yellow{
	dir = 1
	},
/obj/structure/table/glass,
/obj/item/reagent_containers/glass/beaker/large{
	pixel_x = -3;
	pixel_y = 4
	},
/obj/item/reagent_containers/glass/beaker/large{
	pixel_x = -6;
	pixel_y = 2
	},
/obj/item/reagent_containers/syringe,
/obj/item/reagent_containers/syringe{
	pixel_x = 1;
	pixel_y = 4
	},
/turf/open/floor/plasteel/white,
/area/ruin/unpowered)
"u" = (
/obj/effect/turf_decal/tile/blue{
	dir = 1
	},
/obj/effect/turf_decal/tile/blue{
	dir = 4
	},
/obj/effect/turf_decal/tile/blue{
	dir = 8
	},
/turf/open/floor/plasteel/white,
/area/ruin/unpowered)
"v" = (
/obj/effect/abstract/open_area_marker{
	dir = 8
	},
/turf/open/floor/plasteel,
/area/ruin/unpowered)
"w" = (
/obj/effect/turf_decal/tile/yellow{
	dir = 4
	},
/obj/effect/turf_decal/tile/yellow,
/obj/effect/turf_decal/tile/yellow{
	dir = 1
	},
/obj/structure/closet/secure_closet/chemical,
/turf/open/floor/plasteel/white,
/area/ruin/unpowered)
"x" = (
/obj/effect/turf_decal/tile/yellow{
	dir = 8
	},
/obj/effect/turf_decal/tile/yellow{
	dir = 1
	},
/obj/structure/table/glass,
/obj/item/reagent_containers/glass/bottle/epinephrine{
	pixel_x = -2;
	pixel_y = 1
	},
/obj/item/storage/pill_bottle,
/obj/item/storage/pill_bottle,
/obj/item/storage/pill_bottle,
/obj/item/reagent_containers/syringe,
/turf/open/floor/plasteel/white,
/area/ruin/unpowered)
"y" = (
/obj/effect/turf_decal/tile/blue{
	dir = 1
	},
/obj/effect/turf_decal/tile/blue{
	dir = 4
	},
/obj/machinery/light{
	dir = 1
	},
/turf/open/floor/plasteel/white,
/area/ruin/unpowered)
"z" = (
/obj/structure/table/reinforced,
/obj/machinery/door/firedoor/border_only{
	dir = 8
	},
/obj/machinery/door/firedoor/border_only{
	dir = 4
	},
/obj/machinery/door/window/northleft{
	dir = 4;
	name = "Chemistry Desk";
	req_access_txt = "5; 33"
	},
/turf/open/floor/plasteel/white,
/area/ruin/unpowered)
"A" = (
/obj/effect/turf_decal/tile/blue,
/obj/effect/turf_decal/tile/blue{
	dir = 8
	},
/obj/effect/turf_decal/tile/blue{
	dir = 4
	},
/turf/open/floor/plasteel/white,
/area/ruin/unpowered)
"C" = (
/obj/effect/turf_decal/tile/blue,
/obj/effect/turf_decal/tile/blue{
	dir = 8
	},
/obj/effect/turf_decal/tile/blue{
	dir = 1
	},
/turf/open/floor/plasteel/white,
/area/ruin/unpowered)
"D" = (
/obj/effect/turf_decal/tile/yellow{
	dir = 8
	},
/obj/effect/turf_decal/tile/yellow,
/obj/machinery/chem_master,
/turf/open/floor/plasteel/white,
/area/ruin/unpowered)
"E" = (
/obj/effect/turf_decal/tile/yellow{
	dir = 4
	},
/obj/effect/turf_decal/tile/yellow,
/obj/machinery/light{
	dir = 4
	},
/turf/open/floor/plasteel/white,
/area/ruin/unpowered)
"F" = (
/obj/effect/turf_decal/tile/blue,
/obj/effect/turf_decal/tile/blue{
	dir = 8
	},
/turf/open/floor/plasteel/white,
/area/ruin/unpowered)
"G" = (
/obj/effect/turf_decal/tile/yellow{
	dir = 8
	},
/turf/open/floor/plasteel/white,
/area/ruin/unpowered)
"I" = (
/obj/effect/turf_decal/tile/yellow{
	dir = 8
	},
/obj/effect/turf_decal/tile/yellow,
/obj/structure/extinguisher_cabinet{
	pixel_y = -30
	},
/turf/open/floor/plasteel/white,
/area/ruin/unpowered)
"J" = (
/obj/effect/turf_decal/tile/yellow{
	dir = 8
	},
/obj/effect/turf_decal/tile/yellow,
/obj/effect/turf_decal/tile/yellow{
	dir = 1
	},
/obj/structure/table/glass,
/obj/item/storage/box/beakers,
/obj/item/reagent_containers/syringe,
/obj/item/reagent_containers/syringe,
/turf/open/floor/plasteel/white,
/area/ruin/unpowered)
"K" = (
/obj/machinery/door/firedoor/border_only,
/obj/machinery/door/firedoor/border_only{
	dir = 1
	},
/obj/effect/turf_decal/stripes/line,
/obj/effect/turf_decal/stripes/line{
	dir = 1
	},
/obj/machinery/door/airlock/medical/glass,
/turf/open/floor/plasteel/white,
/area/ruin/unpowered)
"L" = (
/obj/effect/turf_decal/tile/yellow{
	dir = 4
	},
/obj/effect/turf_decal/tile/yellow,
/turf/open/floor/plasteel/white,
/area/ruin/unpowered)
"M" = (
/obj/effect/turf_decal/tile/yellow{
	dir = 4
	},
/obj/effect/turf_decal/tile/yellow{
	dir = 1
	},
/obj/machinery/vending/wardrobe/chem_wardrobe,
/turf/open/floor/plasteel/white,
/area/ruin/unpowered)
"N" = (
/obj/effect/turf_decal/bot_white,
/turf/open/floor/plasteel/white,
/area/ruin/unpowered)
"O" = (
/turf/closed/wall/riveted_wall,
/area/ruin/unpowered)
"T" = (
/obj/machinery/smartfridge/chemistry/preloaded,
/turf/closed/wall,
/area/ruin/unpowered)
"U" = (
/obj/effect/turf_decal/tile/yellow{
	dir = 4
	},
/obj/effect/turf_decal/tile/yellow{
	dir = 1
	},
/turf/open/floor/plasteel/white,
/area/ruin/unpowered)
"V" = (
/obj/effect/abstract/doorway_marker{
	dir = 4
	},
/turf/open/floor/plasteel/white,
/area/ruin/unpowered)
"X" = (
/obj/effect/turf_decal/tile/yellow{
	dir = 4
	},
/obj/effect/turf_decal/tile/yellow,
/obj/structure/rack,
/obj/item/construction/plumbing,
/turf/open/floor/plasteel/white,
/area/ruin/unpowered)
"Y" = (
/obj/effect/turf_decal/tile/yellow{
	dir = 4
	},
/obj/effect/turf_decal/tile/yellow{
	dir = 1
	},
/obj/structure/table/glass,
/obj/machinery/light{
	dir = 1
	},
/obj/item/book/manual/wiki/grenades{
	pixel_y = 3
	},
/turf/open/floor/plasteel/white,
/area/ruin/unpowered)
"Z" = (
/obj/effect/turf_decal/tile/yellow{
	dir = 8
	},
/obj/effect/turf_decal/tile/yellow,
/obj/structure/table/glass,
/obj/effect/spawner/random/exotic/antag_gear_weak,
/turf/open/floor/plasteel/white,
/area/ruin/unpowered)

(1,1,1) = {"
O
O
O
O
O
b
v
b
O
"}
(2,1,1) = {"
O
Y
c
Z
O
u
f
C
b
"}
(3,1,1) = {"
O
U
k
p
O
y
N
F
n
"}
(4,1,1) = {"
O
U
k
a
K
i
m
A
b
"}
(5,1,1) = {"
O
j
k
I
O
s
z
T
O
"}
(6,1,1) = {"
O
t
k
G
x
q
g
J
O
"}
(7,1,1) = {"
O
M
k
k
k
k
k
D
O
"}
(8,1,1) = {"
O
w
L
e
X
E
L
d
O
"}
(9,1,1) = {"
O
O
V
O
O
O
O
O
O
"}
