//MAP CONVERTED BY dmm2tgm.py THIS HEADER COMMENT PREVENTS RECONVERSION, DO NOT REMOVE
"aU" = (
/obj/effect/decal/cleanable/dirt,
/obj/effect/turf_decal/trimline/white/line{
	dir = 1
	},
/turf/open/floor/wood,
/area/space)
"cn" = (
/obj/effect/decal/cleanable/dirt,
/turf/open/floor/wood,
/area/space)
"dP" = (
/obj/machinery/atmospherics/pipe/heat_exchanging/junction,
/turf/open/floor/engine/airless,
/area/space)
"dV" = (
/obj/effect/spawner/structure/window/plasma/reinforced,
/obj/machinery/atmospherics/pipe/manifold/general/visible{
	dir = 4
	},
/turf/open/floor/plating,
/area/space)
"ee" = (
/turf/open/floor/plasteel/dark,
/area/space)
"ep" = (
/obj/structure/window,
/obj/effect/decal/cleanable/food/flour,
/turf/open/floor/plasteel/white,
/area/space)
"fA" = (
/obj/machinery/door/window/brigdoor/security/cell/eastright,
/turf/open/floor/plasteel/dark,
/area/space)
"gc" = (
/obj/effect/spawner/structure/window/reinforced,
/turf/open/floor/plating,
/area/space)
"gC" = (
/obj/machinery/atmospherics/pipe/simple/general/visible{
	dir = 10
	},
/obj/machinery/atmospherics/pipe/heat_exchanging/simple{
	dir = 5
	},
/turf/open/floor/engine/airless,
/area/space)
"hz" = (
/obj/effect/spawner/structure/window/plasma/reinforced,
/obj/machinery/atmospherics/pipe/simple/general/visible{
	dir = 10
	},
/turf/open/floor/plating,
/area/space)
"hI" = (
/obj/structure/table,
/obj/item/kitchen/fork/plastic,
/turf/open/floor/plasteel,
/area/space)
"iz" = (
/obj/machinery/atmospherics/components/unary/vent_pump/on{
	dir = 4
	},
/turf/open/floor/engine/airless,
/area/space)
"jw" = (
/obj/item/radio/intercom{
	desc = "A station intercom. It looks like it has been modified to not broadcast.";
	name = "Prison Intercom (General)";
	pixel_y = 24;
	prison_radio = 1
	},
/turf/open/floor/plasteel/dark,
/area/space)
"jQ" = (
/obj/effect/decal/cleanable/dirt,
/obj/effect/turf_decal/trimline/white/line{
	dir = 8
	},
/turf/open/floor/wood,
/area/space)
"lp" = (
/obj/structure/sink/kitchen{
	pixel_y = 28
	},
/turf/open/floor/plasteel/white,
/area/space)
"me" = (
/obj/structure/table,
/obj/machinery/microwave,
/turf/open/floor/plasteel/white,
/area/space)
"mI" = (
/obj/effect/spawner/structure/window/plasma/reinforced,
/obj/machinery/atmospherics/pipe/manifold/general/visible{
	dir = 8
	},
/turf/open/floor/plating,
/area/space)
"nO" = (
/turf/open/floor/engine/airless,
/area/space)
"oh" = (
/obj/effect/decal/cleanable/dirt,
/obj/effect/turf_decal/trimline/white,
/obj/item/toy/beach_ball/holoball,
/turf/open/floor/wood,
/area/space)
"oA" = (
/obj/effect/turf_decal/stripes/white/line{
	dir = 8
	},
/obj/effect/decal/cleanable/dirt,
/obj/effect/turf_decal/trimline/white/line{
	dir = 5
	},
/turf/open/floor/wood,
/area/space)
"oD" = (
/obj/structure/closet/crate,
/obj/item/stack/license_plates/empty/fifty,
/obj/item/stack/license_plates/empty/fifty,
/obj/item/stack/license_plates/empty/fifty,
/obj/item/stack/sheet/cardboard{
	amount = 14
	},
/obj/item/stack/package_wrap,
/turf/open/floor/plasteel/dark,
/area/space)
"oN" = (
/obj/machinery/atmospherics/pipe/heat_exchanging/simple{
	dir = 4
	},
/turf/open/floor/engine/airless,
/area/space)
"py" = (
/obj/machinery/atmospherics/pipe/heat_exchanging/manifold4w,
/turf/open/floor/engine/airless,
/area/space)
"pQ" = (
/obj/effect/decal/cleanable/dirt,
/obj/effect/turf_decal/trimline/white/line{
	dir = 4
	},
/turf/open/floor/wood,
/area/space)
"qo" = (
/obj/machinery/atmospherics/pipe/heat_exchanging/simple{
	dir = 5
	},
/turf/open/floor/engine/airless,
/area/space)
"ry" = (
/obj/effect/turf_decal/stripes/white/line{
	dir = 6
	},
/obj/effect/decal/cleanable/dirt,
/turf/open/floor/wood,
/area/space)
"rX" = (
/obj/structure/window,
/turf/open/floor/plasteel/white,
/area/space)
"sf" = (
/obj/structure/sink{
	pixel_y = 30
	},
/turf/open/floor/plasteel/white,
/area/space)
"sN" = (
/obj/effect/decal/cleanable/dirt,
/obj/effect/turf_decal/trimline/white/corner{
	dir = 1
	},
/turf/open/floor/wood,
/area/space)
"tU" = (
/obj/structure/toilet/greyscale{
	dir = 4
	},
/turf/open/floor/plasteel/white,
/area/space)
"ua" = (
/obj/structure/closet/crate,
/obj/item/stack/license_plates/empty/fifty,
/obj/item/stack/license_plates/empty/fifty,
/obj/item/stack/license_plates/empty/fifty,
/obj/effect/spawner/lootdrop/prison_contraband,
/turf/open/floor/plasteel/dark,
/area/space)
"uf" = (
/turf/closed/wall,
/area/space)
"vt" = (
/obj/effect/spawner/structure/window/plasma/reinforced,
/obj/machinery/atmospherics/pipe/manifold/general/visible,
/turf/open/floor/plating,
/area/space)
"vG" = (
/obj/structure/closet,
/obj/effect/spawner/lootdrop/prison_contraband,
/turf/open/floor/plasteel/white,
/area/space)
"vJ" = (
/turf/open/space/basic,
/area/space)
"vY" = (
/obj/effect/turf_decal/stripes/white/line{
	dir = 8
	},
/obj/effect/decal/cleanable/dirt,
/obj/effect/turf_decal/trimline/white/line{
	dir = 6
	},
/turf/open/floor/wood,
/area/space)
"xc" = (
/obj/machinery/atmospherics/pipe/heat_exchanging/manifold{
	dir = 1
	},
/turf/open/floor/engine/airless,
/area/space)
"xK" = (
/obj/structure/table,
/turf/open/floor/plasteel,
/area/space)
"xR" = (
/obj/machinery/vending/cola/red,
/turf/open/floor/plasteel/dark,
/area/space)
"yH" = (
/obj/effect/turf_decal/stripes/white/line{
	dir = 10
	},
/obj/effect/decal/cleanable/dirt,
/turf/open/floor/wood,
/area/space)
"yI" = (
/obj/effect/turf_decal/stripes/white/line{
	dir = 4
	},
/obj/effect/decal/cleanable/dirt,
/obj/effect/turf_decal/trimline/white/line{
	dir = 10
	},
/turf/open/floor/wood,
/area/space)
"zb" = (
/obj/structure/chair{
	dir = 8
	},
/turf/open/floor/plasteel,
/area/space)
"ze" = (
/obj/machinery/door/window/brigdoor/security/cell/southleft,
/turf/open/floor/plasteel/dark,
/area/space)
"Ai" = (
/obj/machinery/vending/sustenance,
/turf/open/floor/plasteel/dark,
/area/space)
"Ce" = (
/obj/structure/chair{
	dir = 4
	},
/turf/open/floor/plasteel,
/area/space)
"Cp" = (
/turf/closed/wall/r_wall/syndicate,
/area/space)
"Cr" = (
/obj/machinery/atmospherics/pipe/heat_exchanging/simple{
	dir = 6
	},
/turf/open/floor/engine/airless,
/area/space)
"CN" = (
/obj/structure/closet/crate,
/obj/item/reagent_containers/food/snacks/breadslice/plain,
/obj/item/reagent_containers/food/snacks/breadslice/plain,
/obj/item/reagent_containers/food/snacks/breadslice/plain,
/obj/item/reagent_containers/food/snacks/grown/potato,
/obj/item/reagent_containers/food/snacks/grown/potato,
/obj/item/reagent_containers/food/snacks/grown/onion,
/obj/item/reagent_containers/food/snacks/grown/onion,
/obj/item/reagent_containers/food/snacks/meat/rawcutlet/plain,
/obj/item/reagent_containers/food/snacks/meat/rawcutlet/plain,
/obj/item/reagent_containers/food/snacks/meat/rawcutlet/plain,
/turf/open/floor/plasteel/white,
/area/space)
"Dj" = (
/obj/machinery/door/window/brigdoor/security/cell/westleft,
/turf/open/floor/plasteel/dark,
/area/space)
"DM" = (
/obj/effect/decal/cleanable/dirt,
/obj/effect/turf_decal/trimline/white/corner,
/turf/open/floor/wood,
/area/space)
"EC" = (
/obj/effect/turf_decal/stripes/white/line{
	dir = 4
	},
/obj/effect/decal/cleanable/dirt,
/obj/effect/turf_decal/trimline/white/line{
	dir = 9
	},
/turf/open/floor/wood,
/area/space)
"FL" = (
/obj/effect/spawner/structure/window/plasma/reinforced,
/turf/open/floor/plating,
/area/space)
"FX" = (
/obj/machinery/atmospherics/components/unary/vent_scrubber/on{
	dir = 8
	},
/turf/open/floor/engine/airless,
/area/space)
"Gh" = (
/obj/machinery/door/airlock/engineering/glass/critical{
	heat_proof = 1;
	name = "Supermatter Chamber";
	req_access_txt = "10"
	},
/turf/open/floor/engine/airless,
/area/space)
"Gt" = (
/obj/effect/decal/cleanable/dirt,
/obj/effect/turf_decal/trimline/white/corner{
	dir = 8
	},
/turf/open/floor/wood,
/area/space)
"Gz" = (
/turf/open/floor/plasteel,
/area/space)
"GF" = (
/turf/open/floor/plasteel/white,
/area/space)
"GQ" = (
/obj/effect/decal/cleanable/dirt,
/obj/effect/turf_decal/trimline/white/line,
/turf/open/floor/wood,
/area/space)
"Hg" = (
/obj/machinery/atmospherics/components/binary/pump/on{
	dir = 4;
	target_pressure = 4500
	},
/turf/open/floor/engine/airless,
/area/space)
"Hw" = (
/obj/machinery/plate_press,
/turf/open/floor/plasteel/dark,
/area/space)
"HB" = (
/obj/machinery/atmospherics/pipe/simple/general/visible{
	dir = 6
	},
/obj/machinery/atmospherics/pipe/heat_exchanging/simple{
	dir = 9
	},
/turf/open/floor/engine/airless,
/area/space)
"Ii" = (
/turf/closed/wall/r_wall,
/area/space)
"IJ" = (
/obj/structure/table/reinforced,
/obj/item/storage/bag/tray/cafeteria,
/obj/item/storage/bag/tray/cafeteria{
	pixel_y = 2
	},
/obj/item/storage/bag/tray/cafeteria{
	pixel_y = 4
	},
/obj/item/storage/bag/tray/cafeteria{
	pixel_y = 6
	},
/turf/open/floor/plasteel,
/area/space)
"Jw" = (
/obj/machinery/atmospherics/pipe/heat_exchanging/simple{
	dir = 10
	},
/turf/open/floor/engine/airless,
/area/space)
"Kc" = (
/obj/structure/weightmachine/weightlifter,
/turf/open/floor/plasteel,
/area/space)
"Mk" = (
/obj/machinery/atmospherics/pipe/heat_exchanging/junction{
	dir = 4
	},
/turf/open/floor/engine/airless,
/area/space)
"Mp" = (
/obj/structure/table,
/obj/structure/window,
/obj/item/reagent_containers/food/condiment/saltshaker{
	layer = 3.1;
	pixel_x = -2;
	pixel_y = 2
	},
/obj/item/reagent_containers/food/condiment/peppermill{
	desc = "Often used to flavor food or make people sneeze. Fashionably moved to the left side of the table.";
	pixel_x = -8;
	pixel_y = 2
	},
/obj/item/reagent_containers/food/condiment/enzyme{
	pixel_x = 9;
	pixel_y = 3
	},
/obj/item/book/manual/chef_recipes,
/turf/open/floor/plasteel/white,
/area/space)
"NY" = (
/obj/structure/table,
/obj/item/reagent_containers/food/snacks/energybar,
/turf/open/floor/plasteel,
/area/space)
"Pm" = (
/obj/structure/holohoop{
	dir = 4
	},
/obj/effect/turf_decal/stripes/white/line{
	dir = 8
	},
/obj/effect/decal/cleanable/dirt,
/obj/effect/turf_decal/trimline/white/line{
	dir = 4
	},
/turf/open/floor/wood,
/area/space)
"Pw" = (
/obj/effect/turf_decal/stripes/white/line{
	dir = 5
	},
/obj/effect/decal/cleanable/dirt,
/turf/open/floor/wood,
/area/space)
"PG" = (
/obj/effect/turf_decal/stripes/white/line,
/obj/effect/decal/cleanable/dirt,
/turf/open/floor/wood,
/area/space)
"PQ" = (
/obj/structure/table,
/obj/item/reagent_containers/food/drinks/drinkingglass,
/turf/open/floor/plasteel,
/area/space)
"Qg" = (
/obj/structure/table,
/obj/structure/reagent_dispensers/servingdish,
/turf/open/floor/plasteel/white,
/area/space)
"Qs" = (
/obj/structure/table,
/obj/item/storage/fancy/egg_box,
/obj/item/reagent_containers/food/condiment/flour,
/obj/item/reagent_containers/food/condiment/rice,
/turf/open/floor/plasteel/white,
/area/space)
"Rd" = (
/obj/structure/holohoop{
	dir = 8
	},
/obj/effect/turf_decal/stripes/white/line{
	dir = 4
	},
/obj/effect/decal/cleanable/dirt,
/obj/effect/turf_decal/trimline/white/line{
	dir = 8
	},
/turf/open/floor/wood,
/area/space)
"Rj" = (
/obj/effect/decal/cleanable/dirt,
/obj/effect/turf_decal/trimline/white/corner{
	dir = 4
	},
/turf/open/floor/wood,
/area/space)
"Rk" = (
/turf/open/floor/plating,
/area/space)
"RL" = (
/obj/structure/bed,
/obj/item/bedsheet/orange,
/turf/open/floor/plasteel/white,
/area/space)
"Tn" = (
/obj/machinery/door/window/brigdoor/security/cell/southright,
/turf/open/floor/plasteel/dark,
/area/space)
"UN" = (
/obj/machinery/atmospherics/pipe/heat_exchanging/simple,
/turf/open/floor/engine/airless,
/area/space)
"UO" = (
/obj/machinery/power/supermatter_crystal/engine,
/turf/open/floor/engine/airless,
/area/space)
"Vs" = (
/obj/structure/closet,
/turf/open/floor/plasteel/white,
/area/space)
"Wa" = (
/obj/machinery/atmospherics/pipe/heat_exchanging/simple{
	dir = 9
	},
/turf/open/floor/engine/airless,
/area/space)
"Wb" = (
/obj/effect/spawner/structure/window/plasma/reinforced,
/obj/machinery/atmospherics/pipe/simple/general/visible{
	dir = 6
	},
/turf/open/floor/plating,
/area/space)
"Wu" = (
/obj/machinery/door/window/southleft{
	name = "Permabrig Kitchen"
	},
/turf/open/floor/plasteel/white,
/area/space)
"Wx" = (
/obj/structure/closet/crate,
/obj/item/reagent_containers/glass/bowl,
/obj/effect/spawner/lootdrop/prison_contraband,
/obj/item/reagent_containers/glass/bowl,
/obj/item/reagent_containers/glass/bowl,
/obj/item/reagent_containers/glass/bowl,
/obj/item/reagent_containers/glass/bowl,
/obj/item/reagent_containers/glass/bowl,
/obj/item/reagent_containers/glass/bowl,
/obj/item/reagent_containers/glass/bowl,
/obj/item/kitchen/fork/plastic,
/obj/item/kitchen/fork/plastic,
/obj/item/kitchen/fork/plastic,
/obj/item/storage/box/drinkingglasses,
/obj/item/kitchen/spoon/plastic,
/obj/item/kitchen/spoon/plastic,
/obj/item/kitchen/spoon/plastic,
/obj/item/kitchen/knife/plastic,
/obj/item/kitchen/knife/plastic,
/obj/item/kitchen/knife/plastic,
/obj/item/storage/bag/tray/cafeteria,
/obj/item/storage/bag/tray/cafeteria,
/obj/item/storage/bag/tray/cafeteria,
/obj/item/storage/bag/tray/cafeteria,
/obj/item/storage/box/drinkingglasses,
/turf/open/floor/plasteel/white,
/area/space)
"WM" = (
/obj/effect/turf_decal/stripes/white/line{
	dir = 9
	},
/obj/effect/decal/cleanable/dirt,
/turf/open/floor/wood,
/area/space)
"YR" = (
/obj/machinery/atmospherics/pipe/heat_exchanging/junction{
	dir = 8
	},
/turf/open/floor/engine/airless,
/area/space)
"YV" = (
/obj/effect/turf_decal/stripes/white/line{
	dir = 1
	},
/obj/effect/decal/cleanable/dirt,
/turf/open/floor/wood,
/area/space)
"ZW" = (
/obj/structure/toilet/greyscale{
	dir = 8
	},
/turf/open/floor/plasteel/white,
/area/space)

(1,1,1) = {"
vJ
vJ
vJ
vJ
vJ
vJ
vJ
vJ
vJ
vJ
vJ
vJ
vJ
vJ
vJ
vJ
vJ
vJ
vJ
vJ
vJ
vJ
vJ
vJ
vJ
vJ
vJ
vJ
vJ
vJ
vJ
vJ
vJ
vJ
vJ
vJ
vJ
vJ
vJ
vJ
vJ
vJ
vJ
vJ
vJ
vJ
vJ
vJ
vJ
vJ
vJ
vJ
vJ
vJ
vJ
vJ
vJ
vJ
vJ
vJ
vJ
vJ
vJ
vJ
vJ
vJ
vJ
vJ
vJ
vJ
vJ
vJ
vJ
vJ
vJ
vJ
vJ
vJ
vJ
vJ
vJ
vJ
vJ
vJ
vJ
vJ
vJ
vJ
vJ
vJ
vJ
vJ
vJ
vJ
vJ
vJ
vJ
vJ
vJ
vJ
"}
(2,1,1) = {"
vJ
vJ
vJ
vJ
vJ
vJ
vJ
vJ
vJ
vJ
vJ
vJ
vJ
vJ
vJ
vJ
vJ
vJ
vJ
vJ
vJ
vJ
vJ
vJ
vJ
vJ
vJ
vJ
vJ
vJ
vJ
vJ
vJ
vJ
vJ
vJ
vJ
vJ
vJ
vJ
vJ
vJ
vJ
vJ
vJ
vJ
vJ
vJ
vJ
vJ
vJ
vJ
vJ
vJ
vJ
vJ
vJ
vJ
vJ
vJ
vJ
vJ
vJ
vJ
vJ
vJ
vJ
vJ
vJ
vJ
vJ
vJ
vJ
vJ
vJ
vJ
vJ
vJ
vJ
vJ
vJ
vJ
vJ
vJ
vJ
vJ
vJ
vJ
vJ
vJ
vJ
vJ
vJ
vJ
vJ
vJ
vJ
vJ
vJ
vJ
"}
(3,1,1) = {"
vJ
vJ
vJ
vJ
vJ
vJ
vJ
vJ
vJ
vJ
vJ
vJ
vJ
vJ
vJ
vJ
vJ
vJ
vJ
vJ
vJ
vJ
vJ
vJ
vJ
vJ
vJ
vJ
vJ
vJ
vJ
vJ
vJ
vJ
vJ
vJ
vJ
vJ
vJ
vJ
vJ
vJ
vJ
vJ
vJ
vJ
vJ
vJ
vJ
vJ
vJ
vJ
vJ
vJ
vJ
vJ
vJ
vJ
vJ
vJ
vJ
vJ
vJ
vJ
vJ
vJ
vJ
vJ
vJ
vJ
vJ
vJ
vJ
vJ
vJ
vJ
vJ
vJ
vJ
vJ
vJ
vJ
vJ
vJ
vJ
vJ
vJ
vJ
vJ
vJ
vJ
vJ
vJ
vJ
vJ
vJ
vJ
vJ
vJ
vJ
"}
(4,1,1) = {"
vJ
vJ
vJ
vJ
vJ
vJ
vJ
vJ
vJ
vJ
vJ
vJ
vJ
vJ
vJ
vJ
vJ
vJ
vJ
vJ
vJ
vJ
vJ
vJ
vJ
vJ
vJ
vJ
vJ
vJ
vJ
vJ
vJ
vJ
vJ
vJ
vJ
vJ
vJ
vJ
vJ
vJ
vJ
vJ
vJ
vJ
vJ
vJ
vJ
vJ
vJ
vJ
vJ
vJ
vJ
vJ
vJ
vJ
vJ
vJ
vJ
vJ
vJ
vJ
vJ
vJ
vJ
vJ
vJ
vJ
vJ
vJ
vJ
vJ
vJ
vJ
vJ
vJ
vJ
vJ
vJ
vJ
vJ
vJ
vJ
vJ
vJ
vJ
vJ
vJ
vJ
vJ
vJ
vJ
vJ
vJ
vJ
vJ
vJ
vJ
"}
(5,1,1) = {"
vJ
vJ
vJ
vJ
vJ
vJ
vJ
vJ
vJ
vJ
vJ
vJ
vJ
vJ
vJ
vJ
vJ
vJ
vJ
vJ
vJ
vJ
vJ
vJ
vJ
vJ
vJ
vJ
vJ
vJ
vJ
vJ
vJ
vJ
vJ
vJ
vJ
vJ
vJ
vJ
vJ
vJ
vJ
vJ
vJ
vJ
vJ
vJ
vJ
vJ
vJ
vJ
vJ
vJ
vJ
vJ
vJ
vJ
vJ
vJ
vJ
vJ
vJ
vJ
vJ
vJ
vJ
vJ
vJ
vJ
vJ
vJ
vJ
vJ
vJ
vJ
vJ
vJ
vJ
vJ
vJ
vJ
vJ
vJ
vJ
vJ
vJ
vJ
vJ
vJ
vJ
vJ
vJ
vJ
vJ
vJ
vJ
vJ
vJ
vJ
"}
(6,1,1) = {"
vJ
vJ
vJ
vJ
vJ
vJ
vJ
vJ
vJ
vJ
vJ
vJ
vJ
vJ
vJ
vJ
vJ
vJ
vJ
vJ
vJ
vJ
vJ
vJ
vJ
vJ
vJ
vJ
vJ
vJ
vJ
vJ
vJ
vJ
vJ
vJ
vJ
vJ
vJ
vJ
vJ
vJ
vJ
vJ
vJ
vJ
vJ
vJ
vJ
vJ
vJ
vJ
vJ
vJ
vJ
vJ
vJ
vJ
vJ
vJ
vJ
vJ
vJ
vJ
vJ
vJ
vJ
vJ
vJ
vJ
vJ
vJ
vJ
vJ
vJ
vJ
vJ
vJ
vJ
vJ
vJ
vJ
vJ
vJ
vJ
vJ
vJ
vJ
vJ
vJ
vJ
vJ
vJ
vJ
vJ
vJ
vJ
vJ
vJ
vJ
"}
(7,1,1) = {"
vJ
vJ
vJ
vJ
vJ
vJ
vJ
vJ
vJ
vJ
vJ
vJ
vJ
vJ
vJ
vJ
vJ
vJ
vJ
vJ
vJ
vJ
vJ
vJ
vJ
vJ
vJ
vJ
vJ
vJ
vJ
vJ
vJ
vJ
vJ
vJ
vJ
vJ
vJ
vJ
vJ
vJ
vJ
vJ
vJ
vJ
vJ
vJ
vJ
vJ
vJ
vJ
vJ
vJ
vJ
vJ
vJ
vJ
vJ
vJ
vJ
vJ
vJ
vJ
vJ
vJ
vJ
vJ
vJ
vJ
vJ
vJ
vJ
vJ
vJ
vJ
vJ
vJ
vJ
vJ
vJ
vJ
vJ
vJ
vJ
vJ
vJ
vJ
vJ
vJ
vJ
vJ
vJ
vJ
vJ
vJ
vJ
vJ
vJ
vJ
"}
(8,1,1) = {"
vJ
vJ
vJ
vJ
vJ
vJ
vJ
vJ
vJ
vJ
vJ
vJ
vJ
vJ
vJ
vJ
vJ
vJ
vJ
vJ
vJ
vJ
vJ
vJ
vJ
vJ
vJ
vJ
vJ
vJ
vJ
vJ
vJ
vJ
vJ
vJ
vJ
vJ
vJ
vJ
vJ
vJ
vJ
vJ
vJ
vJ
vJ
vJ
vJ
vJ
vJ
vJ
vJ
vJ
vJ
vJ
vJ
vJ
vJ
vJ
vJ
vJ
vJ
vJ
vJ
vJ
vJ
vJ
vJ
vJ
vJ
vJ
vJ
vJ
vJ
vJ
vJ
vJ
vJ
vJ
vJ
vJ
vJ
vJ
vJ
vJ
vJ
vJ
vJ
vJ
vJ
vJ
vJ
vJ
vJ
vJ
vJ
vJ
vJ
vJ
"}
(9,1,1) = {"
vJ
vJ
vJ
vJ
vJ
vJ
vJ
vJ
vJ
vJ
vJ
vJ
vJ
vJ
vJ
vJ
vJ
vJ
vJ
vJ
vJ
vJ
vJ
vJ
vJ
vJ
vJ
vJ
vJ
vJ
vJ
vJ
vJ
vJ
vJ
vJ
vJ
vJ
vJ
vJ
vJ
vJ
vJ
vJ
vJ
vJ
vJ
vJ
vJ
vJ
vJ
vJ
vJ
vJ
vJ
vJ
vJ
vJ
vJ
vJ
vJ
vJ
vJ
vJ
vJ
vJ
vJ
vJ
vJ
vJ
vJ
vJ
vJ
vJ
vJ
vJ
vJ
vJ
vJ
vJ
vJ
vJ
vJ
vJ
vJ
vJ
vJ
vJ
vJ
vJ
vJ
vJ
vJ
vJ
vJ
vJ
vJ
vJ
vJ
vJ
"}
(10,1,1) = {"
vJ
vJ
vJ
vJ
vJ
vJ
vJ
vJ
vJ
vJ
vJ
vJ
vJ
vJ
vJ
vJ
vJ
vJ
vJ
vJ
vJ
vJ
vJ
vJ
vJ
vJ
vJ
vJ
vJ
vJ
vJ
vJ
vJ
vJ
vJ
vJ
vJ
vJ
vJ
vJ
vJ
vJ
vJ
vJ
vJ
vJ
vJ
vJ
vJ
vJ
vJ
vJ
vJ
vJ
vJ
vJ
vJ
vJ
vJ
vJ
vJ
vJ
vJ
vJ
vJ
vJ
vJ
vJ
vJ
vJ
vJ
vJ
vJ
vJ
vJ
vJ
vJ
vJ
vJ
vJ
vJ
vJ
vJ
vJ
vJ
vJ
vJ
vJ
vJ
vJ
vJ
vJ
vJ
vJ
vJ
vJ
vJ
vJ
vJ
vJ
"}
(11,1,1) = {"
vJ
vJ
vJ
vJ
vJ
vJ
vJ
vJ
vJ
vJ
vJ
vJ
vJ
vJ
vJ
vJ
vJ
vJ
vJ
vJ
vJ
vJ
vJ
vJ
vJ
vJ
vJ
vJ
vJ
vJ
vJ
vJ
vJ
vJ
vJ
vJ
vJ
vJ
vJ
vJ
vJ
vJ
vJ
vJ
vJ
vJ
vJ
vJ
vJ
vJ
vJ
vJ
vJ
vJ
vJ
vJ
vJ
vJ
vJ
vJ
vJ
vJ
Cp
Cp
Cp
Cp
Cp
Cp
Cp
Cp
Cp
Cp
Cp
Cp
Cp
Cp
Cp
Cp
Cp
vJ
vJ
vJ
vJ
vJ
vJ
vJ
vJ
vJ
vJ
vJ
vJ
vJ
vJ
vJ
vJ
vJ
vJ
vJ
vJ
vJ
"}
(12,1,1) = {"
vJ
vJ
vJ
vJ
vJ
vJ
vJ
vJ
vJ
vJ
vJ
vJ
vJ
vJ
vJ
vJ
vJ
vJ
vJ
vJ
vJ
vJ
vJ
vJ
vJ
vJ
vJ
vJ
vJ
vJ
vJ
vJ
vJ
vJ
vJ
vJ
vJ
vJ
vJ
vJ
vJ
vJ
vJ
vJ
vJ
vJ
vJ
vJ
vJ
vJ
vJ
vJ
vJ
vJ
vJ
vJ
Cp
Cp
Cp
Cp
Cp
Cp
Cp
Rk
Rk
Rk
Rk
Rk
Rk
Rk
Rk
Rk
Rk
Rk
Rk
Rk
Rk
Rk
Cp
Cp
Cp
Cp
Cp
Cp
Cp
vJ
vJ
vJ
vJ
vJ
vJ
vJ
vJ
vJ
vJ
vJ
vJ
vJ
vJ
vJ
"}
(13,1,1) = {"
vJ
vJ
vJ
vJ
vJ
vJ
vJ
vJ
vJ
vJ
vJ
vJ
vJ
vJ
vJ
vJ
vJ
vJ
vJ
vJ
vJ
vJ
vJ
vJ
vJ
vJ
vJ
vJ
vJ
vJ
vJ
vJ
vJ
vJ
vJ
vJ
vJ
vJ
vJ
vJ
vJ
vJ
vJ
vJ
vJ
vJ
vJ
vJ
vJ
vJ
vJ
vJ
vJ
Cp
Cp
Cp
Cp
Rk
Rk
Rk
Rk
Rk
Rk
Rk
Rk
Ii
Ii
Ii
Ii
Ii
Ii
Ii
Ii
Ii
Ii
Ii
Ii
Rk
Rk
Rk
Rk
Rk
Rk
Rk
Cp
Cp
Cp
Cp
Cp
Cp
Cp
Cp
vJ
vJ
vJ
vJ
vJ
vJ
vJ
vJ
"}
(14,1,1) = {"
vJ
vJ
vJ
vJ
vJ
vJ
vJ
vJ
vJ
vJ
vJ
vJ
vJ
vJ
vJ
vJ
vJ
vJ
vJ
vJ
vJ
vJ
vJ
vJ
vJ
vJ
vJ
vJ
vJ
vJ
vJ
vJ
vJ
Cp
Cp
Cp
Cp
Cp
Cp
Cp
Cp
Cp
Cp
Cp
Cp
Cp
Cp
Cp
Cp
Cp
Cp
Cp
Cp
Cp
Rk
Rk
Rk
Rk
Rk
Rk
Rk
Rk
Rk
Rk
Ii
Ii
Gz
Gz
Gz
Gz
Gz
Gz
Gz
Gz
Gz
Gz
Ii
Ii
Ii
Ii
Ii
Ii
Ii
Rk
Rk
Rk
Rk
Rk
Rk
Rk
Rk
Cp
vJ
vJ
vJ
vJ
vJ
vJ
vJ
vJ
"}
(15,1,1) = {"
vJ
vJ
vJ
vJ
vJ
vJ
vJ
vJ
vJ
vJ
vJ
vJ
vJ
vJ
vJ
vJ
vJ
vJ
vJ
vJ
vJ
vJ
vJ
vJ
vJ
vJ
vJ
Cp
Cp
Cp
Cp
Cp
Cp
Cp
Rk
Rk
Rk
Rk
Rk
Rk
Rk
Rk
Rk
Rk
Rk
Rk
Rk
Rk
Rk
Rk
Rk
Rk
Rk
Rk
Rk
Rk
Rk
Rk
Rk
Rk
Rk
Rk
Rk
Rk
Ii
Gz
Gz
Gz
Gz
Gz
Gz
Gz
Gz
Gz
Gz
Gz
Gz
Gz
Gz
Gz
Gz
Gz
Ii
Ii
Ii
Ii
Ii
Rk
Rk
Rk
Rk
Cp
vJ
vJ
vJ
vJ
vJ
vJ
vJ
vJ
"}
(16,1,1) = {"
vJ
vJ
vJ
vJ
vJ
vJ
vJ
vJ
vJ
vJ
vJ
vJ
vJ
vJ
vJ
vJ
vJ
vJ
vJ
Cp
Cp
Cp
Cp
Cp
Cp
Cp
Cp
Cp
Rk
Rk
Rk
Rk
Rk
Rk
Rk
Ii
Ii
Ii
Ii
Ii
Ii
Ii
Ii
Ii
Ii
Ii
Ii
Ii
Ii
Ii
Ii
Ii
Ii
Ii
Ii
Ii
Rk
Rk
Rk
Rk
Rk
Rk
Rk
Rk
Ii
Gz
Gz
Gz
Gz
Gz
Gz
Gz
Gz
Gz
Gz
Gz
Gz
Gz
Gz
Gz
Gz
Gz
Gz
Gz
Gz
Gz
Ii
Rk
Rk
Rk
Rk
Cp
vJ
vJ
vJ
vJ
vJ
vJ
vJ
vJ
"}
(17,1,1) = {"
vJ
vJ
vJ
vJ
vJ
vJ
vJ
vJ
vJ
vJ
vJ
vJ
vJ
vJ
vJ
vJ
vJ
vJ
Cp
Cp
Rk
Rk
Rk
Rk
Rk
Rk
Rk
Rk
Rk
Ii
Rk
Ii
Ii
Ii
Rk
Ii
vJ
vJ
vJ
vJ
vJ
vJ
vJ
vJ
vJ
vJ
vJ
vJ
vJ
vJ
vJ
vJ
vJ
vJ
vJ
Ii
Rk
Rk
Rk
Rk
Rk
Rk
Rk
Rk
Ii
Gz
Gz
Gz
Gz
Gz
Gz
Gz
Gz
Gz
Gz
Gz
Gz
Gz
Gz
Gz
Gz
Gz
Gz
Gz
Gz
Gz
Ii
Rk
Rk
Rk
Rk
Cp
vJ
vJ
vJ
vJ
vJ
vJ
vJ
vJ
"}
(18,1,1) = {"
vJ
vJ
vJ
vJ
vJ
vJ
vJ
vJ
vJ
vJ
vJ
vJ
vJ
vJ
vJ
vJ
vJ
Cp
Cp
Rk
Rk
Ii
Ii
Ii
Ii
Ii
Ii
Ii
Ii
Ii
Rk
Rk
Ii
Gz
Gz
Ii
vJ
vJ
vJ
vJ
vJ
vJ
vJ
vJ
vJ
vJ
vJ
vJ
vJ
vJ
vJ
vJ
vJ
vJ
vJ
Ii
Rk
Rk
Rk
Rk
Rk
Rk
Rk
Rk
Ii
Gz
Gz
Gz
Gz
Gz
Gz
Gz
Gz
Gz
Gz
Gz
Gz
Gz
Gz
Gz
Gz
Gz
Gz
Gz
Gz
Gz
Ii
Rk
Rk
Rk
Rk
Cp
vJ
vJ
vJ
vJ
vJ
vJ
vJ
vJ
"}
(19,1,1) = {"
vJ
vJ
vJ
vJ
vJ
vJ
vJ
vJ
vJ
vJ
vJ
vJ
vJ
vJ
vJ
vJ
Cp
Cp
Rk
Rk
Rk
Ii
ee
ee
Gz
Gz
Gz
Gz
ee
uf
uf
Rk
Ii
Gz
Gz
Ii
vJ
vJ
vJ
vJ
vJ
vJ
vJ
vJ
vJ
vJ
vJ
vJ
vJ
vJ
vJ
vJ
vJ
vJ
vJ
Ii
Rk
Rk
Rk
Rk
Rk
Rk
Rk
Rk
Ii
Gz
Gz
Gz
Gz
Gz
Gz
Gz
Gz
Gz
Gz
Gz
Gz
Gz
Gz
Gz
Gz
Gz
Gz
Gz
Gz
Gz
Ii
Rk
Rk
Rk
Rk
Cp
vJ
vJ
vJ
vJ
vJ
vJ
vJ
vJ
"}
(20,1,1) = {"
vJ
vJ
vJ
vJ
vJ
vJ
vJ
vJ
vJ
vJ
vJ
vJ
vJ
vJ
vJ
Cp
Cp
Rk
Rk
Rk
Rk
Ii
ee
Gz
Ce
Ce
Ce
Ce
Gz
Ai
uf
Rk
Ii
Gz
Gz
Ii
Ii
Ii
Ii
Ii
Ii
Ii
Ii
Ii
Ii
Ii
Ii
Ii
Ii
Ii
Ii
Ii
Ii
Ii
Ii
Ii
Ii
Ii
Ii
Ii
Ii
Ii
Ii
Rk
Ii
Ii
Ii
Gz
Gz
Gz
Gz
Gz
Gz
Gz
Gz
Gz
Gz
Gz
Gz
Gz
Gz
Gz
Gz
Gz
Gz
Gz
Ii
Rk
Rk
Rk
Rk
Cp
vJ
vJ
vJ
vJ
vJ
vJ
vJ
vJ
"}
(21,1,1) = {"
vJ
vJ
vJ
vJ
vJ
vJ
vJ
vJ
vJ
vJ
vJ
vJ
vJ
vJ
Cp
Cp
Rk
Rk
Rk
Ii
Ii
Ii
ee
Gz
xK
xK
xK
xK
Gz
xR
uf
Rk
Ii
Gz
Gz
Ii
RL
vG
Ii
RL
Vs
Ii
RL
Vs
Ii
RL
vG
Ii
RL
Vs
Ii
RL
Vs
Ii
RL
Vs
Ii
RL
vG
Ii
RL
Vs
Ii
Gz
Gz
Gz
Ii
Gz
Ii
Ii
Ii
FL
FL
FL
Ii
Ii
Ii
Gz
Ii
Ii
Ii
FL
ee
FL
Ii
Ii
Ii
Rk
Rk
Rk
Rk
Cp
vJ
vJ
vJ
vJ
vJ
vJ
vJ
vJ
"}
(22,1,1) = {"
vJ
vJ
vJ
vJ
vJ
vJ
vJ
vJ
vJ
vJ
vJ
vJ
vJ
Cp
Cp
Rk
Rk
Rk
Rk
Ii
ee
ee
ee
Gz
zb
zb
zb
zb
Gz
ee
uf
Rk
uf
Gz
Gz
Ii
sf
GF
Ii
sf
GF
Ii
sf
GF
Ii
sf
GF
Ii
sf
GF
Ii
sf
GF
Ii
sf
GF
Ii
sf
GF
Ii
sf
GF
Ii
Gz
Gz
Gz
Ii
Ii
Ii
Cr
qo
Cr
qo
Cr
UN
qo
Ii
Ii
Ii
ee
ee
ee
ee
ee
ee
ee
Ii
Ii
Rk
Rk
Rk
Cp
vJ
vJ
vJ
vJ
vJ
vJ
vJ
vJ
"}
(23,1,1) = {"
vJ
vJ
vJ
vJ
vJ
vJ
vJ
vJ
vJ
vJ
vJ
vJ
Cp
Cp
Rk
Rk
Ii
Ii
Ii
Ii
ee
Gz
Gz
Gz
Ce
Ce
Ce
Ce
Gz
ee
uf
Rk
uf
Gz
Gz
Ii
ZW
GF
Ii
ZW
GF
Ii
ZW
GF
Ii
ZW
GF
Ii
ZW
GF
Ii
ZW
GF
Ii
ZW
GF
Ii
ZW
GF
Ii
ZW
GF
Ii
Gz
Gz
Gz
Gz
Ii
Cr
Wa
Jw
Wa
Jw
HB
dP
py
qo
Ii
ee
ee
ee
ee
ee
ee
ee
ee
ee
Ii
Rk
Rk
Cp
Cp
vJ
vJ
vJ
vJ
vJ
vJ
vJ
vJ
"}
(24,1,1) = {"
vJ
vJ
vJ
vJ
vJ
vJ
vJ
vJ
vJ
vJ
vJ
vJ
Cp
Rk
Rk
Ii
Ii
CN
Wx
ep
ee
Gz
IJ
Gz
xK
xK
PQ
xK
Gz
uf
uf
Rk
uf
Gz
Ii
Ii
gc
Dj
Ii
gc
Dj
Ii
gc
Dj
Ii
gc
Dj
Ii
gc
Dj
Ii
gc
Dj
Ii
gc
Dj
Ii
gc
Dj
Ii
gc
Dj
Ii
Gz
Gz
Gz
Gz
Ii
xc
qo
Ii
Wb
mI
vt
Ii
oN
oN
Ii
ee
ee
ee
ee
ee
ee
ee
ee
ee
Ii
Rk
Rk
Cp
vJ
vJ
vJ
vJ
vJ
vJ
vJ
vJ
vJ
"}
(25,1,1) = {"
vJ
vJ
vJ
vJ
vJ
vJ
vJ
vJ
vJ
vJ
vJ
vJ
Cp
Rk
Rk
Ii
Qg
GF
GF
rX
Gz
Gz
IJ
Gz
zb
zb
zb
zb
Gz
gc
Gz
Gz
Gz
Gz
gc
Gz
Gz
ee
Gz
Gz
ee
Gz
Gz
ee
Gz
Gz
ee
Gz
Gz
ee
Gz
Gz
ee
Gz
Gz
ee
Gz
Gz
ee
Gz
Gz
ee
Ii
Gz
Gz
Gz
Gz
Ii
YR
YR
FL
FX
FX
FX
FL
Jw
Wa
FL
ee
ee
ee
ee
ee
ee
ee
ee
ee
Ii
Rk
Rk
Cp
vJ
vJ
vJ
vJ
vJ
vJ
vJ
vJ
vJ
"}
(26,1,1) = {"
vJ
vJ
vJ
vJ
vJ
vJ
vJ
vJ
vJ
vJ
vJ
vJ
Cp
Rk
Rk
Ii
lp
GF
GF
Wu
Gz
Gz
IJ
Gz
Gz
Gz
Gz
Gz
Gz
Gz
Gz
Gz
Gz
Gz
ee
ee
ee
ee
ee
ee
ee
ee
ee
ee
ee
ee
ee
ee
ee
ee
ee
ee
ee
ee
ee
ee
ee
ee
ee
ee
ee
ee
ee
Gz
Gz
Gz
Gz
Ii
Hg
Hg
Gh
nO
UO
nO
FL
nO
nO
ee
ee
ee
ee
ee
ee
ee
ee
ee
ee
Ii
Rk
Rk
Cp
vJ
vJ
vJ
vJ
vJ
vJ
vJ
vJ
vJ
"}
(27,1,1) = {"
vJ
vJ
vJ
vJ
vJ
vJ
vJ
vJ
vJ
vJ
vJ
vJ
Cp
Rk
Rk
Ii
Qg
GF
GF
rX
Gz
Gz
IJ
Gz
Ce
Ce
Ce
Ce
Gz
gc
Gz
Gz
Gz
Gz
gc
Gz
Gz
ee
Gz
Gz
ee
Gz
Gz
ee
Gz
Gz
ee
Gz
Gz
ee
Gz
Gz
ee
Gz
Gz
ee
Gz
Gz
ee
Gz
Gz
ee
Ii
Gz
Gz
Gz
Gz
Ii
Mk
Mk
FL
iz
iz
iz
FL
Cr
qo
FL
ee
ee
ee
ee
ee
ee
ee
ee
ee
Ii
Rk
Rk
Cp
vJ
vJ
vJ
vJ
vJ
vJ
vJ
vJ
vJ
"}
(28,1,1) = {"
vJ
vJ
vJ
vJ
vJ
vJ
vJ
vJ
vJ
vJ
vJ
vJ
Cp
Rk
Rk
Ii
Ii
me
Qs
Mp
ee
Gz
IJ
Gz
xK
NY
xK
xK
Gz
uf
uf
Rk
uf
Gz
Ii
Ii
gc
fA
Ii
gc
fA
Ii
gc
fA
Ii
gc
fA
Ii
gc
fA
Ii
gc
fA
Ii
gc
fA
Ii
gc
fA
Ii
gc
fA
Ii
Gz
Gz
Gz
Gz
Ii
xc
Wa
Ii
hz
dV
vt
Ii
oN
oN
Ii
ee
ee
ee
ee
ee
ee
ee
ee
ee
Ii
Rk
Rk
Cp
vJ
vJ
vJ
vJ
vJ
vJ
vJ
vJ
vJ
"}
(29,1,1) = {"
vJ
vJ
vJ
vJ
vJ
vJ
vJ
vJ
vJ
vJ
vJ
vJ
Cp
Cp
Rk
Rk
Ii
Ii
Ii
Ii
ee
Gz
Gz
Gz
zb
zb
zb
zb
Gz
ee
uf
Rk
uf
Gz
Gz
Ii
tU
GF
Ii
tU
GF
Ii
tU
GF
Ii
tU
GF
Ii
tU
GF
Ii
tU
GF
Ii
tU
GF
Ii
tU
GF
Ii
tU
GF
Ii
Gz
Gz
Gz
Gz
Ii
Jw
qo
Cr
qo
Cr
gC
dP
py
Wa
Ii
ee
ee
ee
ee
ee
ee
ee
ee
ee
Ii
Rk
Rk
Cp
Cp
vJ
vJ
vJ
vJ
vJ
vJ
vJ
vJ
"}
(30,1,1) = {"
vJ
vJ
vJ
vJ
vJ
vJ
vJ
vJ
vJ
vJ
vJ
vJ
vJ
Cp
Cp
Rk
Rk
Rk
Rk
Ii
ee
ee
ee
Gz
Ce
Ce
Ce
Ce
Gz
ee
uf
Rk
uf
Gz
Gz
Ii
sf
GF
Ii
sf
GF
Ii
sf
GF
Ii
sf
GF
Ii
sf
GF
Ii
sf
GF
Ii
sf
GF
Ii
sf
GF
Ii
sf
GF
Ii
Gz
Gz
Gz
Gz
Ii
Ii
Jw
Wa
Jw
Wa
Jw
UN
Wa
Ii
Ii
Ii
ee
ee
ee
ee
ee
ee
ee
Ii
Ii
Rk
Rk
Rk
Cp
vJ
vJ
vJ
vJ
vJ
vJ
vJ
vJ
"}
(31,1,1) = {"
vJ
vJ
vJ
vJ
vJ
vJ
vJ
vJ
vJ
vJ
vJ
vJ
vJ
vJ
Cp
Cp
Rk
Rk
Rk
Ii
Ii
Ii
ee
Gz
xK
hI
xK
xK
Gz
ee
uf
Rk
uf
Gz
Gz
Ii
RL
Vs
Ii
RL
vG
Ii
RL
Vs
Ii
RL
Vs
Ii
RL
vG
Ii
RL
Vs
Ii
RL
vG
Ii
RL
Vs
Ii
RL
Vs
Ii
Gz
Gz
Gz
Gz
Gz
Ii
Ii
Ii
Ii
Ii
Ii
Ii
Ii
Ii
Gz
Ii
Ii
Ii
FL
ee
FL
Ii
Ii
Ii
Rk
Rk
Rk
Rk
Cp
vJ
vJ
vJ
vJ
vJ
vJ
vJ
vJ
"}
(32,1,1) = {"
vJ
vJ
vJ
vJ
vJ
vJ
vJ
vJ
vJ
vJ
vJ
vJ
vJ
vJ
vJ
Cp
Cp
Rk
Rk
Rk
Rk
Ii
jw
Gz
zb
zb
zb
zb
Gz
ee
uf
Rk
uf
Gz
Gz
Ii
Ii
Ii
Ii
Ii
Ii
Ii
Ii
Ii
Ii
Ii
Ii
Ii
Ii
Ii
Ii
Ii
Ii
Ii
Ii
Ii
Ii
Ii
Ii
Ii
Ii
Ii
Ii
Gz
Gz
Gz
Gz
Gz
Gz
Gz
gc
ry
oA
Pm
vY
Pw
Ii
Gz
Gz
Gz
Gz
Gz
Gz
Gz
Gz
Gz
Ii
Rk
Rk
Rk
Rk
Cp
vJ
vJ
vJ
vJ
vJ
vJ
vJ
vJ
"}
(33,1,1) = {"
vJ
vJ
vJ
vJ
vJ
vJ
vJ
vJ
vJ
vJ
vJ
vJ
vJ
vJ
vJ
vJ
Cp
Cp
Rk
Rk
Rk
Ii
ee
ee
Gz
Gz
Gz
Gz
ee
uf
uf
Rk
uf
Gz
Gz
Ii
vJ
vJ
vJ
vJ
vJ
vJ
vJ
vJ
vJ
vJ
vJ
vJ
vJ
vJ
vJ
vJ
vJ
vJ
vJ
Ii
Hw
ua
Hw
uf
Gz
Gz
Gz
Gz
Gz
Gz
Gz
Gz
Kc
Gz
gc
YV
cn
cn
cn
PG
Ii
Gz
Gz
Gz
Gz
Gz
Gz
Gz
Gz
Gz
Ii
Rk
Rk
Rk
Rk
Cp
vJ
vJ
vJ
vJ
vJ
vJ
vJ
vJ
"}
(34,1,1) = {"
vJ
vJ
vJ
vJ
vJ
vJ
vJ
vJ
vJ
vJ
vJ
vJ
vJ
vJ
vJ
vJ
vJ
Cp
Cp
Rk
Rk
Ii
Ii
Ii
Ii
Ii
Ii
Ii
Ii
Ii
Rk
Rk
uf
Gz
Gz
Ii
vJ
vJ
vJ
vJ
vJ
vJ
vJ
vJ
vJ
vJ
vJ
vJ
vJ
vJ
vJ
vJ
vJ
vJ
vJ
Ii
ee
ee
ee
ze
Gz
Gz
Gz
Gz
Gz
Gz
Gz
Gz
Gz
Gz
gc
YV
DM
pQ
Rj
PG
Ii
Gz
Gz
Gz
Gz
Gz
Gz
Gz
Gz
Gz
Ii
Rk
Rk
Rk
Rk
Cp
vJ
vJ
vJ
vJ
vJ
vJ
vJ
vJ
"}
(35,1,1) = {"
vJ
vJ
vJ
vJ
vJ
vJ
vJ
vJ
vJ
vJ
vJ
vJ
vJ
vJ
vJ
vJ
vJ
vJ
Cp
Cp
Rk
Rk
Rk
Rk
Rk
Rk
Rk
Rk
Rk
Ii
Rk
Ii
Ii
Ii
Rk
Ii
vJ
vJ
vJ
vJ
vJ
vJ
vJ
vJ
vJ
vJ
vJ
vJ
vJ
vJ
vJ
vJ
vJ
vJ
vJ
Ii
ee
ee
ee
Tn
Gz
Gz
Gz
Gz
Gz
Gz
Gz
Gz
Gz
Gz
ee
YV
GQ
oh
aU
PG
Ii
Gz
Gz
Gz
Gz
Gz
Gz
Gz
Gz
Gz
Ii
Rk
Rk
Rk
Rk
Cp
vJ
vJ
vJ
vJ
vJ
vJ
vJ
vJ
"}
(36,1,1) = {"
vJ
vJ
vJ
vJ
vJ
vJ
vJ
vJ
vJ
vJ
vJ
vJ
vJ
vJ
vJ
vJ
vJ
vJ
vJ
Cp
Cp
Cp
Cp
Cp
Cp
Cp
Cp
Cp
Rk
Rk
Rk
Rk
Rk
Rk
Rk
Ii
Ii
Ii
Ii
Ii
Ii
Ii
Ii
Ii
Ii
Ii
Ii
Ii
Ii
Ii
Ii
Ii
Ii
Ii
Ii
Ii
Hw
oD
Hw
uf
Gz
Gz
Gz
Gz
Gz
Gz
Gz
Gz
Gz
Gz
gc
YV
Gt
jQ
sN
PG
Ii
Gz
Gz
Gz
Gz
Gz
Gz
Gz
Gz
Gz
Ii
Rk
Rk
Rk
Rk
Cp
vJ
vJ
vJ
vJ
vJ
vJ
vJ
vJ
"}
(37,1,1) = {"
vJ
vJ
vJ
vJ
vJ
vJ
vJ
vJ
vJ
vJ
vJ
vJ
vJ
vJ
vJ
vJ
vJ
vJ
vJ
vJ
vJ
vJ
vJ
vJ
vJ
vJ
vJ
Cp
Cp
Cp
Cp
Cp
Cp
Cp
Rk
Rk
Rk
Rk
Rk
Rk
Rk
Rk
Rk
Rk
Rk
Rk
Rk
Rk
Rk
Rk
Rk
Rk
Rk
Rk
Rk
Ii
Ii
Ii
Ii
Ii
Ii
Rk
Ii
Ii
Ii
Gz
Gz
Gz
Kc
Gz
gc
YV
cn
cn
cn
PG
Ii
Gz
Gz
Gz
Gz
Gz
Ii
Ii
Ii
Ii
Ii
Rk
Rk
Rk
Rk
Cp
vJ
vJ
vJ
vJ
vJ
vJ
vJ
vJ
"}
(38,1,1) = {"
vJ
vJ
vJ
vJ
vJ
vJ
vJ
vJ
vJ
vJ
vJ
vJ
vJ
vJ
vJ
vJ
vJ
vJ
vJ
vJ
vJ
vJ
vJ
vJ
vJ
vJ
vJ
vJ
vJ
vJ
vJ
vJ
vJ
Cp
Cp
Cp
Cp
Cp
Cp
Cp
Cp
Cp
Cp
Cp
Cp
Cp
Cp
Cp
Cp
Cp
Cp
Cp
Cp
Cp
Rk
Rk
Rk
Rk
Rk
Rk
Rk
Rk
Rk
Rk
Ii
Gz
Gz
Gz
Gz
Gz
gc
yH
EC
Rd
yI
WM
Ii
Ii
Ii
Ii
Ii
Ii
Ii
Rk
Rk
Rk
Rk
Rk
Rk
Rk
Rk
Cp
vJ
vJ
vJ
vJ
vJ
vJ
vJ
vJ
"}
(39,1,1) = {"
vJ
vJ
vJ
vJ
vJ
vJ
vJ
vJ
vJ
vJ
vJ
vJ
vJ
vJ
vJ
vJ
vJ
vJ
vJ
vJ
vJ
vJ
vJ
vJ
vJ
vJ
vJ
vJ
vJ
vJ
vJ
vJ
vJ
vJ
vJ
vJ
vJ
vJ
vJ
vJ
vJ
vJ
vJ
vJ
vJ
vJ
vJ
vJ
vJ
vJ
vJ
vJ
vJ
Cp
Cp
Cp
Cp
Rk
Rk
Rk
Rk
Rk
Rk
Rk
Ii
Ii
Ii
Ii
Ii
Ii
Ii
Ii
Ii
Ii
Ii
Ii
Ii
Rk
Rk
Rk
Rk
Rk
Rk
Rk
Cp
Cp
Cp
Cp
Cp
Cp
Cp
Cp
vJ
vJ
vJ
vJ
vJ
vJ
vJ
vJ
"}
(40,1,1) = {"
vJ
vJ
vJ
vJ
vJ
vJ
vJ
vJ
vJ
vJ
vJ
vJ
vJ
vJ
vJ
vJ
vJ
vJ
vJ
vJ
vJ
vJ
vJ
vJ
vJ
vJ
vJ
vJ
vJ
vJ
vJ
vJ
vJ
vJ
vJ
vJ
vJ
vJ
vJ
vJ
vJ
vJ
vJ
vJ
vJ
vJ
vJ
vJ
vJ
vJ
vJ
vJ
vJ
vJ
vJ
vJ
Cp
Cp
Cp
Cp
Cp
Cp
Cp
Rk
Rk
Rk
Rk
Rk
Rk
Rk
Rk
Rk
Rk
Rk
Rk
Rk
Rk
Rk
Cp
Cp
Cp
Cp
Cp
Cp
Cp
vJ
vJ
vJ
vJ
vJ
vJ
vJ
vJ
vJ
vJ
vJ
vJ
vJ
vJ
vJ
"}
(41,1,1) = {"
vJ
vJ
vJ
vJ
vJ
vJ
vJ
vJ
vJ
vJ
vJ
vJ
vJ
vJ
vJ
vJ
vJ
vJ
vJ
vJ
vJ
vJ
vJ
vJ
vJ
vJ
vJ
vJ
vJ
vJ
vJ
vJ
vJ
vJ
vJ
vJ
vJ
vJ
vJ
vJ
vJ
vJ
vJ
vJ
vJ
vJ
vJ
vJ
vJ
vJ
vJ
vJ
vJ
vJ
vJ
vJ
vJ
vJ
vJ
vJ
vJ
vJ
Cp
Cp
Cp
Cp
Cp
Cp
Cp
Cp
Cp
Cp
Cp
Cp
Cp
Cp
Cp
Cp
Cp
vJ
vJ
vJ
vJ
vJ
vJ
vJ
vJ
vJ
vJ
vJ
vJ
vJ
vJ
vJ
vJ
vJ
vJ
vJ
vJ
vJ
"}
(42,1,1) = {"
vJ
vJ
vJ
vJ
vJ
vJ
vJ
vJ
vJ
vJ
vJ
vJ
vJ
vJ
vJ
vJ
vJ
vJ
vJ
vJ
vJ
vJ
vJ
vJ
vJ
vJ
vJ
vJ
vJ
vJ
vJ
vJ
vJ
vJ
vJ
vJ
vJ
vJ
vJ
vJ
vJ
vJ
vJ
vJ
vJ
vJ
vJ
vJ
vJ
vJ
vJ
vJ
vJ
vJ
vJ
vJ
vJ
vJ
vJ
vJ
vJ
vJ
vJ
vJ
vJ
vJ
vJ
vJ
vJ
vJ
vJ
vJ
vJ
vJ
vJ
vJ
vJ
vJ
vJ
vJ
vJ
vJ
vJ
vJ
vJ
vJ
vJ
vJ
vJ
vJ
vJ
vJ
vJ
vJ
vJ
vJ
vJ
vJ
vJ
vJ
"}
(43,1,1) = {"
vJ
vJ
vJ
vJ
vJ
vJ
vJ
vJ
vJ
vJ
vJ
vJ
vJ
vJ
vJ
vJ
vJ
vJ
vJ
vJ
vJ
vJ
vJ
vJ
vJ
vJ
vJ
vJ
vJ
vJ
vJ
vJ
vJ
vJ
vJ
vJ
vJ
vJ
vJ
vJ
vJ
vJ
vJ
vJ
vJ
vJ
vJ
vJ
vJ
vJ
vJ
vJ
vJ
vJ
vJ
vJ
vJ
vJ
vJ
vJ
vJ
vJ
vJ
vJ
vJ
vJ
vJ
vJ
vJ
vJ
vJ
vJ
vJ
vJ
vJ
vJ
vJ
vJ
vJ
vJ
vJ
vJ
vJ
vJ
vJ
vJ
vJ
vJ
vJ
vJ
vJ
vJ
vJ
vJ
vJ
vJ
vJ
vJ
vJ
vJ
"}
(44,1,1) = {"
vJ
vJ
vJ
vJ
vJ
vJ
vJ
vJ
vJ
vJ
vJ
vJ
vJ
vJ
vJ
vJ
vJ
vJ
vJ
vJ
vJ
vJ
vJ
vJ
vJ
vJ
vJ
vJ
vJ
vJ
vJ
vJ
vJ
vJ
vJ
vJ
vJ
vJ
vJ
vJ
vJ
vJ
vJ
vJ
vJ
vJ
vJ
vJ
vJ
vJ
vJ
vJ
vJ
vJ
vJ
vJ
vJ
vJ
vJ
vJ
vJ
vJ
vJ
vJ
vJ
vJ
vJ
vJ
vJ
vJ
vJ
vJ
vJ
vJ
vJ
vJ
vJ
vJ
vJ
vJ
vJ
vJ
vJ
vJ
vJ
vJ
vJ
vJ
vJ
vJ
vJ
vJ
vJ
vJ
vJ
vJ
vJ
vJ
vJ
vJ
"}
(45,1,1) = {"
vJ
vJ
vJ
vJ
vJ
vJ
vJ
vJ
vJ
vJ
vJ
vJ
vJ
vJ
vJ
vJ
vJ
vJ
vJ
vJ
vJ
vJ
vJ
vJ
vJ
vJ
vJ
vJ
vJ
vJ
vJ
vJ
vJ
vJ
vJ
vJ
vJ
vJ
vJ
vJ
vJ
vJ
vJ
vJ
vJ
vJ
vJ
vJ
vJ
vJ
vJ
vJ
vJ
vJ
vJ
vJ
vJ
vJ
vJ
vJ
vJ
vJ
vJ
vJ
vJ
vJ
vJ
vJ
vJ
vJ
vJ
vJ
vJ
vJ
vJ
vJ
vJ
vJ
vJ
vJ
vJ
vJ
vJ
vJ
vJ
vJ
vJ
vJ
vJ
vJ
vJ
vJ
vJ
vJ
vJ
vJ
vJ
vJ
vJ
vJ
"}
(46,1,1) = {"
vJ
vJ
vJ
vJ
vJ
vJ
vJ
vJ
vJ
vJ
vJ
vJ
vJ
vJ
vJ
vJ
vJ
vJ
vJ
vJ
vJ
vJ
vJ
vJ
vJ
vJ
vJ
vJ
vJ
vJ
vJ
vJ
vJ
vJ
vJ
vJ
vJ
vJ
vJ
vJ
vJ
vJ
vJ
vJ
vJ
vJ
vJ
vJ
vJ
vJ
vJ
vJ
vJ
vJ
vJ
vJ
vJ
vJ
vJ
vJ
vJ
vJ
vJ
vJ
vJ
vJ
vJ
vJ
vJ
vJ
vJ
vJ
vJ
vJ
vJ
vJ
vJ
vJ
vJ
vJ
vJ
vJ
vJ
vJ
vJ
vJ
vJ
vJ
vJ
vJ
vJ
vJ
vJ
vJ
vJ
vJ
vJ
vJ
vJ
vJ
"}
(47,1,1) = {"
vJ
vJ
vJ
vJ
vJ
vJ
vJ
vJ
vJ
vJ
vJ
vJ
vJ
vJ
vJ
vJ
vJ
vJ
vJ
vJ
vJ
vJ
vJ
vJ
vJ
vJ
vJ
vJ
vJ
vJ
vJ
vJ
vJ
vJ
vJ
vJ
vJ
vJ
vJ
vJ
vJ
vJ
vJ
vJ
vJ
vJ
vJ
vJ
vJ
vJ
vJ
vJ
vJ
vJ
vJ
vJ
vJ
vJ
vJ
vJ
vJ
vJ
vJ
vJ
vJ
vJ
vJ
vJ
vJ
vJ
vJ
vJ
vJ
vJ
vJ
vJ
vJ
vJ
vJ
vJ
vJ
vJ
vJ
vJ
vJ
vJ
vJ
vJ
vJ
vJ
vJ
vJ
vJ
vJ
vJ
vJ
vJ
vJ
vJ
vJ
"}
(48,1,1) = {"
vJ
vJ
vJ
vJ
vJ
vJ
vJ
vJ
vJ
vJ
vJ
vJ
vJ
vJ
vJ
vJ
vJ
vJ
vJ
vJ
vJ
vJ
vJ
vJ
vJ
vJ
vJ
vJ
vJ
vJ
vJ
vJ
vJ
vJ
vJ
vJ
vJ
vJ
vJ
vJ
vJ
vJ
vJ
vJ
vJ
vJ
vJ
vJ
vJ
vJ
vJ
vJ
vJ
vJ
vJ
vJ
vJ
vJ
vJ
vJ
vJ
vJ
vJ
vJ
vJ
vJ
vJ
vJ
vJ
vJ
vJ
vJ
vJ
vJ
vJ
vJ
vJ
vJ
vJ
vJ
vJ
vJ
vJ
vJ
vJ
vJ
vJ
vJ
vJ
vJ
vJ
vJ
vJ
vJ
vJ
vJ
vJ
vJ
vJ
vJ
"}
(49,1,1) = {"
vJ
vJ
vJ
vJ
vJ
vJ
vJ
vJ
vJ
vJ
vJ
vJ
vJ
vJ
vJ
vJ
vJ
vJ
vJ
vJ
vJ
vJ
vJ
vJ
vJ
vJ
vJ
vJ
vJ
vJ
vJ
vJ
vJ
vJ
vJ
vJ
vJ
vJ
vJ
vJ
vJ
vJ
vJ
vJ
vJ
vJ
vJ
vJ
vJ
vJ
vJ
vJ
vJ
vJ
vJ
vJ
vJ
vJ
vJ
vJ
vJ
vJ
vJ
vJ
vJ
vJ
vJ
vJ
vJ
vJ
vJ
vJ
vJ
vJ
vJ
vJ
vJ
vJ
vJ
vJ
vJ
vJ
vJ
vJ
vJ
vJ
vJ
vJ
vJ
vJ
vJ
vJ
vJ
vJ
vJ
vJ
vJ
vJ
vJ
vJ
"}
(50,1,1) = {"
vJ
vJ
vJ
vJ
vJ
vJ
vJ
vJ
vJ
vJ
vJ
vJ
vJ
vJ
vJ
vJ
vJ
vJ
vJ
vJ
vJ
vJ
vJ
vJ
vJ
vJ
vJ
vJ
vJ
vJ
vJ
vJ
vJ
vJ
vJ
vJ
vJ
vJ
vJ
vJ
vJ
vJ
vJ
vJ
vJ
vJ
vJ
vJ
vJ
vJ
vJ
vJ
vJ
vJ
vJ
vJ
vJ
vJ
vJ
vJ
vJ
vJ
vJ
vJ
vJ
vJ
vJ
vJ
vJ
vJ
vJ
vJ
vJ
vJ
vJ
vJ
vJ
vJ
vJ
vJ
vJ
vJ
vJ
vJ
vJ
vJ
vJ
vJ
vJ
vJ
vJ
vJ
vJ
vJ
vJ
vJ
vJ
vJ
vJ
vJ
"}
