//MAP CONVERTED BY dmm2tgm.py THIS HEADER COMMENT PREVENTS RECONVERSION, DO NOT REMOVE
"bl" = (
/obj/machinery/computer/message_monitor{
	dir = 8
	},
/obj/effect/turf_decal/tile/yellow{
	dir = 4
	},
/obj/effect/turf_decal/tile/yellow,
/obj/effect/turf_decal/tile/yellow{
	dir = 1
	},
/turf/open/floor/plasteel,
/area/tcommsat/computer)
"bu" = (
/obj/structure/chair/office{
	dir = 4
	},
/obj/effect/turf_decal/tile/yellow{
	dir = 4
	},
/turf/open/floor/plasteel,
/area/tcommsat/computer)
"bI" = (
/obj/effect/spawner/structure/window/reinforced,
/obj/structure/cable,
/turf/open/floor/plating,
/area/tcommsat/computer)
"cT" = (
/obj/machinery/telecomms/bus/preset_one,
/turf/open/floor/plasteel/dark/telecomms,
/area/tcommsat/server)
"cX" = (
/obj/machinery/telecomms/receiver/preset_right,
/turf/open/floor/plasteel/dark/telecomms,
/area/tcommsat/server)
"dm" = (
/turf/closed/wall/r_wall/syndicate,
/area/space)
"dP" = (
/obj/machinery/ntnet_relay,
/turf/open/floor/plasteel/dark/telecomms,
/area/tcommsat/server)
"dV" = (
/obj/structure/cable,
/obj/machinery/light,
/turf/open/floor/plasteel,
/area/tcommsat/computer)
"fa" = (
/obj/effect/turf_decal/tile/yellow,
/turf/open/floor/plasteel,
/area/tcommsat/computer)
"fH" = (
/obj/effect/turf_decal/stripes/line{
	dir = 6
	},
/turf/open/floor/plasteel,
/area/space)
"hE" = (
/obj/structure/cable,
/obj/machinery/door/airlock/engineering/glass{
	name = "Server Room";
	req_access_txt = "61"
	},
/turf/open/floor/plasteel/dark,
/area/tcommsat/computer)
"ii" = (
/obj/structure/cable/multilayer/multiz,
/turf/open/floor/plasteel,
/area/space)
"iC" = (
/obj/structure/cable,
/turf/open/floor/plasteel/dark,
/area/space)
"iF" = (
/obj/machinery/telecomms/server/presets/science,
/turf/open/floor/plasteel/dark/telecomms,
/area/tcommsat/server)
"iL" = (
/obj/effect/turf_decal/stripes/line{
	dir = 9
	},
/turf/open/floor/plasteel,
/area/space)
"jc" = (
/obj/machinery/telecomms/receiver/preset_left,
/turf/open/floor/plasteel/dark/telecomms,
/area/tcommsat/server)
"jp" = (
/obj/machinery/telecomms/bus/preset_three,
/turf/open/floor/plasteel/dark/telecomms,
/area/tcommsat/server)
"jY" = (
/turf/open/floor/plating,
/area/space)
"km" = (
/obj/effect/turf_decal/stripes/line{
	dir = 10
	},
/turf/open/floor/plasteel,
/area/space)
"mD" = (
/obj/structure/cable,
/obj/machinery/door/airlock/engineering{
	name = "Telecommunications";
	req_access_txt = "61"
	},
/obj/structure/sign/warning/securearea{
	pixel_x = -32
	},
/turf/open/floor/plasteel,
/area/tcommsat/computer)
"mG" = (
/turf/open/transparent/openspace/airless,
/area/engine/supermatter)
"np" = (
/obj/machinery/blackbox_recorder,
/turf/open/floor/plasteel/dark/telecomms,
/area/tcommsat/server)
"nq" = (
/obj/structure/lattice/catwalk,
/turf/open/transparent/openspace/airless,
/area/space)
"nG" = (
/obj/machinery/light{
	dir = 4;
	icon_state = "tube"
	},
/turf/open/floor/plasteel/dark/telecomms,
/area/tcommsat/server)
"oD" = (
/obj/effect/turf_decal/stripes/line,
/turf/open/floor/plasteel,
/area/space)
"oW" = (
/turf/open/floor/plasteel,
/area/space)
"pi" = (
/turf/open/transparent/openspace/airless,
/area/space)
"pq" = (
/obj/machinery/holopad,
/turf/open/floor/plasteel,
/area/tcommsat/computer)
"qG" = (
/obj/effect/turf_decal/stripes/line{
	dir = 1
	},
/turf/open/floor/plasteel,
/area/space)
"ri" = (
/obj/machinery/telecomms/processor/preset_one,
/turf/open/floor/plasteel/dark/telecomms,
/area/tcommsat/server)
"rz" = (
/obj/structure/cable,
/turf/open/floor/plasteel,
/area/tcommsat/computer)
"rR" = (
/obj/machinery/telecomms/server/presets/command,
/turf/open/floor/plasteel/dark/telecomms,
/area/tcommsat/server)
"si" = (
/obj/machinery/power/smes{
	charge = 5e+006
	},
/turf/open/floor/plasteel,
/area/tcommsat/computer)
"sp" = (
/turf/open/floor/circuit/telecomms/mainframe,
/area/tcommsat/server)
"sV" = (
/obj/machinery/telecomms/bus/preset_four,
/turf/open/floor/plasteel/dark/telecomms,
/area/tcommsat/server)
"tr" = (
/obj/effect/turf_decal/stripes/line{
	dir = 4
	},
/turf/open/floor/plasteel,
/area/space)
"uD" = (
/obj/machinery/computer/telecomms/monitor{
	dir = 8
	},
/obj/machinery/light_switch{
	pixel_x = 27
	},
/obj/effect/turf_decal/tile/yellow{
	dir = 4
	},
/obj/effect/turf_decal/tile/yellow,
/obj/effect/turf_decal/tile/yellow{
	dir = 8
	},
/obj/machinery/camera{
	c_tag = "Telecomms Monitoring";
	dir = 8;
	network = list("tcomms")
	},
/turf/open/floor/plasteel,
/area/tcommsat/computer)
"uL" = (
/obj/machinery/navbeacon/wayfinding/tcomms,
/turf/open/floor/plasteel,
/area/tcommsat/computer)
"xe" = (
/obj/machinery/power/terminal,
/obj/structure/cable,
/obj/structure/table,
/obj/item/book/manual/wiki/tcomms,
/obj/item/multitool,
/obj/machinery/airalarm{
	dir = 4;
	pixel_x = -23
	},
/turf/open/floor/plasteel,
/area/tcommsat/computer)
"zu" = (
/obj/machinery/telecomms/message_server/preset,
/turf/open/floor/plasteel/dark/telecomms,
/area/tcommsat/server)
"zV" = (
/obj/structure/rack,
/obj/item/storage/toolbox/mechanical{
	pixel_x = -2;
	pixel_y = -1
	},
/obj/item/radio/off,
/obj/machinery/requests_console{
	announcementConsole = 1;
	department = "Telecomms Admin";
	departmentType = 5;
	name = "Telecomms RC";
	pixel_x = 30
	},
/obj/machinery/power/apc/auto_name/south,
/obj/structure/cable,
/turf/open/floor/plasteel,
/area/tcommsat/computer)
"Ah" = (
/obj/machinery/telecomms/server/presets/common,
/turf/open/floor/plasteel/dark/telecomms,
/area/tcommsat/server)
"BR" = (
/obj/machinery/power/apc/highcap/five_k{
	areastring = "/area/tcommsat/server";
	dir = 1;
	name = "Telecomms Server APC";
	pixel_y = 23
	},
/obj/structure/cable,
/obj/machinery/light{
	dir = 1
	},
/turf/open/floor/circuit/telecomms/mainframe,
/area/tcommsat/server)
"CD" = (
/obj/machinery/telecomms/server/presets/security,
/turf/open/floor/plasteel/dark/telecomms,
/area/tcommsat/server)
"Eb" = (
/obj/machinery/telecomms/processor/preset_two,
/turf/open/floor/plasteel/dark/telecomms,
/area/tcommsat/server)
"Fc" = (
/obj/machinery/telecomms/broadcaster/preset_right,
/turf/open/floor/plasteel/dark/telecomms,
/area/tcommsat/server)
"Fq" = (
/obj/machinery/telecomms/broadcaster/preset_left,
/turf/open/floor/plasteel/dark/telecomms,
/area/tcommsat/server)
"FS" = (
/obj/structure/cable,
/turf/open/floor/circuit/telecomms/mainframe,
/area/tcommsat/server)
"Hu" = (
/obj/machinery/light{
	dir = 8
	},
/turf/open/floor/plasteel/dark/telecomms,
/area/tcommsat/server)
"ID" = (
/obj/machinery/telecomms/server/presets/service,
/turf/open/floor/plasteel/dark/telecomms,
/area/tcommsat/server)
"IP" = (
/obj/machinery/telecomms/hub/preset,
/obj/machinery/camera{
	c_tag = "Telecomms Server Room";
	dir = 4;
	network = list("tcomms")
	},
/turf/open/floor/circuit/telecomms/mainframe,
/area/tcommsat/server)
"Jg" = (
/obj/machinery/telecomms/server/presets/medical,
/turf/open/floor/plasteel/dark/telecomms,
/area/tcommsat/server)
"JB" = (
/turf/open/floor/plasteel,
/area/tcommsat/computer)
"Lb" = (
/obj/structure/shuttle/engine/huge,
/turf/closed/wall/r_wall,
/area/space)
"Lv" = (
/obj/machinery/announcement_system,
/obj/item/radio/intercom{
	dir = 8;
	freerange = 1;
	name = "Station Intercom (Telecomms)";
	pixel_x = -26
	},
/turf/open/floor/plasteel,
/area/tcommsat/computer)
"LH" = (
/turf/closed/wall/r_wall,
/area/space)
"Mf" = (
/obj/effect/turf_decal/stripes/line{
	dir = 1
	},
/obj/structure/cable,
/turf/open/floor/plasteel,
/area/space)
"Mq" = (
/obj/machinery/telecomms/processor/preset_three,
/turf/open/floor/plasteel/dark/telecomms,
/area/tcommsat/server)
"Nd" = (
/turf/open/floor/plasteel/dark,
/area/space)
"Nz" = (
/obj/machinery/telecomms/server/presets/supply,
/turf/open/floor/plasteel/dark/telecomms,
/area/tcommsat/server)
"NC" = (
/turf/open/floor/plasteel/dark/telecomms,
/area/tcommsat/server)
"Oc" = (
/obj/structure/shuttle/engine/heater,
/turf/open/floor/plating,
/area/space)
"Oo" = (
/turf/open/floor/engine/hull/reinforced,
/area/space)
"OC" = (
/turf/closed/wall/r_wall,
/area/tcommsat/computer)
"OI" = (
/obj/machinery/telecomms/server/presets/engineering,
/turf/open/floor/plasteel/dark/telecomms,
/area/tcommsat/server)
"Ps" = (
/obj/machinery/telecomms/bus/preset_two,
/turf/open/floor/plasteel/dark/telecomms,
/area/tcommsat/server)
"PN" = (
/turf/closed/wall/r_wall,
/area/engine/supermatter)
"RD" = (
/obj/machinery/telecomms/processor/preset_four,
/obj/structure/sign/warning/nosmoking{
	pixel_y = 28
	},
/turf/open/floor/plasteel/dark/telecomms,
/area/tcommsat/server)
"Uw" = (
/obj/effect/turf_decal/stripes/line{
	dir = 5
	},
/turf/open/floor/plasteel,
/area/space)
"Vi" = (
/obj/effect/turf_decal/stripes/line{
	dir = 8
	},
/turf/open/floor/plasteel,
/area/space)
"VU" = (
/obj/structure/closet/emcloset,
/turf/open/floor/plasteel/dark,
/area/tcommsat/computer)
"Xp" = (
/obj/effect/spawner/structure/window/plasma/reinforced,
/turf/open/floor/plating,
/area/engine/supermatter)
"Xz" = (
/obj/structure/ladder,
/obj/effect/turf_decal/bot{
	dir = 1
	},
/turf/open/floor/plasteel,
/area/space)
"XV" = (
/obj/structure/cable,
/obj/effect/spawner/structure/window/reinforced,
/turf/open/floor/plating,
/area/tcommsat/computer)
"Zr" = (
/turf/closed/wall/r_wall,
/area/tcommsat/server)

(1,1,1) = {"
pi
pi
pi
pi
pi
pi
pi
pi
pi
pi
pi
pi
pi
pi
pi
pi
pi
pi
pi
pi
pi
pi
pi
pi
pi
pi
pi
pi
pi
pi
pi
pi
pi
pi
pi
pi
pi
pi
pi
pi
pi
pi
pi
pi
pi
pi
pi
pi
pi
pi
pi
pi
pi
pi
pi
pi
pi
pi
pi
pi
pi
pi
pi
pi
pi
pi
pi
pi
pi
pi
pi
pi
pi
pi
pi
pi
pi
pi
pi
pi
pi
pi
pi
pi
pi
pi
pi
pi
pi
pi
pi
pi
pi
pi
pi
pi
pi
pi
pi
pi
"}
(2,1,1) = {"
pi
pi
pi
pi
pi
pi
pi
pi
pi
pi
pi
pi
pi
pi
pi
pi
pi
pi
pi
pi
pi
pi
pi
pi
pi
pi
pi
pi
pi
pi
pi
pi
pi
pi
pi
pi
pi
pi
pi
pi
pi
pi
pi
pi
pi
pi
pi
pi
pi
pi
pi
pi
pi
pi
pi
pi
pi
pi
pi
pi
pi
pi
pi
pi
pi
pi
pi
pi
pi
pi
pi
pi
pi
pi
pi
pi
pi
pi
pi
pi
pi
pi
pi
pi
pi
pi
pi
pi
pi
pi
pi
pi
pi
pi
pi
pi
pi
pi
pi
pi
"}
(3,1,1) = {"
pi
pi
pi
pi
pi
pi
pi
pi
pi
pi
pi
pi
pi
pi
pi
pi
pi
pi
pi
pi
pi
pi
pi
pi
pi
pi
pi
pi
pi
pi
pi
pi
pi
pi
pi
pi
pi
pi
pi
pi
pi
pi
pi
pi
pi
pi
pi
pi
pi
pi
pi
pi
pi
pi
pi
pi
pi
pi
pi
pi
pi
pi
pi
pi
pi
pi
pi
pi
pi
pi
pi
pi
pi
pi
pi
pi
pi
pi
pi
pi
pi
pi
pi
pi
pi
pi
pi
pi
pi
pi
pi
pi
pi
pi
pi
pi
pi
pi
pi
pi
"}
(4,1,1) = {"
pi
pi
pi
pi
pi
pi
pi
pi
pi
pi
pi
pi
pi
pi
pi
pi
pi
pi
pi
pi
pi
pi
pi
pi
pi
pi
pi
pi
pi
pi
pi
pi
pi
pi
pi
pi
pi
pi
pi
pi
pi
pi
pi
pi
pi
pi
pi
pi
pi
pi
pi
pi
pi
pi
pi
pi
pi
pi
pi
pi
pi
pi
pi
pi
pi
pi
pi
pi
pi
pi
pi
pi
pi
pi
pi
pi
pi
pi
pi
pi
pi
pi
pi
pi
pi
pi
pi
pi
pi
pi
pi
pi
pi
pi
pi
pi
pi
pi
pi
pi
"}
(5,1,1) = {"
pi
pi
pi
pi
pi
pi
pi
pi
pi
pi
pi
pi
pi
pi
pi
pi
pi
pi
pi
pi
pi
pi
pi
pi
pi
pi
pi
pi
pi
pi
pi
pi
pi
pi
pi
pi
pi
pi
pi
pi
pi
pi
pi
pi
pi
pi
pi
pi
pi
pi
pi
pi
pi
pi
pi
pi
pi
pi
pi
pi
pi
pi
pi
pi
pi
pi
pi
pi
pi
pi
pi
pi
pi
pi
pi
pi
pi
pi
pi
pi
pi
pi
pi
pi
pi
pi
pi
pi
pi
pi
pi
pi
pi
pi
pi
pi
pi
pi
pi
pi
"}
(6,1,1) = {"
pi
pi
pi
pi
pi
pi
pi
pi
pi
pi
pi
pi
pi
pi
pi
pi
pi
pi
pi
pi
pi
pi
pi
pi
pi
pi
pi
pi
pi
pi
pi
pi
pi
pi
pi
pi
pi
pi
pi
pi
pi
pi
pi
pi
pi
pi
pi
pi
pi
pi
pi
pi
pi
pi
pi
pi
pi
pi
pi
pi
pi
pi
pi
pi
pi
pi
pi
pi
pi
pi
pi
pi
pi
pi
pi
pi
pi
pi
pi
pi
pi
pi
pi
pi
pi
pi
pi
pi
pi
pi
pi
pi
pi
pi
pi
pi
pi
pi
pi
pi
"}
(7,1,1) = {"
pi
pi
pi
pi
pi
pi
pi
pi
pi
pi
pi
pi
pi
pi
pi
pi
pi
pi
pi
pi
pi
pi
pi
pi
pi
pi
pi
pi
pi
pi
pi
pi
pi
pi
pi
pi
pi
pi
pi
pi
pi
pi
pi
pi
pi
pi
pi
pi
pi
pi
pi
pi
pi
pi
pi
pi
pi
pi
pi
pi
pi
pi
pi
pi
pi
pi
pi
pi
pi
pi
pi
pi
pi
pi
pi
pi
pi
pi
pi
pi
pi
pi
pi
pi
pi
pi
pi
pi
pi
pi
pi
pi
pi
pi
pi
pi
pi
pi
pi
pi
"}
(8,1,1) = {"
pi
pi
pi
pi
pi
pi
pi
pi
pi
pi
pi
pi
pi
pi
pi
pi
pi
pi
pi
pi
pi
pi
pi
pi
pi
pi
pi
pi
pi
pi
pi
pi
pi
pi
pi
pi
pi
pi
pi
pi
pi
pi
pi
pi
pi
pi
pi
pi
pi
pi
pi
pi
pi
pi
pi
pi
pi
pi
pi
pi
pi
pi
pi
pi
pi
pi
pi
pi
pi
pi
pi
pi
pi
pi
pi
pi
pi
pi
pi
pi
pi
pi
pi
pi
pi
pi
pi
pi
pi
pi
pi
pi
pi
pi
pi
pi
pi
pi
pi
pi
"}
(9,1,1) = {"
pi
pi
pi
pi
pi
pi
pi
pi
pi
pi
pi
pi
pi
pi
pi
pi
pi
pi
pi
pi
pi
pi
pi
pi
pi
pi
pi
pi
pi
pi
pi
pi
pi
pi
pi
pi
pi
pi
pi
pi
pi
pi
pi
pi
pi
pi
pi
pi
pi
pi
pi
pi
pi
pi
pi
pi
pi
pi
pi
pi
pi
pi
pi
pi
pi
pi
pi
pi
pi
pi
pi
pi
pi
pi
pi
pi
pi
pi
pi
pi
pi
pi
pi
pi
pi
pi
pi
pi
pi
pi
pi
pi
pi
pi
pi
pi
pi
pi
pi
pi
"}
(10,1,1) = {"
pi
pi
pi
pi
pi
pi
pi
pi
pi
pi
pi
pi
pi
pi
pi
pi
pi
pi
pi
pi
pi
pi
pi
pi
pi
pi
pi
pi
pi
pi
pi
pi
pi
pi
pi
pi
pi
pi
pi
pi
pi
pi
pi
pi
pi
pi
pi
pi
pi
pi
pi
pi
pi
pi
pi
pi
pi
pi
pi
pi
pi
pi
pi
pi
pi
pi
pi
pi
pi
pi
pi
pi
pi
pi
pi
pi
pi
pi
pi
pi
pi
pi
pi
pi
pi
pi
pi
pi
pi
pi
pi
pi
pi
pi
pi
pi
pi
pi
pi
pi
"}
(11,1,1) = {"
pi
pi
pi
pi
pi
pi
pi
pi
pi
pi
pi
pi
pi
pi
pi
pi
pi
pi
pi
pi
pi
pi
pi
pi
pi
pi
pi
pi
pi
pi
pi
pi
pi
pi
pi
pi
pi
pi
pi
pi
pi
pi
pi
pi
pi
pi
pi
pi
pi
pi
pi
pi
pi
pi
pi
pi
pi
pi
pi
pi
pi
pi
Oo
Oo
Oo
Oo
Oo
Oo
Oo
Oo
Oo
Oo
Oo
Oo
Oo
Oo
Oo
Oo
Oo
pi
pi
pi
pi
pi
pi
pi
pi
pi
pi
pi
pi
pi
pi
pi
pi
pi
pi
pi
pi
pi
"}
(12,1,1) = {"
pi
pi
pi
pi
pi
pi
pi
pi
pi
pi
pi
pi
pi
pi
pi
pi
pi
pi
pi
pi
pi
pi
pi
pi
pi
pi
pi
pi
pi
pi
pi
pi
pi
pi
pi
pi
pi
pi
pi
pi
pi
pi
pi
pi
pi
pi
pi
pi
pi
pi
pi
pi
pi
pi
pi
pi
Oo
Oo
Oo
Oo
Oo
Oo
Oo
dm
dm
dm
dm
dm
dm
dm
dm
dm
dm
dm
dm
dm
dm
dm
Oo
Oo
Oo
Oo
Oo
Oo
Oo
pi
pi
pi
pi
pi
pi
pi
pi
pi
pi
pi
pi
pi
pi
pi
"}
(13,1,1) = {"
pi
pi
pi
pi
pi
pi
pi
pi
pi
pi
pi
pi
pi
pi
pi
pi
pi
pi
pi
pi
pi
pi
pi
pi
pi
pi
pi
pi
pi
pi
pi
pi
pi
pi
pi
pi
pi
pi
pi
pi
pi
pi
pi
pi
pi
pi
pi
pi
pi
pi
pi
pi
pi
Oo
Oo
Oo
Oo
dm
dm
dm
dm
dm
dm
dm
jY
jY
jY
jY
jY
jY
jY
jY
jY
jY
jY
jY
jY
dm
dm
dm
dm
dm
dm
dm
Oo
Oo
Oo
Oo
Oo
Oo
Oo
Oo
pi
pi
pi
pi
pi
pi
pi
pi
"}
(14,1,1) = {"
pi
pi
pi
pi
pi
pi
pi
pi
pi
pi
pi
pi
pi
pi
pi
pi
pi
pi
pi
pi
pi
pi
pi
pi
pi
pi
pi
pi
pi
pi
pi
pi
pi
Oo
Oo
Oo
Oo
Oo
Oo
Oo
Oo
Oo
Oo
Oo
Oo
Oo
Oo
Oo
Oo
Oo
Oo
Oo
Oo
Oo
dm
dm
dm
dm
jY
jY
jY
jY
jY
jY
jY
Zr
Zr
Zr
Zr
Zr
Zr
Zr
Zr
OC
OC
OC
jY
jY
jY
jY
jY
jY
jY
dm
dm
dm
dm
dm
dm
dm
dm
Oo
pi
pi
pi
pi
pi
pi
pi
pi
"}
(15,1,1) = {"
pi
pi
pi
pi
pi
pi
pi
pi
pi
pi
pi
pi
pi
pi
pi
pi
pi
pi
pi
pi
pi
pi
pi
pi
pi
pi
pi
Oo
Oo
Oo
Oo
Oo
Oo
Oo
dm
dm
dm
dm
dm
dm
dm
dm
dm
Oo
Oo
Oo
Oo
Oo
dm
dm
dm
dm
dm
dm
dm
jY
jY
jY
jY
LH
LH
LH
LH
Zr
Zr
Zr
zu
NC
IP
Hu
np
NC
dP
bI
Lv
OC
OC
OC
LH
LH
LH
LH
jY
LH
LH
LH
LH
LH
LH
LH
dm
Oo
pi
pi
pi
pi
pi
pi
pi
pi
"}
(16,1,1) = {"
pi
pi
pi
pi
pi
pi
pi
pi
pi
pi
pi
pi
pi
pi
pi
pi
pi
pi
pi
Oo
Oo
Oo
Oo
Oo
Oo
Oo
Oo
Oo
dm
dm
dm
dm
dm
dm
dm
jY
jY
jY
jY
jY
jY
jY
dm
Oo
Oo
Oo
Oo
Oo
dm
jY
jY
jY
jY
jY
jY
jY
LH
LH
LH
LH
oW
oW
oW
Zr
sV
NC
OI
NC
sp
NC
ID
NC
Ps
bI
rz
xe
si
OC
Nd
Nd
Nd
Nd
Nd
iL
Vi
km
nq
nq
nq
LH
dm
Oo
pi
pi
pi
pi
pi
pi
pi
pi
"}
(17,1,1) = {"
pi
pi
pi
pi
pi
pi
pi
pi
pi
pi
pi
pi
pi
pi
pi
pi
pi
pi
Oo
Oo
dm
dm
dm
dm
dm
dm
dm
dm
dm
jY
jY
jY
jY
jY
jY
jY
LH
LH
LH
LH
LH
jY
dm
Oo
Oo
Oo
Oo
Oo
dm
jY
LH
LH
LH
LH
LH
LH
LH
oW
oW
oW
oW
oW
oW
Zr
RD
NC
Ah
Fc
sp
Fq
Nz
NC
Eb
XV
JB
JB
dV
OC
Nd
Nd
Nd
Nd
Nd
qG
Xz
oD
Oc
jY
jY
Lb
dm
Oo
pi
pi
pi
pi
pi
pi
pi
pi
"}
(18,1,1) = {"
pi
pi
pi
pi
pi
pi
pi
pi
pi
pi
pi
pi
pi
pi
pi
pi
pi
Oo
Oo
dm
dm
oW
jY
jY
jY
jY
jY
jY
jY
jY
LH
LH
LH
LH
LH
LH
LH
oW
oW
oW
LH
jY
dm
dm
dm
dm
dm
dm
dm
jY
LH
oW
oW
oW
oW
oW
oW
oW
oW
oW
oW
oW
oW
Zr
BR
FS
FS
FS
FS
FS
FS
FS
FS
hE
pq
uL
rz
mD
iC
iC
iC
iC
iC
Mf
ii
oD
Oc
jY
jY
LH
dm
Oo
pi
pi
pi
pi
pi
pi
pi
pi
"}
(19,1,1) = {"
pi
pi
pi
pi
pi
pi
pi
pi
pi
pi
pi
pi
pi
pi
pi
pi
Oo
Oo
dm
dm
oW
oW
LH
jY
LH
LH
LH
LH
LH
LH
LH
oW
oW
oW
oW
oW
oW
oW
oW
oW
LH
jY
jY
jY
jY
jY
jY
jY
jY
jY
LH
oW
oW
oW
oW
oW
oW
oW
oW
oW
oW
oW
oW
Zr
Mq
NC
CD
cX
sp
jc
Jg
NC
ri
bI
bu
fa
zV
OC
Nd
Nd
Nd
Nd
Nd
qG
Xz
oD
Oc
jY
jY
LH
dm
Oo
pi
pi
pi
pi
pi
pi
pi
pi
"}
(20,1,1) = {"
pi
pi
pi
pi
pi
pi
pi
pi
pi
pi
pi
pi
pi
pi
pi
Oo
Oo
dm
dm
oW
oW
oW
LH
LH
LH
oW
oW
oW
oW
oW
oW
oW
oW
oW
oW
oW
oW
oW
oW
oW
LH
jY
LH
LH
LH
LH
LH
LH
LH
jY
LH
oW
oW
oW
oW
oW
oW
oW
oW
oW
oW
oW
oW
Zr
jp
NC
rR
NC
sp
nG
iF
NC
cT
bI
bl
uD
OC
OC
Nd
Nd
Nd
Nd
Nd
Uw
tr
fH
nq
nq
nq
LH
dm
Oo
pi
pi
pi
pi
pi
pi
pi
pi
"}
(21,1,1) = {"
pi
pi
pi
pi
pi
pi
pi
pi
pi
pi
pi
pi
pi
pi
Oo
Oo
dm
dm
oW
oW
oW
oW
oW
LH
oW
oW
oW
oW
oW
oW
oW
oW
oW
oW
oW
oW
oW
oW
oW
oW
oW
oW
oW
oW
oW
oW
oW
oW
oW
oW
oW
oW
oW
oW
oW
oW
oW
oW
oW
oW
oW
oW
oW
Zr
Zr
Zr
Zr
Zr
PN
PN
Xp
Xp
PN
Xp
Xp
PN
PN
VU
Nd
Nd
Nd
LH
LH
LH
LH
LH
LH
LH
LH
LH
dm
Oo
pi
pi
pi
pi
pi
pi
pi
pi
"}
(22,1,1) = {"
pi
pi
pi
pi
pi
pi
pi
pi
pi
pi
pi
pi
pi
Oo
Oo
dm
dm
oW
oW
oW
oW
oW
oW
LH
oW
oW
oW
oW
oW
oW
oW
oW
oW
oW
oW
oW
oW
oW
oW
oW
oW
oW
oW
oW
oW
oW
oW
oW
oW
oW
oW
oW
oW
oW
oW
oW
oW
oW
oW
oW
oW
oW
oW
LH
Nd
Nd
Nd
PN
PN
mG
mG
mG
mG
mG
mG
mG
PN
PN
Nd
Nd
LH
LH
dm
dm
dm
dm
dm
dm
dm
dm
dm
Oo
pi
pi
pi
pi
pi
pi
pi
pi
"}
(23,1,1) = {"
pi
pi
pi
pi
pi
pi
pi
pi
pi
pi
pi
pi
Oo
Oo
dm
dm
oW
oW
oW
oW
oW
oW
oW
LH
oW
oW
oW
oW
oW
oW
oW
oW
oW
oW
oW
oW
oW
oW
LH
LH
jY
jY
jY
jY
jY
jY
jY
jY
jY
jY
LH
LH
LH
oW
oW
oW
oW
oW
oW
oW
oW
oW
oW
LH
Nd
Nd
Nd
PN
mG
mG
mG
mG
mG
mG
mG
mG
mG
PN
Nd
Nd
LH
dm
dm
Oo
Oo
Oo
Oo
Oo
Oo
Oo
Oo
Oo
pi
pi
pi
pi
pi
pi
pi
pi
"}
(24,1,1) = {"
pi
pi
pi
pi
pi
pi
pi
pi
pi
pi
pi
pi
Oo
dm
dm
oW
oW
oW
oW
oW
oW
oW
oW
LH
oW
oW
oW
oW
oW
oW
oW
oW
oW
oW
LH
LH
LH
LH
LH
pi
pi
pi
pi
pi
pi
pi
pi
pi
pi
pi
pi
pi
LH
LH
LH
LH
LH
LH
LH
LH
LH
LH
LH
LH
Nd
Nd
Nd
Xp
mG
mG
PN
Xp
Xp
Xp
PN
mG
mG
Xp
Nd
Nd
LH
dm
Oo
Oo
Oo
Oo
Oo
Oo
Oo
Oo
Oo
pi
pi
pi
pi
pi
pi
pi
pi
pi
"}
(25,1,1) = {"
pi
pi
pi
pi
pi
pi
pi
pi
pi
pi
pi
pi
Oo
dm
oW
oW
oW
oW
oW
oW
oW
oW
oW
LH
oW
oW
oW
oW
oW
oW
oW
oW
oW
LH
LH
pi
pi
pi
pi
pi
pi
pi
pi
pi
pi
pi
pi
pi
pi
pi
pi
pi
pi
pi
pi
pi
pi
pi
pi
pi
pi
pi
pi
LH
LH
Nd
Nd
Xp
mG
mG
Xp
mG
mG
mG
Xp
mG
mG
Xp
Nd
Nd
LH
dm
Oo
Oo
Oo
Oo
Oo
Oo
Oo
Oo
Oo
pi
pi
pi
pi
pi
pi
pi
pi
pi
"}
(26,1,1) = {"
pi
pi
pi
pi
pi
pi
pi
pi
pi
pi
pi
pi
Oo
dm
oW
oW
oW
oW
oW
oW
oW
oW
oW
oW
oW
oW
oW
oW
oW
oW
oW
oW
oW
LH
pi
pi
pi
pi
pi
pi
pi
pi
pi
pi
pi
pi
pi
pi
pi
pi
pi
pi
pi
pi
pi
pi
pi
pi
pi
pi
pi
pi
pi
pi
LH
Nd
Nd
PN
mG
mG
Xp
mG
mG
mG
Xp
mG
mG
PN
Nd
Nd
LH
dm
Oo
Oo
Oo
Oo
Oo
Oo
Oo
Oo
Oo
pi
pi
pi
pi
pi
pi
pi
pi
pi
"}
(27,1,1) = {"
pi
pi
pi
pi
pi
pi
pi
pi
pi
pi
pi
pi
Oo
dm
oW
oW
oW
oW
oW
oW
oW
oW
oW
LH
oW
oW
oW
oW
oW
oW
oW
oW
oW
LH
LH
pi
pi
pi
pi
pi
pi
pi
pi
pi
pi
pi
pi
pi
pi
pi
pi
pi
pi
pi
pi
pi
pi
pi
pi
pi
pi
pi
pi
LH
LH
Nd
Nd
Xp
mG
mG
Xp
mG
mG
mG
Xp
mG
mG
Xp
Nd
Nd
LH
dm
Oo
Oo
Oo
Oo
Oo
Oo
Oo
Oo
Oo
pi
pi
pi
pi
pi
pi
pi
pi
pi
"}
(28,1,1) = {"
pi
pi
pi
pi
pi
pi
pi
pi
pi
pi
pi
pi
Oo
dm
dm
oW
oW
oW
oW
oW
oW
oW
oW
LH
oW
oW
oW
oW
oW
oW
oW
oW
oW
oW
LH
LH
LH
LH
LH
pi
pi
pi
pi
pi
pi
pi
pi
pi
pi
pi
pi
pi
LH
LH
LH
LH
LH
LH
LH
LH
LH
LH
LH
LH
Nd
Nd
Nd
Xp
mG
mG
PN
Xp
Xp
Xp
PN
mG
mG
Xp
Nd
Nd
LH
dm
Oo
Oo
Oo
Oo
Oo
Oo
Oo
Oo
Oo
pi
pi
pi
pi
pi
pi
pi
pi
pi
"}
(29,1,1) = {"
pi
pi
pi
pi
pi
pi
pi
pi
pi
pi
pi
pi
Oo
Oo
dm
dm
oW
oW
oW
oW
oW
oW
oW
LH
oW
oW
oW
oW
oW
oW
oW
oW
oW
oW
oW
oW
oW
oW
LH
LH
jY
jY
jY
jY
jY
jY
jY
jY
jY
jY
LH
LH
LH
oW
oW
oW
oW
oW
oW
oW
oW
oW
oW
LH
Nd
Nd
Nd
PN
mG
mG
mG
mG
mG
mG
mG
mG
mG
PN
Nd
Nd
LH
dm
dm
Oo
Oo
Oo
Oo
Oo
Oo
Oo
Oo
Oo
pi
pi
pi
pi
pi
pi
pi
pi
"}
(30,1,1) = {"
pi
pi
pi
pi
pi
pi
pi
pi
pi
pi
pi
pi
pi
Oo
Oo
dm
dm
oW
oW
oW
oW
oW
oW
LH
oW
oW
oW
oW
oW
oW
oW
oW
oW
oW
oW
oW
oW
oW
oW
oW
oW
oW
oW
oW
oW
oW
oW
oW
oW
oW
oW
oW
oW
oW
oW
oW
oW
oW
oW
oW
oW
oW
oW
LH
Nd
Nd
Nd
PN
PN
mG
mG
mG
mG
mG
mG
mG
PN
PN
Nd
Nd
LH
LH
dm
dm
dm
dm
dm
dm
dm
dm
dm
Oo
pi
pi
pi
pi
pi
pi
pi
pi
"}
(31,1,1) = {"
pi
pi
pi
pi
pi
pi
pi
pi
pi
pi
pi
pi
pi
pi
Oo
Oo
dm
dm
oW
oW
oW
oW
oW
LH
oW
oW
oW
oW
oW
oW
oW
oW
oW
oW
oW
oW
oW
oW
oW
oW
oW
oW
oW
oW
oW
oW
oW
oW
oW
oW
oW
oW
oW
oW
oW
oW
oW
oW
oW
oW
oW
oW
oW
LH
Nd
Nd
Nd
Nd
PN
PN
Xp
Xp
PN
Xp
Xp
PN
PN
Nd
Nd
Nd
Nd
LH
LH
LH
LH
LH
LH
LH
LH
LH
dm
Oo
pi
pi
pi
pi
pi
pi
pi
pi
"}
(32,1,1) = {"
pi
pi
pi
pi
pi
pi
pi
pi
pi
pi
pi
pi
pi
pi
pi
Oo
Oo
dm
dm
oW
oW
oW
LH
LH
LH
oW
oW
oW
oW
oW
oW
oW
oW
oW
oW
oW
oW
oW
oW
oW
LH
jY
LH
LH
LH
LH
LH
LH
LH
jY
LH
oW
oW
oW
oW
oW
oW
oW
oW
oW
oW
oW
oW
LH
Nd
Nd
Nd
Nd
Nd
Nd
Nd
Nd
Nd
Nd
Nd
Nd
Nd
Nd
Nd
Nd
Nd
Nd
Nd
Nd
Nd
Nd
nq
nq
nq
LH
dm
Oo
pi
pi
pi
pi
pi
pi
pi
pi
"}
(33,1,1) = {"
pi
pi
pi
pi
pi
pi
pi
pi
pi
pi
pi
pi
pi
pi
pi
pi
Oo
Oo
dm
dm
oW
oW
LH
jY
LH
LH
LH
LH
LH
LH
LH
oW
oW
oW
oW
oW
oW
oW
oW
oW
LH
jY
jY
jY
jY
jY
jY
jY
jY
jY
LH
oW
oW
oW
oW
oW
oW
oW
oW
oW
oW
oW
oW
LH
LH
Nd
Nd
Nd
Nd
Nd
Nd
Nd
Nd
Nd
Nd
Nd
Nd
Nd
Nd
Nd
Nd
Nd
Nd
Nd
Nd
Nd
Oc
jY
jY
Lb
dm
Oo
pi
pi
pi
pi
pi
pi
pi
pi
"}
(34,1,1) = {"
pi
pi
pi
pi
pi
pi
pi
pi
pi
pi
pi
pi
pi
pi
pi
pi
pi
Oo
Oo
dm
dm
oW
jY
jY
jY
jY
jY
jY
jY
jY
LH
LH
LH
LH
LH
LH
LH
oW
oW
oW
LH
jY
dm
dm
dm
dm
dm
dm
dm
jY
LH
oW
oW
oW
oW
oW
oW
oW
oW
oW
oW
oW
oW
oW
LH
LH
LH
LH
LH
LH
LH
LH
LH
LH
LH
LH
Nd
Nd
Nd
Nd
Nd
Nd
Nd
Nd
Nd
Nd
Oc
jY
jY
LH
dm
Oo
pi
pi
pi
pi
pi
pi
pi
pi
"}
(35,1,1) = {"
pi
pi
pi
pi
pi
pi
pi
pi
pi
pi
pi
pi
pi
pi
pi
pi
pi
pi
Oo
Oo
dm
dm
dm
dm
dm
dm
dm
dm
dm
jY
jY
jY
jY
jY
jY
jY
LH
LH
LH
LH
LH
jY
dm
Oo
Oo
Oo
Oo
Oo
dm
jY
LH
LH
LH
LH
LH
LH
LH
oW
oW
oW
oW
oW
oW
oW
oW
oW
oW
oW
oW
oW
oW
oW
oW
oW
oW
LH
LH
Nd
Nd
Nd
Nd
Nd
Nd
Nd
Nd
Nd
Oc
jY
jY
LH
dm
Oo
pi
pi
pi
pi
pi
pi
pi
pi
"}
(36,1,1) = {"
pi
pi
pi
pi
pi
pi
pi
pi
pi
pi
pi
pi
pi
pi
pi
pi
pi
pi
pi
Oo
Oo
Oo
Oo
Oo
Oo
Oo
Oo
Oo
dm
dm
dm
dm
dm
dm
dm
jY
jY
jY
jY
jY
jY
jY
dm
Oo
Oo
Oo
Oo
Oo
dm
jY
jY
jY
jY
jY
jY
jY
LH
LH
LH
LH
oW
oW
oW
oW
oW
oW
oW
oW
oW
oW
oW
oW
oW
oW
oW
oW
LH
Nd
Nd
Nd
Nd
Nd
Nd
Nd
Nd
Nd
nq
nq
nq
LH
dm
Oo
pi
pi
pi
pi
pi
pi
pi
pi
"}
(37,1,1) = {"
pi
pi
pi
pi
pi
pi
pi
pi
pi
pi
pi
pi
pi
pi
pi
pi
pi
pi
pi
pi
pi
pi
pi
pi
pi
pi
pi
Oo
Oo
Oo
Oo
Oo
Oo
Oo
dm
dm
dm
dm
dm
dm
dm
dm
dm
Oo
Oo
Oo
Oo
Oo
dm
dm
dm
dm
dm
dm
dm
jY
jY
jY
jY
LH
LH
LH
LH
LH
LH
LH
oW
oW
oW
oW
oW
oW
oW
oW
oW
LH
LH
LH
LH
LH
LH
LH
jY
LH
LH
LH
LH
LH
LH
LH
dm
Oo
pi
pi
pi
pi
pi
pi
pi
pi
"}
(38,1,1) = {"
pi
pi
pi
pi
pi
pi
pi
pi
pi
pi
pi
pi
pi
pi
pi
pi
pi
pi
pi
pi
pi
pi
pi
pi
pi
pi
pi
pi
pi
pi
pi
pi
pi
Oo
Oo
Oo
Oo
Oo
Oo
Oo
Oo
Oo
Oo
Oo
Oo
Oo
Oo
Oo
Oo
Oo
Oo
Oo
Oo
Oo
dm
dm
dm
dm
jY
jY
jY
jY
jY
jY
jY
LH
LH
LH
LH
LH
LH
LH
LH
LH
LH
LH
jY
jY
jY
jY
jY
jY
jY
dm
dm
dm
dm
dm
dm
dm
dm
Oo
pi
pi
pi
pi
pi
pi
pi
pi
"}
(39,1,1) = {"
pi
pi
pi
pi
pi
pi
pi
pi
pi
pi
pi
pi
pi
pi
pi
pi
pi
pi
pi
pi
pi
pi
pi
pi
pi
pi
pi
pi
pi
pi
pi
pi
pi
pi
pi
pi
pi
pi
pi
pi
pi
pi
pi
pi
pi
pi
pi
pi
pi
pi
pi
pi
pi
Oo
Oo
Oo
Oo
dm
dm
dm
dm
dm
dm
dm
jY
jY
jY
jY
jY
jY
jY
jY
jY
jY
jY
jY
jY
dm
dm
dm
dm
dm
dm
dm
Oo
Oo
Oo
Oo
Oo
Oo
Oo
Oo
pi
pi
pi
pi
pi
pi
pi
pi
"}
(40,1,1) = {"
pi
pi
pi
pi
pi
pi
pi
pi
pi
pi
pi
pi
pi
pi
pi
pi
pi
pi
pi
pi
pi
pi
pi
pi
pi
pi
pi
pi
pi
pi
pi
pi
pi
pi
pi
pi
pi
pi
pi
pi
pi
pi
pi
pi
pi
pi
pi
pi
pi
pi
pi
pi
pi
pi
pi
pi
Oo
Oo
Oo
Oo
Oo
Oo
Oo
dm
dm
dm
dm
dm
dm
dm
dm
dm
dm
dm
dm
dm
dm
dm
Oo
Oo
Oo
Oo
Oo
Oo
Oo
pi
pi
pi
pi
pi
pi
pi
pi
pi
pi
pi
pi
pi
pi
pi
"}
(41,1,1) = {"
pi
pi
pi
pi
pi
pi
pi
pi
pi
pi
pi
pi
pi
pi
pi
pi
pi
pi
pi
pi
pi
pi
pi
pi
pi
pi
pi
pi
pi
pi
pi
pi
pi
pi
pi
pi
pi
pi
pi
pi
pi
pi
pi
pi
pi
pi
pi
pi
pi
pi
pi
pi
pi
pi
pi
pi
pi
pi
pi
pi
pi
pi
Oo
Oo
Oo
Oo
Oo
Oo
Oo
Oo
Oo
Oo
Oo
Oo
Oo
Oo
Oo
Oo
Oo
pi
pi
pi
pi
pi
pi
pi
pi
pi
pi
pi
pi
pi
pi
pi
pi
pi
pi
pi
pi
pi
"}
(42,1,1) = {"
pi
pi
pi
pi
pi
pi
pi
pi
pi
pi
pi
pi
pi
pi
pi
pi
pi
pi
pi
pi
pi
pi
pi
pi
pi
pi
pi
pi
pi
pi
pi
pi
pi
pi
pi
pi
pi
pi
pi
pi
pi
pi
pi
pi
pi
pi
pi
pi
pi
pi
pi
pi
pi
pi
pi
pi
pi
pi
pi
pi
pi
pi
pi
pi
pi
pi
pi
pi
pi
pi
pi
pi
pi
pi
pi
pi
pi
pi
pi
pi
pi
pi
pi
pi
pi
pi
pi
pi
pi
pi
pi
pi
pi
pi
pi
pi
pi
pi
pi
pi
"}
(43,1,1) = {"
pi
pi
pi
pi
pi
pi
pi
pi
pi
pi
pi
pi
pi
pi
pi
pi
pi
pi
pi
pi
pi
pi
pi
pi
pi
pi
pi
pi
pi
pi
pi
pi
pi
pi
pi
pi
pi
pi
pi
pi
pi
pi
pi
pi
pi
pi
pi
pi
pi
pi
pi
pi
pi
pi
pi
pi
pi
pi
pi
pi
pi
pi
pi
pi
pi
pi
pi
pi
pi
pi
pi
pi
pi
pi
pi
pi
pi
pi
pi
pi
pi
pi
pi
pi
pi
pi
pi
pi
pi
pi
pi
pi
pi
pi
pi
pi
pi
pi
pi
pi
"}
(44,1,1) = {"
pi
pi
pi
pi
pi
pi
pi
pi
pi
pi
pi
pi
pi
pi
pi
pi
pi
pi
pi
pi
pi
pi
pi
pi
pi
pi
pi
pi
pi
pi
pi
pi
pi
pi
pi
pi
pi
pi
pi
pi
pi
pi
pi
pi
pi
pi
pi
pi
pi
pi
pi
pi
pi
pi
pi
pi
pi
pi
pi
pi
pi
pi
pi
pi
pi
pi
pi
pi
pi
pi
pi
pi
pi
pi
pi
pi
pi
pi
pi
pi
pi
pi
pi
pi
pi
pi
pi
pi
pi
pi
pi
pi
pi
pi
pi
pi
pi
pi
pi
pi
"}
(45,1,1) = {"
pi
pi
pi
pi
pi
pi
pi
pi
pi
pi
pi
pi
pi
pi
pi
pi
pi
pi
pi
pi
pi
pi
pi
pi
pi
pi
pi
pi
pi
pi
pi
pi
pi
pi
pi
pi
pi
pi
pi
pi
pi
pi
pi
pi
pi
pi
pi
pi
pi
pi
pi
pi
pi
pi
pi
pi
pi
pi
pi
pi
pi
pi
pi
pi
pi
pi
pi
pi
pi
pi
pi
pi
pi
pi
pi
pi
pi
pi
pi
pi
pi
pi
pi
pi
pi
pi
pi
pi
pi
pi
pi
pi
pi
pi
pi
pi
pi
pi
pi
pi
"}
(46,1,1) = {"
pi
pi
pi
pi
pi
pi
pi
pi
pi
pi
pi
pi
pi
pi
pi
pi
pi
pi
pi
pi
pi
pi
pi
pi
pi
pi
pi
pi
pi
pi
pi
pi
pi
pi
pi
pi
pi
pi
pi
pi
pi
pi
pi
pi
pi
pi
pi
pi
pi
pi
pi
pi
pi
pi
pi
pi
pi
pi
pi
pi
pi
pi
pi
pi
pi
pi
pi
pi
pi
pi
pi
pi
pi
pi
pi
pi
pi
pi
pi
pi
pi
pi
pi
pi
pi
pi
pi
pi
pi
pi
pi
pi
pi
pi
pi
pi
pi
pi
pi
pi
"}
(47,1,1) = {"
pi
pi
pi
pi
pi
pi
pi
pi
pi
pi
pi
pi
pi
pi
pi
pi
pi
pi
pi
pi
pi
pi
pi
pi
pi
pi
pi
pi
pi
pi
pi
pi
pi
pi
pi
pi
pi
pi
pi
pi
pi
pi
pi
pi
pi
pi
pi
pi
pi
pi
pi
pi
pi
pi
pi
pi
pi
pi
pi
pi
pi
pi
pi
pi
pi
pi
pi
pi
pi
pi
pi
pi
pi
pi
pi
pi
pi
pi
pi
pi
pi
pi
pi
pi
pi
pi
pi
pi
pi
pi
pi
pi
pi
pi
pi
pi
pi
pi
pi
pi
"}
(48,1,1) = {"
pi
pi
pi
pi
pi
pi
pi
pi
pi
pi
pi
pi
pi
pi
pi
pi
pi
pi
pi
pi
pi
pi
pi
pi
pi
pi
pi
pi
pi
pi
pi
pi
pi
pi
pi
pi
pi
pi
pi
pi
pi
pi
pi
pi
pi
pi
pi
pi
pi
pi
pi
pi
pi
pi
pi
pi
pi
pi
pi
pi
pi
pi
pi
pi
pi
pi
pi
pi
pi
pi
pi
pi
pi
pi
pi
pi
pi
pi
pi
pi
pi
pi
pi
pi
pi
pi
pi
pi
pi
pi
pi
pi
pi
pi
pi
pi
pi
pi
pi
pi
"}
(49,1,1) = {"
pi
pi
pi
pi
pi
pi
pi
pi
pi
pi
pi
pi
pi
pi
pi
pi
pi
pi
pi
pi
pi
pi
pi
pi
pi
pi
pi
pi
pi
pi
pi
pi
pi
pi
pi
pi
pi
pi
pi
pi
pi
pi
pi
pi
pi
pi
pi
pi
pi
pi
pi
pi
pi
pi
pi
pi
pi
pi
pi
pi
pi
pi
pi
pi
pi
pi
pi
pi
pi
pi
pi
pi
pi
pi
pi
pi
pi
pi
pi
pi
pi
pi
pi
pi
pi
pi
pi
pi
pi
pi
pi
pi
pi
pi
pi
pi
pi
pi
pi
pi
"}
(50,1,1) = {"
pi
pi
pi
pi
pi
pi
pi
pi
pi
pi
pi
pi
pi
pi
pi
pi
pi
pi
pi
pi
pi
pi
pi
pi
pi
pi
pi
pi
pi
pi
pi
pi
pi
pi
pi
pi
pi
pi
pi
pi
pi
pi
pi
pi
pi
pi
pi
pi
pi
pi
pi
pi
pi
pi
pi
pi
pi
pi
pi
pi
pi
pi
pi
pi
pi
pi
pi
pi
pi
pi
pi
pi
pi
pi
pi
pi
pi
pi
pi
pi
pi
pi
pi
pi
pi
pi
pi
pi
pi
pi
pi
pi
pi
pi
pi
pi
pi
pi
pi
pi
"}
