//MAP CONVERTED BY dmm2tgm.py THIS HEADER COMMENT PREVENTS RECONVERSION, DO NOT REMOVE
"a" = (
/turf/open/space/basic,
/area/space)
"g" = (
/obj/machinery/door/window/brigdoor/security/cell/westleft,
/turf/open/floor/plasteel/dark,
/area/space)
"i" = (
/turf/open/floor/engine,
/area/space)
"j" = (
/obj/machinery/door/window/brigdoor/security/cell/eastright,
/turf/open/floor/plasteel/dark,
/area/space)
"n" = (
/obj/structure/closet/crate,
/obj/item/stack/license_plates/empty/fifty,
/obj/item/stack/license_plates/empty/fifty,
/obj/item/stack/license_plates/empty/fifty,
/obj/item/stack/sheet/cardboard{
	amount = 14
	},
/obj/item/stack/package_wrap,
/turf/open/floor/plasteel/dark,
/area/space)
"o" = (
/turf/open/floor/engine/airless,
/area/space)
"q" = (
/turf/open/floor/plasteel,
/area/space)
"r" = (
/turf/closed/wall,
/area/space)
"y" = (
/turf/closed/wall/r_wall,
/area/space)
"D" = (
/obj/effect/spawner/structure/window/reinforced,
/turf/open/floor/plating,
/area/space)
"G" = (
/turf/open/floor/plating,
/area/space)
"J" = (
/obj/machinery/door/window/brigdoor/security/cell/southleft,
/turf/open/floor/plasteel/dark,
/area/space)
"L" = (
/obj/effect/spawner/structure/window/plasma/reinforced,
/turf/open/floor/plating,
/area/space)
"M" = (
/obj/machinery/door/window/brigdoor/security/cell/southright,
/turf/open/floor/plasteel/dark,
/area/space)
"O" = (
/obj/machinery/plate_press,
/turf/open/floor/plasteel/dark,
/area/space)
"S" = (
/turf/open/floor/plasteel/dark,
/area/space)
"T" = (
/turf/open/floor/plasteel/white,
/area/space)
"X" = (
/turf/closed/wall/r_wall/syndicate,
/area/space)
"Y" = (
/obj/structure/closet/crate,
/obj/item/stack/license_plates/empty/fifty,
/obj/item/stack/license_plates/empty/fifty,
/obj/item/stack/license_plates/empty/fifty,
/turf/open/floor/plasteel/dark,
/area/space)
"Z" = (
/obj/machinery/power/supermatter_crystal/engine,
/turf/open/floor/engine/airless,
/area/space)

(1,1,1) = {"
a
a
a
a
a
a
a
a
a
a
a
a
a
a
a
a
a
a
a
a
a
a
a
a
a
a
a
a
a
a
a
a
a
a
a
a
a
a
a
a
a
a
a
a
a
a
a
a
a
a
a
a
a
a
a
a
a
a
a
a
a
a
a
a
a
a
a
a
a
a
a
a
a
a
a
a
a
a
a
a
a
a
a
a
a
a
a
a
a
a
a
a
a
a
a
a
a
a
a
a
"}
(2,1,1) = {"
a
a
a
a
a
a
a
a
a
a
a
a
a
a
a
a
a
a
a
a
a
a
a
a
a
a
a
a
a
a
a
a
a
a
a
a
a
a
a
a
a
a
a
a
a
a
a
a
a
a
a
a
a
a
a
a
a
a
a
a
a
a
a
a
a
a
a
a
a
a
a
a
a
a
a
a
a
a
a
a
a
a
a
a
a
a
a
a
a
a
a
a
a
a
a
a
a
a
a
a
"}
(3,1,1) = {"
a
a
a
a
a
a
a
a
a
a
a
a
a
a
a
a
a
a
a
a
a
a
a
a
a
a
a
a
a
a
a
a
a
a
a
a
a
a
a
a
a
a
a
a
a
a
a
a
a
a
a
a
a
a
a
a
a
a
a
a
a
a
a
a
a
a
a
a
a
a
a
a
a
a
a
a
a
a
a
a
a
a
a
a
a
a
a
a
a
a
a
a
a
a
a
a
a
a
a
a
"}
(4,1,1) = {"
a
a
a
a
a
a
a
a
a
a
a
a
a
a
a
a
a
a
a
a
a
a
a
a
a
a
a
a
a
a
a
a
a
a
a
a
a
a
a
a
a
a
a
a
a
a
a
a
a
a
a
a
a
a
a
a
a
a
a
a
a
a
a
a
a
a
a
a
a
a
a
a
a
a
a
a
a
a
a
a
a
a
a
a
a
a
a
a
a
a
a
a
a
a
a
a
a
a
a
a
"}
(5,1,1) = {"
a
a
a
a
a
a
a
a
a
a
a
a
a
a
a
a
a
a
a
a
a
a
a
a
a
a
a
a
a
a
a
a
a
a
a
a
a
a
a
a
a
a
a
a
a
a
a
a
a
a
a
a
a
a
a
a
a
a
a
a
a
a
a
a
a
a
a
a
a
a
a
a
a
a
a
a
a
a
a
a
a
a
a
a
a
a
a
a
a
a
a
a
a
a
a
a
a
a
a
a
"}
(6,1,1) = {"
a
a
a
a
a
a
a
a
a
a
a
a
a
a
a
a
a
a
a
a
a
a
a
a
a
a
a
a
a
a
a
a
a
a
a
a
a
a
a
a
a
a
a
a
a
a
a
a
a
a
a
a
a
a
a
a
a
a
a
a
a
a
a
a
a
a
a
a
a
a
a
a
a
a
a
a
a
a
a
a
a
a
a
a
a
a
a
a
a
a
a
a
a
a
a
a
a
a
a
a
"}
(7,1,1) = {"
a
a
a
a
a
a
a
a
a
a
a
a
a
a
a
a
a
a
a
a
a
a
a
a
a
a
a
a
a
a
a
a
a
a
a
a
a
a
a
a
a
a
a
a
a
a
a
a
a
a
a
a
a
a
a
a
a
a
a
a
a
a
a
a
a
a
a
a
a
a
a
a
a
a
a
a
a
a
a
a
a
a
a
a
a
a
a
a
a
a
a
a
a
a
a
a
a
a
a
a
"}
(8,1,1) = {"
a
a
a
a
a
a
a
a
a
a
a
a
a
a
a
a
a
a
a
a
a
a
a
a
a
a
a
a
a
a
a
a
a
a
a
a
a
a
a
a
a
a
a
a
a
a
a
a
a
a
a
a
a
a
a
a
a
a
a
a
a
a
a
a
a
a
a
a
a
a
a
a
a
a
a
a
a
a
a
a
a
a
a
a
a
a
a
a
a
a
a
a
a
a
a
a
a
a
a
a
"}
(9,1,1) = {"
a
a
a
a
a
a
a
a
a
a
a
a
a
a
a
a
a
a
a
a
a
a
a
a
a
a
a
a
a
a
a
a
a
a
a
a
a
a
a
a
a
a
a
a
a
a
a
a
a
a
a
a
a
a
a
a
a
a
a
a
a
a
a
a
a
a
a
a
a
a
a
a
a
a
a
a
a
a
a
a
a
a
a
a
a
a
a
a
a
a
a
a
a
a
a
a
a
a
a
a
"}
(10,1,1) = {"
a
a
a
a
a
a
a
a
a
a
a
a
a
a
a
a
a
a
a
a
a
a
a
a
a
a
a
a
a
a
a
a
a
a
a
a
a
a
a
a
a
a
a
a
a
a
a
a
a
a
a
a
a
a
a
a
a
a
a
a
a
a
a
a
a
a
a
a
a
a
a
a
a
a
a
a
a
a
a
a
a
a
a
a
a
a
a
a
a
a
a
a
a
a
a
a
a
a
a
a
"}
(11,1,1) = {"
a
a
a
a
a
a
a
a
a
a
a
a
a
a
a
a
a
a
a
a
a
a
a
a
a
a
a
a
a
a
a
a
a
a
a
a
a
a
a
a
a
a
a
a
a
a
a
a
a
a
a
a
a
a
a
a
a
a
a
a
a
a
X
X
X
X
X
X
X
X
X
X
X
X
X
X
X
X
X
a
a
a
a
a
a
a
a
a
a
a
a
a
a
a
a
a
a
a
a
a
"}
(12,1,1) = {"
a
a
a
a
a
a
a
a
a
a
a
a
a
a
a
a
a
a
a
a
a
a
a
a
a
a
a
a
a
a
a
a
a
a
a
a
a
a
a
a
a
a
a
a
a
a
a
a
a
a
a
a
a
a
a
a
X
X
X
X
X
X
X
G
G
G
G
G
G
G
G
G
G
G
G
G
G
G
X
X
X
X
X
X
X
a
a
a
a
a
a
a
a
a
a
a
a
a
a
a
"}
(13,1,1) = {"
a
a
a
a
a
a
a
a
a
a
a
a
a
a
a
a
a
a
a
a
a
a
a
a
a
a
a
a
a
a
a
a
a
a
a
a
a
a
a
a
a
a
a
a
a
a
a
a
a
a
a
a
a
X
X
X
X
G
G
G
G
G
G
G
y
y
y
y
y
y
y
y
y
y
y
y
y
G
G
G
G
G
G
G
X
X
X
X
X
X
X
X
a
a
a
a
a
a
a
a
"}
(14,1,1) = {"
a
a
a
a
a
a
a
a
a
a
a
a
a
a
a
a
a
a
a
a
a
a
a
a
a
a
a
a
a
a
a
a
a
X
X
X
X
X
X
X
X
X
X
X
X
X
X
X
X
X
X
X
X
X
G
G
G
G
y
y
y
y
y
y
y
G
G
G
G
G
G
G
G
G
G
G
y
y
y
y
y
y
y
G
G
G
G
G
G
G
G
X
a
a
a
a
a
a
a
a
"}
(15,1,1) = {"
a
a
a
a
a
a
a
a
a
a
a
a
a
a
a
a
a
a
a
a
a
a
a
a
a
a
a
X
X
X
X
X
X
X
G
G
G
G
G
G
G
G
G
G
G
G
G
G
G
G
G
G
G
G
G
y
y
y
y
G
G
G
G
G
G
G
G
G
G
G
G
G
G
G
G
G
G
G
G
G
G
G
y
y
y
y
y
y
y
y
G
X
a
a
a
a
a
a
a
a
"}
(16,1,1) = {"
a
a
a
a
a
a
a
a
a
a
a
a
a
a
a
a
a
a
a
X
X
X
X
X
X
X
X
X
G
G
G
G
G
G
G
y
y
y
y
y
y
y
y
y
y
y
y
y
y
y
y
y
y
y
y
y
G
G
G
G
G
G
G
G
G
G
G
G
G
G
G
G
G
G
G
G
G
G
G
G
G
G
G
G
G
G
G
G
G
y
G
X
a
a
a
a
a
a
a
a
"}
(17,1,1) = {"
a
a
a
a
a
a
a
a
a
a
a
a
a
a
a
a
a
a
X
X
G
G
G
G
G
G
G
G
G
y
G
y
y
y
G
y
a
a
a
a
a
a
a
a
a
a
a
a
a
a
a
a
a
a
a
y
G
G
G
G
G
G
G
G
G
G
G
G
G
G
G
G
G
G
G
G
G
G
G
G
G
G
G
G
G
G
y
G
G
y
G
X
a
a
a
a
a
a
a
a
"}
(18,1,1) = {"
a
a
a
a
a
a
a
a
a
a
a
a
a
a
a
a
a
X
X
G
G
y
y
y
y
y
y
y
y
y
G
G
y
q
q
y
a
a
a
a
a
a
a
a
a
a
a
a
a
a
a
a
a
a
a
y
G
G
G
G
G
G
G
G
G
G
G
G
G
G
G
G
G
G
G
G
G
G
G
G
G
G
G
G
G
G
G
G
G
y
G
X
a
a
a
a
a
a
a
a
"}
(19,1,1) = {"
a
a
a
a
a
a
a
a
a
a
a
a
a
a
a
a
X
X
G
G
y
y
q
q
q
q
q
q
q
r
r
G
y
q
q
y
a
a
a
a
a
a
a
a
a
a
a
a
a
a
a
a
a
a
a
y
G
G
G
G
G
G
G
G
G
G
G
G
G
G
G
G
G
G
G
G
G
G
G
G
G
G
G
G
G
G
y
G
G
y
G
X
a
a
a
a
a
a
a
a
"}
(20,1,1) = {"
a
a
a
a
a
a
a
a
a
a
a
a
a
a
a
X
X
G
G
y
y
q
q
q
q
q
q
q
q
q
r
G
y
q
q
y
y
y
y
y
y
y
y
y
y
y
y
y
y
y
y
y
y
y
y
y
y
y
y
y
y
y
y
y
y
y
y
G
G
G
G
G
G
G
G
G
G
G
G
G
G
G
G
G
G
G
G
G
G
y
G
X
a
a
a
a
a
a
a
a
"}
(21,1,1) = {"
a
a
a
a
a
a
a
a
a
a
a
a
a
a
X
X
G
G
y
y
q
q
S
S
S
S
S
S
S
q
r
G
y
q
q
y
T
T
y
T
T
y
T
T
y
T
T
y
T
T
y
T
T
y
T
T
y
T
T
y
T
T
y
q
q
q
y
G
y
y
y
y
y
y
y
y
y
G
G
G
G
G
G
G
G
G
G
G
y
y
G
X
a
a
a
a
a
a
a
a
"}
(22,1,1) = {"
a
a
a
a
a
a
a
a
a
a
a
a
a
X
X
G
G
y
y
q
q
q
S
S
S
S
S
S
S
q
r
G
r
q
q
y
T
T
y
T
T
y
T
T
y
T
T
y
T
T
y
T
T
y
T
T
y
T
T
y
T
T
y
q
q
q
y
y
y
i
i
i
i
i
i
i
y
y
G
G
G
G
G
G
G
G
G
G
y
G
G
X
a
a
a
a
a
a
a
a
"}
(23,1,1) = {"
a
a
a
a
a
a
a
a
a
a
a
a
X
X
G
G
y
y
q
q
q
q
S
S
S
S
S
S
S
q
r
G
r
q
q
y
T
T
y
T
T
y
T
T
y
T
T
y
T
T
y
T
T
y
T
T
y
T
T
y
T
T
y
q
q
q
q
y
i
i
i
i
i
i
i
i
i
y
G
G
G
G
G
G
G
G
G
G
y
G
X
X
a
a
a
a
a
a
a
a
"}
(24,1,1) = {"
a
a
a
a
a
a
a
a
a
a
a
a
X
G
G
y
y
q
q
q
q
q
S
S
S
S
S
S
S
q
r
G
r
q
q
y
D
g
y
D
g
y
D
g
y
D
g
y
D
g
y
D
g
y
D
g
y
D
g
y
D
g
y
q
q
q
q
y
i
i
y
L
L
L
y
i
i
y
G
G
G
G
G
G
G
G
G
G
y
G
X
a
a
a
a
a
a
a
a
a
"}
(25,1,1) = {"
a
a
a
a
a
a
a
a
a
a
a
a
X
G
y
y
q
q
q
q
q
q
S
S
S
S
S
S
S
q
q
q
q
q
q
y
q
S
q
q
S
q
q
S
q
q
S
q
q
S
q
q
S
q
q
S
q
q
S
q
q
S
y
q
q
q
q
y
i
i
L
o
o
o
L
i
i
y
G
G
G
G
G
G
G
G
G
G
y
G
X
a
a
a
a
a
a
a
a
a
"}
(26,1,1) = {"
a
a
a
a
a
a
a
a
a
a
a
a
X
G
y
q
q
q
q
q
q
q
S
S
S
S
S
S
S
S
S
S
S
S
S
S
S
S
S
S
S
S
S
S
S
S
S
S
S
S
S
S
S
S
S
S
S
S
S
S
S
S
S
S
q
q
q
y
i
i
L
o
Z
o
L
i
i
y
G
G
G
G
G
G
G
G
G
G
y
G
X
a
a
a
a
a
a
a
a
a
"}
(27,1,1) = {"
a
a
a
a
a
a
a
a
a
a
a
a
X
G
y
y
q
q
q
q
q
q
S
S
S
S
S
S
S
q
q
q
q
q
q
y
q
S
q
q
S
q
q
S
q
q
S
q
q
S
q
q
S
q
q
S
q
q
S
q
q
S
y
q
q
q
q
y
i
i
L
o
o
o
L
i
i
y
G
G
G
G
G
G
G
G
G
G
y
G
X
a
a
a
a
a
a
a
a
a
"}
(28,1,1) = {"
a
a
a
a
a
a
a
a
a
a
a
a
X
G
G
y
y
q
q
q
q
q
S
S
S
S
S
S
S
q
r
G
r
q
q
y
D
j
y
D
j
y
D
j
y
D
j
y
D
j
y
D
j
y
D
j
y
D
j
y
D
j
y
q
q
q
q
y
i
i
y
L
L
L
y
i
i
y
G
G
G
G
G
G
G
G
G
G
y
G
X
a
a
a
a
a
a
a
a
a
"}
(29,1,1) = {"
a
a
a
a
a
a
a
a
a
a
a
a
X
X
G
G
y
y
q
q
q
q
S
S
S
S
S
S
S
q
r
G
r
q
q
y
T
T
y
T
T
y
T
T
y
T
T
y
T
T
y
T
T
y
T
T
y
T
T
y
T
T
y
q
q
q
q
y
i
i
i
i
i
i
i
i
i
y
G
G
G
G
G
G
G
G
G
G
y
G
X
X
a
a
a
a
a
a
a
a
"}
(30,1,1) = {"
a
a
a
a
a
a
a
a
a
a
a
a
a
X
X
G
G
y
y
q
q
q
S
S
S
S
S
S
S
q
r
G
r
q
q
y
T
T
y
T
T
y
T
T
y
T
T
y
T
T
y
T
T
y
T
T
y
T
T
y
T
T
y
q
q
q
q
y
y
i
i
i
i
i
i
i
y
y
G
G
G
G
G
G
G
G
G
G
y
G
G
X
a
a
a
a
a
a
a
a
"}
(31,1,1) = {"
a
a
a
a
a
a
a
a
a
a
a
a
a
a
X
X
G
G
y
y
q
q
S
S
S
S
S
S
S
q
r
G
r
q
q
y
T
T
y
T
T
y
T
T
y
T
T
y
T
T
y
T
T
y
T
T
y
T
T
y
T
T
y
q
q
q
q
q
y
y
y
y
y
y
y
y
y
G
G
G
G
G
G
G
G
G
G
G
y
y
G
X
a
a
a
a
a
a
a
a
"}
(32,1,1) = {"
a
a
a
a
a
a
a
a
a
a
a
a
a
a
a
X
X
G
G
y
y
q
q
q
q
q
q
q
q
q
r
G
r
q
q
y
y
y
y
y
y
y
y
y
y
y
y
y
y
y
y
y
y
y
y
y
y
y
y
y
y
y
y
q
q
q
q
q
q
q
q
q
q
q
q
q
y
G
G
G
G
G
G
G
G
G
G
G
G
y
G
X
a
a
a
a
a
a
a
a
"}
(33,1,1) = {"
a
a
a
a
a
a
a
a
a
a
a
a
a
a
a
a
X
X
G
G
y
y
q
q
q
q
q
q
q
r
r
G
r
q
q
y
a
a
a
a
a
a
a
a
a
a
a
a
a
a
a
a
a
a
a
y
O
Y
O
r
q
q
q
q
q
q
q
q
q
q
q
q
q
q
q
q
y
G
G
G
G
G
G
G
G
G
y
G
G
y
G
X
a
a
a
a
a
a
a
a
"}
(34,1,1) = {"
a
a
a
a
a
a
a
a
a
a
a
a
a
a
a
a
a
X
X
G
G
y
y
y
y
y
y
y
y
y
G
G
r
q
q
y
a
a
a
a
a
a
a
a
a
a
a
a
a
a
a
a
a
a
a
y
S
S
S
J
q
q
q
q
q
q
q
q
q
q
q
q
q
q
q
q
y
G
G
G
G
G
G
G
G
G
G
G
G
y
G
X
a
a
a
a
a
a
a
a
"}
(35,1,1) = {"
a
a
a
a
a
a
a
a
a
a
a
a
a
a
a
a
a
a
X
X
G
G
G
G
G
G
G
G
G
y
G
y
y
y
G
y
a
a
a
a
a
a
a
a
a
a
a
a
a
a
a
a
a
a
a
y
S
S
S
M
q
q
q
q
q
q
q
q
q
q
q
q
q
q
q
q
y
G
G
G
G
G
G
G
G
G
y
G
G
y
G
X
a
a
a
a
a
a
a
a
"}
(36,1,1) = {"
a
a
a
a
a
a
a
a
a
a
a
a
a
a
a
a
a
a
a
X
X
X
X
X
X
X
X
X
G
G
G
G
G
G
G
y
y
y
y
y
y
y
y
y
y
y
y
y
y
y
y
y
y
y
y
y
O
n
O
r
q
q
q
q
q
q
q
q
q
q
q
q
q
q
q
q
y
G
G
G
G
G
G
G
G
G
G
G
G
y
G
X
a
a
a
a
a
a
a
a
"}
(37,1,1) = {"
a
a
a
a
a
a
a
a
a
a
a
a
a
a
a
a
a
a
a
a
a
a
a
a
a
a
a
X
X
X
X
X
X
X
G
G
G
G
G
G
G
G
G
G
G
G
G
G
G
G
G
G
G
G
G
y
y
y
y
y
q
q
q
q
q
q
q
q
q
q
q
q
q
q
q
q
y
G
G
G
G
G
y
y
y
y
y
y
y
y
G
X
a
a
a
a
a
a
a
a
"}
(38,1,1) = {"
a
a
a
a
a
a
a
a
a
a
a
a
a
a
a
a
a
a
a
a
a
a
a
a
a
a
a
a
a
a
a
a
a
X
X
X
X
X
X
X
X
X
X
X
X
X
X
X
X
X
X
X
X
X
G
G
G
G
G
y
y
y
y
y
y
q
q
q
q
q
q
q
q
q
q
q
y
y
y
y
y
y
y
G
G
G
G
G
G
G
G
X
a
a
a
a
a
a
a
a
"}
(39,1,1) = {"
a
a
a
a
a
a
a
a
a
a
a
a
a
a
a
a
a
a
a
a
a
a
a
a
a
a
a
a
a
a
a
a
a
a
a
a
a
a
a
a
a
a
a
a
a
a
a
a
a
a
a
a
a
X
X
X
X
G
G
G
G
G
G
G
y
y
y
y
y
y
y
y
y
y
y
y
y
G
G
G
G
G
G
G
X
X
X
X
X
X
X
X
a
a
a
a
a
a
a
a
"}
(40,1,1) = {"
a
a
a
a
a
a
a
a
a
a
a
a
a
a
a
a
a
a
a
a
a
a
a
a
a
a
a
a
a
a
a
a
a
a
a
a
a
a
a
a
a
a
a
a
a
a
a
a
a
a
a
a
a
a
a
a
X
X
X
X
X
X
X
G
G
G
G
G
G
G
G
G
G
G
G
G
G
G
X
X
X
X
X
X
X
a
a
a
a
a
a
a
a
a
a
a
a
a
a
a
"}
(41,1,1) = {"
a
a
a
a
a
a
a
a
a
a
a
a
a
a
a
a
a
a
a
a
a
a
a
a
a
a
a
a
a
a
a
a
a
a
a
a
a
a
a
a
a
a
a
a
a
a
a
a
a
a
a
a
a
a
a
a
a
a
a
a
a
a
X
X
X
X
X
X
X
X
X
X
X
X
X
X
X
X
X
a
a
a
a
a
a
a
a
a
a
a
a
a
a
a
a
a
a
a
a
a
"}
(42,1,1) = {"
a
a
a
a
a
a
a
a
a
a
a
a
a
a
a
a
a
a
a
a
a
a
a
a
a
a
a
a
a
a
a
a
a
a
a
a
a
a
a
a
a
a
a
a
a
a
a
a
a
a
a
a
a
a
a
a
a
a
a
a
a
a
a
a
a
a
a
a
a
a
a
a
a
a
a
a
a
a
a
a
a
a
a
a
a
a
a
a
a
a
a
a
a
a
a
a
a
a
a
a
"}
(43,1,1) = {"
a
a
a
a
a
a
a
a
a
a
a
a
a
a
a
a
a
a
a
a
a
a
a
a
a
a
a
a
a
a
a
a
a
a
a
a
a
a
a
a
a
a
a
a
a
a
a
a
a
a
a
a
a
a
a
a
a
a
a
a
a
a
a
a
a
a
a
a
a
a
a
a
a
a
a
a
a
a
a
a
a
a
a
a
a
a
a
a
a
a
a
a
a
a
a
a
a
a
a
a
"}
(44,1,1) = {"
a
a
a
a
a
a
a
a
a
a
a
a
a
a
a
a
a
a
a
a
a
a
a
a
a
a
a
a
a
a
a
a
a
a
a
a
a
a
a
a
a
a
a
a
a
a
a
a
a
a
a
a
a
a
a
a
a
a
a
a
a
a
a
a
a
a
a
a
a
a
a
a
a
a
a
a
a
a
a
a
a
a
a
a
a
a
a
a
a
a
a
a
a
a
a
a
a
a
a
a
"}
(45,1,1) = {"
a
a
a
a
a
a
a
a
a
a
a
a
a
a
a
a
a
a
a
a
a
a
a
a
a
a
a
a
a
a
a
a
a
a
a
a
a
a
a
a
a
a
a
a
a
a
a
a
a
a
a
a
a
a
a
a
a
a
a
a
a
a
a
a
a
a
a
a
a
a
a
a
a
a
a
a
a
a
a
a
a
a
a
a
a
a
a
a
a
a
a
a
a
a
a
a
a
a
a
a
"}
(46,1,1) = {"
a
a
a
a
a
a
a
a
a
a
a
a
a
a
a
a
a
a
a
a
a
a
a
a
a
a
a
a
a
a
a
a
a
a
a
a
a
a
a
a
a
a
a
a
a
a
a
a
a
a
a
a
a
a
a
a
a
a
a
a
a
a
a
a
a
a
a
a
a
a
a
a
a
a
a
a
a
a
a
a
a
a
a
a
a
a
a
a
a
a
a
a
a
a
a
a
a
a
a
a
"}
(47,1,1) = {"
a
a
a
a
a
a
a
a
a
a
a
a
a
a
a
a
a
a
a
a
a
a
a
a
a
a
a
a
a
a
a
a
a
a
a
a
a
a
a
a
a
a
a
a
a
a
a
a
a
a
a
a
a
a
a
a
a
a
a
a
a
a
a
a
a
a
a
a
a
a
a
a
a
a
a
a
a
a
a
a
a
a
a
a
a
a
a
a
a
a
a
a
a
a
a
a
a
a
a
a
"}
(48,1,1) = {"
a
a
a
a
a
a
a
a
a
a
a
a
a
a
a
a
a
a
a
a
a
a
a
a
a
a
a
a
a
a
a
a
a
a
a
a
a
a
a
a
a
a
a
a
a
a
a
a
a
a
a
a
a
a
a
a
a
a
a
a
a
a
a
a
a
a
a
a
a
a
a
a
a
a
a
a
a
a
a
a
a
a
a
a
a
a
a
a
a
a
a
a
a
a
a
a
a
a
a
a
"}
(49,1,1) = {"
a
a
a
a
a
a
a
a
a
a
a
a
a
a
a
a
a
a
a
a
a
a
a
a
a
a
a
a
a
a
a
a
a
a
a
a
a
a
a
a
a
a
a
a
a
a
a
a
a
a
a
a
a
a
a
a
a
a
a
a
a
a
a
a
a
a
a
a
a
a
a
a
a
a
a
a
a
a
a
a
a
a
a
a
a
a
a
a
a
a
a
a
a
a
a
a
a
a
a
a
"}
(50,1,1) = {"
a
a
a
a
a
a
a
a
a
a
a
a
a
a
a
a
a
a
a
a
a
a
a
a
a
a
a
a
a
a
a
a
a
a
a
a
a
a
a
a
a
a
a
a
a
a
a
a
a
a
a
a
a
a
a
a
a
a
a
a
a
a
a
a
a
a
a
a
a
a
a
a
a
a
a
a
a
a
a
a
a
a
a
a
a
a
a
a
a
a
a
a
a
a
a
a
a
a
a
a
"}
