//MAP CONVERTED BY dmm2tgm.py THIS HEADER COMMENT PREVENTS RECONVERSION, DO NOT REMOVE
"a" = (
/turf/open/transparent/openspace/airless,
/area/space)
"e" = (
/turf/closed/wall/r_wall,
/area/space)
"n" = (
/obj/structure/shuttle/engine/huge,
/turf/closed/wall/r_wall,
/area/space)
"t" = (
/turf/open/floor/plasteel/dark,
/area/space)
"u" = (
/obj/effect/spawner/structure/window/plasma/reinforced,
/turf/open/floor/plating,
/area/space)
"v" = (
/turf/closed/wall/r_wall/syndicate,
/area/space)
"y" = (
/turf/open/floor/plasteel,
/area/space)
"z" = (
/obj/structure/shuttle/engine/heater,
/turf/open/floor/plating,
/area/space)
"C" = (
/obj/structure/lattice/catwalk,
/turf/open/transparent/openspace/airless,
/area/space)
"E" = (
/turf/open/floor/engine/hull/reinforced,
/area/space)
"R" = (
/turf/open/floor/plating,
/area/space)

(1,1,1) = {"
a
a
a
a
a
a
a
a
a
a
a
a
a
a
a
a
a
a
a
a
a
a
a
a
a
a
a
a
a
a
a
a
a
a
a
a
a
a
a
a
a
a
a
a
a
a
a
a
a
a
a
a
a
a
a
a
a
a
a
a
a
a
a
a
a
a
a
a
a
a
a
a
a
a
a
a
a
a
a
a
a
a
a
a
a
a
a
a
a
a
a
a
a
a
a
a
a
a
a
a
"}
(2,1,1) = {"
a
a
a
a
a
a
a
a
a
a
a
a
a
a
a
a
a
a
a
a
a
a
a
a
a
a
a
a
a
a
a
a
a
a
a
a
a
a
a
a
a
a
a
a
a
a
a
a
a
a
a
a
a
a
a
a
a
a
a
a
a
a
a
a
a
a
a
a
a
a
a
a
a
a
a
a
a
a
a
a
a
a
a
a
a
a
a
a
a
a
a
a
a
a
a
a
a
a
a
a
"}
(3,1,1) = {"
a
a
a
a
a
a
a
a
a
a
a
a
a
a
a
a
a
a
a
a
a
a
a
a
a
a
a
a
a
a
a
a
a
a
a
a
a
a
a
a
a
a
a
a
a
a
a
a
a
a
a
a
a
a
a
a
a
a
a
a
a
a
a
a
a
a
a
a
a
a
a
a
a
a
a
a
a
a
a
a
a
a
a
a
a
a
a
a
a
a
a
a
a
a
a
a
a
a
a
a
"}
(4,1,1) = {"
a
a
a
a
a
a
a
a
a
a
a
a
a
a
a
a
a
a
a
a
a
a
a
a
a
a
a
a
a
a
a
a
a
a
a
a
a
a
a
a
a
a
a
a
a
a
a
a
a
a
a
a
a
a
a
a
a
a
a
a
a
a
a
a
a
a
a
a
a
a
a
a
a
a
a
a
a
a
a
a
a
a
a
a
a
a
a
a
a
a
a
a
a
a
a
a
a
a
a
a
"}
(5,1,1) = {"
a
a
a
a
a
a
a
a
a
a
a
a
a
a
a
a
a
a
a
a
a
a
a
a
a
a
a
a
a
a
a
a
a
a
a
a
a
a
a
a
a
a
a
a
a
a
a
a
a
a
a
a
a
a
a
a
a
a
a
a
a
a
a
a
a
a
a
a
a
a
a
a
a
a
a
a
a
a
a
a
a
a
a
a
a
a
a
a
a
a
a
a
a
a
a
a
a
a
a
a
"}
(6,1,1) = {"
a
a
a
a
a
a
a
a
a
a
a
a
a
a
a
a
a
a
a
a
a
a
a
a
a
a
a
a
a
a
a
a
a
a
a
a
a
a
a
a
a
a
a
a
a
a
a
a
a
a
a
a
a
a
a
a
a
a
a
a
a
a
a
a
a
a
a
a
a
a
a
a
a
a
a
a
a
a
a
a
a
a
a
a
a
a
a
a
a
a
a
a
a
a
a
a
a
a
a
a
"}
(7,1,1) = {"
a
a
a
a
a
a
a
a
a
a
a
a
a
a
a
a
a
a
a
a
a
a
a
a
a
a
a
a
a
a
a
a
a
a
a
a
a
a
a
a
a
a
a
a
a
a
a
a
a
a
a
a
a
a
a
a
a
a
a
a
a
a
a
a
a
a
a
a
a
a
a
a
a
a
a
a
a
a
a
a
a
a
a
a
a
a
a
a
a
a
a
a
a
a
a
a
a
a
a
a
"}
(8,1,1) = {"
a
a
a
a
a
a
a
a
a
a
a
a
a
a
a
a
a
a
a
a
a
a
a
a
a
a
a
a
a
a
a
a
a
a
a
a
a
a
a
a
a
a
a
a
a
a
a
a
a
a
a
a
a
a
a
a
a
a
a
a
a
a
a
a
a
a
a
a
a
a
a
a
a
a
a
a
a
a
a
a
a
a
a
a
a
a
a
a
a
a
a
a
a
a
a
a
a
a
a
a
"}
(9,1,1) = {"
a
a
a
a
a
a
a
a
a
a
a
a
a
a
a
a
a
a
a
a
a
a
a
a
a
a
a
a
a
a
a
a
a
a
a
a
a
a
a
a
a
a
a
a
a
a
a
a
a
a
a
a
a
a
a
a
a
a
a
a
a
a
a
a
a
a
a
a
a
a
a
a
a
a
a
a
a
a
a
a
a
a
a
a
a
a
a
a
a
a
a
a
a
a
a
a
a
a
a
a
"}
(10,1,1) = {"
a
a
a
a
a
a
a
a
a
a
a
a
a
a
a
a
a
a
a
a
a
a
a
a
a
a
a
a
a
a
a
a
a
a
a
a
a
a
a
a
a
a
a
a
a
a
a
a
a
a
a
a
a
a
a
a
a
a
a
a
a
a
a
a
a
a
a
a
a
a
a
a
a
a
a
a
a
a
a
a
a
a
a
a
a
a
a
a
a
a
a
a
a
a
a
a
a
a
a
a
"}
(11,1,1) = {"
a
a
a
a
a
a
a
a
a
a
a
a
a
a
a
a
a
a
a
a
a
a
a
a
a
a
a
a
a
a
a
a
a
a
a
a
a
a
a
a
a
a
a
a
a
a
a
a
a
a
a
a
a
a
a
a
a
a
a
a
a
a
E
E
E
E
E
E
E
E
E
E
E
E
E
E
E
E
E
a
a
a
a
a
a
a
a
a
a
a
a
a
a
a
a
a
a
a
a
a
"}
(12,1,1) = {"
a
a
a
a
a
a
a
a
a
a
a
a
a
a
a
a
a
a
a
a
a
a
a
a
a
a
a
a
a
a
a
a
a
a
a
a
a
a
a
a
a
a
a
a
a
a
a
a
a
a
a
a
a
a
a
a
E
E
E
E
E
E
E
v
v
v
v
v
v
v
v
v
v
v
v
v
v
v
E
E
E
E
E
E
E
a
a
a
a
a
a
a
a
a
a
a
a
a
a
a
"}
(13,1,1) = {"
a
a
a
a
a
a
a
a
a
a
a
a
a
a
a
a
a
a
a
a
a
a
a
a
a
a
a
a
a
a
a
a
a
a
a
a
a
a
a
a
a
a
a
a
a
a
a
a
a
a
a
a
a
E
E
E
E
v
v
v
v
v
v
v
R
R
R
R
R
R
R
R
R
R
R
R
R
v
v
v
v
v
v
v
E
E
E
E
E
E
E
E
a
a
a
a
a
a
a
a
"}
(14,1,1) = {"
a
a
a
a
a
a
a
a
a
a
a
a
a
a
a
a
a
a
a
a
a
a
a
a
a
a
a
a
a
a
a
a
a
E
E
E
E
E
E
E
E
E
E
E
E
E
E
E
E
E
E
E
E
E
v
v
v
v
R
R
R
R
R
R
R
e
e
e
e
e
e
e
e
e
e
e
R
R
R
R
R
R
R
v
v
v
v
v
v
v
v
E
a
a
a
a
a
a
a
a
"}
(15,1,1) = {"
a
a
a
a
a
a
a
a
a
a
a
a
a
a
a
a
a
a
a
a
a
a
a
a
a
a
a
E
E
E
E
E
E
E
v
v
v
v
v
v
v
v
v
E
E
E
E
E
v
v
v
v
v
v
v
R
R
R
R
e
e
e
e
e
e
e
y
y
y
y
y
y
y
y
y
e
e
e
e
e
e
e
R
e
e
e
e
e
e
e
v
E
a
a
a
a
a
a
a
a
"}
(16,1,1) = {"
a
a
a
a
a
a
a
a
a
a
a
a
a
a
a
a
a
a
a
E
E
E
E
E
E
E
E
E
v
v
v
v
v
v
v
R
R
R
R
R
R
R
v
E
E
E
E
E
v
R
R
R
R
R
R
R
e
e
e
e
y
y
y
y
y
y
y
y
y
y
y
y
y
y
y
y
e
t
t
t
t
t
t
t
e
C
C
C
C
e
v
E
a
a
a
a
a
a
a
a
"}
(17,1,1) = {"
a
a
a
a
a
a
a
a
a
a
a
a
a
a
a
a
a
a
E
E
v
v
v
v
v
v
v
v
v
R
R
R
R
R
R
R
e
e
e
e
e
R
v
E
E
E
E
E
v
R
e
e
e
e
e
e
e
y
y
y
y
y
y
y
y
y
y
y
y
y
y
y
y
y
y
e
e
t
t
t
t
t
t
t
t
C
z
R
R
n
v
E
a
a
a
a
a
a
a
a
"}
(18,1,1) = {"
a
a
a
a
a
a
a
a
a
a
a
a
a
a
a
a
a
E
E
v
v
y
R
R
R
R
R
R
R
R
e
e
e
e
e
e
e
y
y
y
e
R
v
v
v
v
v
v
v
R
e
y
y
y
y
y
y
y
y
y
y
y
y
y
e
e
e
e
e
e
e
e
e
e
e
e
t
t
t
t
t
t
t
t
t
C
z
R
R
e
v
E
a
a
a
a
a
a
a
a
"}
(19,1,1) = {"
a
a
a
a
a
a
a
a
a
a
a
a
a
a
a
a
E
E
v
v
y
y
e
R
e
e
e
e
e
e
e
y
y
y
y
y
y
y
y
y
e
R
R
R
R
R
R
R
R
R
e
y
y
y
y
y
y
y
y
y
y
y
y
e
e
t
t
t
t
t
t
t
t
t
t
t
t
t
t
t
t
t
t
t
t
C
z
R
R
e
v
E
a
a
a
a
a
a
a
a
"}
(20,1,1) = {"
a
a
a
a
a
a
a
a
a
a
a
a
a
a
a
E
E
v
v
y
y
y
e
e
e
y
y
y
y
y
y
y
y
y
y
y
y
y
y
y
e
R
e
e
e
e
e
e
e
R
e
y
y
y
y
y
y
y
y
y
y
y
y
e
t
t
t
t
t
t
t
t
t
t
t
t
t
t
t
t
t
t
t
t
e
C
C
C
C
e
v
E
a
a
a
a
a
a
a
a
"}
(21,1,1) = {"
a
a
a
a
a
a
a
a
a
a
a
a
a
a
E
E
v
v
y
y
y
y
y
e
y
y
y
y
y
y
y
y
y
y
y
y
y
y
y
y
y
y
y
y
y
y
y
y
y
y
y
y
y
y
y
y
y
y
y
y
y
y
y
e
t
t
t
t
e
e
u
u
u
u
u
e
e
t
t
t
t
e
e
e
e
e
e
e
e
e
v
E
a
a
a
a
a
a
a
a
"}
(22,1,1) = {"
a
a
a
a
a
a
a
a
a
a
a
a
a
E
E
v
v
y
y
y
y
y
y
e
y
y
y
y
y
y
y
y
y
y
y
y
y
y
y
y
y
y
y
y
y
y
y
y
y
y
y
y
y
y
y
y
y
y
y
y
y
y
y
e
t
t
t
e
e
a
a
a
a
a
a
a
e
e
t
t
e
e
v
v
v
v
v
v
v
v
v
E
a
a
a
a
a
a
a
a
"}
(23,1,1) = {"
a
a
a
a
a
a
a
a
a
a
a
a
E
E
v
v
y
y
y
y
y
y
y
e
y
y
y
y
y
y
y
y
y
y
y
y
y
y
e
e
R
R
R
R
R
R
R
R
R
R
e
e
e
y
y
y
y
y
y
y
y
y
y
e
t
t
t
e
a
a
a
a
a
a
a
a
a
e
t
t
e
v
v
E
E
E
E
E
E
E
E
E
a
a
a
a
a
a
a
a
"}
(24,1,1) = {"
a
a
a
a
a
a
a
a
a
a
a
a
E
v
v
y
y
y
y
y
y
y
y
e
y
y
y
y
y
y
y
y
y
y
e
e
e
e
e
a
a
a
a
a
a
a
a
a
a
a
a
a
e
e
e
e
e
e
e
e
e
e
e
e
t
t
t
u
a
a
e
u
u
u
e
a
a
u
t
t
e
v
E
E
E
E
E
E
E
E
E
a
a
a
a
a
a
a
a
a
"}
(25,1,1) = {"
a
a
a
a
a
a
a
a
a
a
a
a
E
v
y
y
y
y
y
y
y
y
y
e
y
y
y
y
y
y
y
y
y
e
e
a
a
a
a
a
a
a
a
a
a
a
a
a
a
a
a
a
a
a
a
a
a
a
a
a
a
a
a
e
e
t
t
u
a
a
u
a
a
a
u
a
a
u
t
t
e
v
E
E
E
E
E
E
E
E
E
a
a
a
a
a
a
a
a
a
"}
(26,1,1) = {"
a
a
a
a
a
a
a
a
a
a
a
a
E
v
y
y
y
y
y
y
y
y
y
y
y
y
y
y
y
y
y
y
y
e
a
a
a
a
a
a
a
a
a
a
a
a
a
a
a
a
a
a
a
a
a
a
a
a
a
a
a
a
a
a
e
t
t
u
a
a
u
a
a
a
u
a
a
u
t
t
e
v
E
E
E
E
E
E
E
E
E
a
a
a
a
a
a
a
a
a
"}
(27,1,1) = {"
a
a
a
a
a
a
a
a
a
a
a
a
E
v
y
y
y
y
y
y
y
y
y
e
y
y
y
y
y
y
y
y
y
e
e
a
a
a
a
a
a
a
a
a
a
a
a
a
a
a
a
a
a
a
a
a
a
a
a
a
a
a
a
e
e
t
t
u
a
a
u
a
a
a
u
a
a
u
t
t
e
v
E
E
E
E
E
E
E
E
E
a
a
a
a
a
a
a
a
a
"}
(28,1,1) = {"
a
a
a
a
a
a
a
a
a
a
a
a
E
v
v
y
y
y
y
y
y
y
y
e
y
y
y
y
y
y
y
y
y
y
e
e
e
e
e
a
a
a
a
a
a
a
a
a
a
a
a
a
e
e
e
e
e
e
e
e
e
e
e
e
t
t
t
u
a
a
e
u
u
u
e
a
a
u
t
t
e
v
E
E
E
E
E
E
E
E
E
a
a
a
a
a
a
a
a
a
"}
(29,1,1) = {"
a
a
a
a
a
a
a
a
a
a
a
a
E
E
v
v
y
y
y
y
y
y
y
e
y
y
y
y
y
y
y
y
y
y
y
y
y
y
e
e
R
R
R
R
R
R
R
R
R
R
e
e
e
y
y
y
y
y
y
y
y
y
y
e
t
t
t
e
a
a
a
a
a
a
a
a
a
e
t
t
e
v
v
E
E
E
E
E
E
E
E
E
a
a
a
a
a
a
a
a
"}
(30,1,1) = {"
a
a
a
a
a
a
a
a
a
a
a
a
a
E
E
v
v
y
y
y
y
y
y
e
y
y
y
y
y
y
y
y
y
y
y
y
y
y
y
y
y
y
y
y
y
y
y
y
y
y
y
y
y
y
y
y
y
y
y
y
y
y
y
e
t
t
t
e
e
a
a
a
a
a
a
a
e
e
t
t
e
e
v
v
v
v
v
v
v
v
v
E
a
a
a
a
a
a
a
a
"}
(31,1,1) = {"
a
a
a
a
a
a
a
a
a
a
a
a
a
a
E
E
v
v
y
y
y
y
y
e
y
y
y
y
y
y
y
y
y
y
y
y
y
y
y
y
y
y
y
y
y
y
y
y
y
y
y
y
y
y
y
y
y
y
y
y
y
y
y
e
t
t
t
t
e
e
u
u
u
u
u
e
e
t
t
t
t
e
e
e
e
e
e
e
e
e
v
E
a
a
a
a
a
a
a
a
"}
(32,1,1) = {"
a
a
a
a
a
a
a
a
a
a
a
a
a
a
a
E
E
v
v
y
y
y
e
e
e
y
y
y
y
y
y
y
y
y
y
y
y
y
y
y
e
R
e
e
e
e
e
e
e
R
e
y
y
y
y
y
y
y
y
y
y
y
y
e
t
t
t
t
t
t
t
t
t
t
t
t
t
t
t
t
t
t
t
t
e
C
C
C
C
e
v
E
a
a
a
a
a
a
a
a
"}
(33,1,1) = {"
a
a
a
a
a
a
a
a
a
a
a
a
a
a
a
a
E
E
v
v
y
y
e
R
e
e
e
e
e
e
e
y
y
y
y
y
y
y
y
y
e
R
R
R
R
R
R
R
R
R
e
y
y
y
y
y
y
y
y
y
y
y
y
e
e
t
t
t
t
t
t
t
t
t
t
t
t
t
t
t
t
t
t
t
t
C
z
R
R
n
v
E
a
a
a
a
a
a
a
a
"}
(34,1,1) = {"
a
a
a
a
a
a
a
a
a
a
a
a
a
a
a
a
a
E
E
v
v
y
R
R
R
R
R
R
R
R
e
e
e
e
e
e
e
y
y
y
e
R
v
v
v
v
v
v
v
R
e
y
y
y
y
y
y
y
y
y
y
y
y
y
e
e
e
e
e
e
e
e
e
e
e
e
t
t
t
t
t
t
t
t
t
C
z
R
R
e
v
E
a
a
a
a
a
a
a
a
"}
(35,1,1) = {"
a
a
a
a
a
a
a
a
a
a
a
a
a
a
a
a
a
a
E
E
v
v
v
v
v
v
v
v
v
R
R
R
R
R
R
R
e
e
e
e
e
R
v
E
E
E
E
E
v
R
e
e
e
e
e
e
e
y
y
y
y
y
y
y
y
y
y
y
y
y
y
y
y
y
y
e
e
t
t
t
t
t
t
t
t
C
z
R
R
e
v
E
a
a
a
a
a
a
a
a
"}
(36,1,1) = {"
a
a
a
a
a
a
a
a
a
a
a
a
a
a
a
a
a
a
a
E
E
E
E
E
E
E
E
E
v
v
v
v
v
v
v
R
R
R
R
R
R
R
v
E
E
E
E
E
v
R
R
R
R
R
R
R
e
e
e
e
y
y
y
y
y
y
y
y
y
y
y
y
y
y
y
y
e
t
t
t
t
t
t
t
e
C
C
C
C
e
v
E
a
a
a
a
a
a
a
a
"}
(37,1,1) = {"
a
a
a
a
a
a
a
a
a
a
a
a
a
a
a
a
a
a
a
a
a
a
a
a
a
a
a
E
E
E
E
E
E
E
v
v
v
v
v
v
v
v
v
E
E
E
E
E
v
v
v
v
v
v
v
R
R
R
R
e
e
e
e
e
e
e
y
y
y
y
y
y
y
y
y
e
e
e
e
e
e
e
R
e
e
e
e
e
e
e
v
E
a
a
a
a
a
a
a
a
"}
(38,1,1) = {"
a
a
a
a
a
a
a
a
a
a
a
a
a
a
a
a
a
a
a
a
a
a
a
a
a
a
a
a
a
a
a
a
a
E
E
E
E
E
E
E
E
E
E
E
E
E
E
E
E
E
E
E
E
E
v
v
v
v
R
R
R
R
R
R
R
e
e
e
e
e
e
e
e
e
e
e
R
R
R
R
R
R
R
v
v
v
v
v
v
v
v
E
a
a
a
a
a
a
a
a
"}
(39,1,1) = {"
a
a
a
a
a
a
a
a
a
a
a
a
a
a
a
a
a
a
a
a
a
a
a
a
a
a
a
a
a
a
a
a
a
a
a
a
a
a
a
a
a
a
a
a
a
a
a
a
a
a
a
a
a
E
E
E
E
v
v
v
v
v
v
v
R
R
R
R
R
R
R
R
R
R
R
R
R
v
v
v
v
v
v
v
E
E
E
E
E
E
E
E
a
a
a
a
a
a
a
a
"}
(40,1,1) = {"
a
a
a
a
a
a
a
a
a
a
a
a
a
a
a
a
a
a
a
a
a
a
a
a
a
a
a
a
a
a
a
a
a
a
a
a
a
a
a
a
a
a
a
a
a
a
a
a
a
a
a
a
a
a
a
a
E
E
E
E
E
E
E
v
v
v
v
v
v
v
v
v
v
v
v
v
v
v
E
E
E
E
E
E
E
a
a
a
a
a
a
a
a
a
a
a
a
a
a
a
"}
(41,1,1) = {"
a
a
a
a
a
a
a
a
a
a
a
a
a
a
a
a
a
a
a
a
a
a
a
a
a
a
a
a
a
a
a
a
a
a
a
a
a
a
a
a
a
a
a
a
a
a
a
a
a
a
a
a
a
a
a
a
a
a
a
a
a
a
E
E
E
E
E
E
E
E
E
E
E
E
E
E
E
E
E
a
a
a
a
a
a
a
a
a
a
a
a
a
a
a
a
a
a
a
a
a
"}
(42,1,1) = {"
a
a
a
a
a
a
a
a
a
a
a
a
a
a
a
a
a
a
a
a
a
a
a
a
a
a
a
a
a
a
a
a
a
a
a
a
a
a
a
a
a
a
a
a
a
a
a
a
a
a
a
a
a
a
a
a
a
a
a
a
a
a
a
a
a
a
a
a
a
a
a
a
a
a
a
a
a
a
a
a
a
a
a
a
a
a
a
a
a
a
a
a
a
a
a
a
a
a
a
a
"}
(43,1,1) = {"
a
a
a
a
a
a
a
a
a
a
a
a
a
a
a
a
a
a
a
a
a
a
a
a
a
a
a
a
a
a
a
a
a
a
a
a
a
a
a
a
a
a
a
a
a
a
a
a
a
a
a
a
a
a
a
a
a
a
a
a
a
a
a
a
a
a
a
a
a
a
a
a
a
a
a
a
a
a
a
a
a
a
a
a
a
a
a
a
a
a
a
a
a
a
a
a
a
a
a
a
"}
(44,1,1) = {"
a
a
a
a
a
a
a
a
a
a
a
a
a
a
a
a
a
a
a
a
a
a
a
a
a
a
a
a
a
a
a
a
a
a
a
a
a
a
a
a
a
a
a
a
a
a
a
a
a
a
a
a
a
a
a
a
a
a
a
a
a
a
a
a
a
a
a
a
a
a
a
a
a
a
a
a
a
a
a
a
a
a
a
a
a
a
a
a
a
a
a
a
a
a
a
a
a
a
a
a
"}
(45,1,1) = {"
a
a
a
a
a
a
a
a
a
a
a
a
a
a
a
a
a
a
a
a
a
a
a
a
a
a
a
a
a
a
a
a
a
a
a
a
a
a
a
a
a
a
a
a
a
a
a
a
a
a
a
a
a
a
a
a
a
a
a
a
a
a
a
a
a
a
a
a
a
a
a
a
a
a
a
a
a
a
a
a
a
a
a
a
a
a
a
a
a
a
a
a
a
a
a
a
a
a
a
a
"}
(46,1,1) = {"
a
a
a
a
a
a
a
a
a
a
a
a
a
a
a
a
a
a
a
a
a
a
a
a
a
a
a
a
a
a
a
a
a
a
a
a
a
a
a
a
a
a
a
a
a
a
a
a
a
a
a
a
a
a
a
a
a
a
a
a
a
a
a
a
a
a
a
a
a
a
a
a
a
a
a
a
a
a
a
a
a
a
a
a
a
a
a
a
a
a
a
a
a
a
a
a
a
a
a
a
"}
(47,1,1) = {"
a
a
a
a
a
a
a
a
a
a
a
a
a
a
a
a
a
a
a
a
a
a
a
a
a
a
a
a
a
a
a
a
a
a
a
a
a
a
a
a
a
a
a
a
a
a
a
a
a
a
a
a
a
a
a
a
a
a
a
a
a
a
a
a
a
a
a
a
a
a
a
a
a
a
a
a
a
a
a
a
a
a
a
a
a
a
a
a
a
a
a
a
a
a
a
a
a
a
a
a
"}
(48,1,1) = {"
a
a
a
a
a
a
a
a
a
a
a
a
a
a
a
a
a
a
a
a
a
a
a
a
a
a
a
a
a
a
a
a
a
a
a
a
a
a
a
a
a
a
a
a
a
a
a
a
a
a
a
a
a
a
a
a
a
a
a
a
a
a
a
a
a
a
a
a
a
a
a
a
a
a
a
a
a
a
a
a
a
a
a
a
a
a
a
a
a
a
a
a
a
a
a
a
a
a
a
a
"}
(49,1,1) = {"
a
a
a
a
a
a
a
a
a
a
a
a
a
a
a
a
a
a
a
a
a
a
a
a
a
a
a
a
a
a
a
a
a
a
a
a
a
a
a
a
a
a
a
a
a
a
a
a
a
a
a
a
a
a
a
a
a
a
a
a
a
a
a
a
a
a
a
a
a
a
a
a
a
a
a
a
a
a
a
a
a
a
a
a
a
a
a
a
a
a
a
a
a
a
a
a
a
a
a
a
"}
(50,1,1) = {"
a
a
a
a
a
a
a
a
a
a
a
a
a
a
a
a
a
a
a
a
a
a
a
a
a
a
a
a
a
a
a
a
a
a
a
a
a
a
a
a
a
a
a
a
a
a
a
a
a
a
a
a
a
a
a
a
a
a
a
a
a
a
a
a
a
a
a
a
a
a
a
a
a
a
a
a
a
a
a
a
a
a
a
a
a
a
a
a
a
a
a
a
a
a
a
a
a
a
a
a
"}
