//MAP CONVERTED BY dmm2tgm.py THIS HEADER COMMENT PREVENTS RECONVERSION, DO NOT REMOVE
"a" = (
/obj/effect/turf_decal/tile/hex/red,
/obj/effect/turf_decal/trimline/red/corner,
/turf/open/floor/engine,
/area/ruin/unpowered)
"b" = (
/turf/open/floor/plasteel/dark/side{
	dir = 8
	},
/area/ruin/unpowered)
"c" = (
/obj/effect/turf_decal/tile/red,
/obj/effect/turf_decal/tile/red{
	dir = 1
	},
/obj/effect/turf_decal/tile/red{
	dir = 4
	},
/obj/effect/turf_decal/tile/red{
	dir = 8
	},
/obj/structure/window/reinforced{
	dir = 8
	},
/obj/structure/railing{
	dir = 8
	},
/obj/machinery/computer/secure_data{
	dir = 4
	},
/turf/open/floor/plasteel/dark,
/area/ruin/unpowered)
"d" = (
/obj/structure/chair/office{
	dir = 8
	},
/turf/open/floor/plasteel/dark/corner{
	dir = 8
	},
/area/ruin/unpowered)
"e" = (
/obj/effect/turf_decal/trimline/red/filled/line,
/obj/structure/table/reinforced,
/obj/item/clothing/gloves/color/black{
	pixel_y = 2
	},
/turf/open/floor/plasteel/dark,
/area/ruin/unpowered)
"f" = (
/obj/effect/turf_decal/trimline/red/filled/line,
/obj/structure/table/reinforced,
/obj/item/taperecorder{
	pixel_x = 5;
	pixel_y = 5
	},
/obj/item/restraints/handcuffs,
/obj/item/screwdriver{
	pixel_x = -8;
	pixel_y = 5
	},
/turf/open/floor/plasteel/dark,
/area/ruin/unpowered)
"g" = (
/obj/structure/railing/left{
	dir = 4
	},
/obj/structure/window/reinforced{
	dir = 4
	},
/obj/effect/turf_decal/trimline/red/filled/corner{
	dir = 4
	},
/obj/effect/turf_decal/trimline/red/filled/line{
	dir = 8
	},
/turf/open/floor/plasteel/dark,
/area/ruin/unpowered)
"h" = (
/obj/effect/turf_decal/trimline/red/filled/line{
	dir = 4
	},
/obj/structure/table/reinforced,
/obj/item/storage/backpack/duffelbag/sec/surgery{
	pixel_y = 5
	},
/obj/item/wirecutters{
	pixel_x = 1;
	pixel_y = -11
	},
/turf/open/floor/plasteel/dark,
/area/ruin/unpowered)
"i" = (
/turf/open/floor/plasteel/dark,
/area/ruin/unpowered)
"j" = (
/obj/structure/table/reinforced,
/obj/effect/turf_decal/tile/red,
/obj/effect/turf_decal/tile/red{
	dir = 4
	},
/obj/effect/turf_decal/tile/red{
	dir = 8
	},
/obj/item/storage/firstaid/o2{
	pixel_x = 10;
	pixel_y = 5
	},
/obj/item/stack/medical/suture/emergency,
/obj/item/stack/medical/suture/emergency{
	pixel_y = 6;
	pixel_x = -2
	},
/turf/open/floor/plasteel/dark,
/area/ruin/unpowered)
"k" = (
/obj/effect/turf_decal/trimline/red/filled/warning{
	dir = 4
	},
/obj/effect/turf_decal/trimline/red/filled/line{
	dir = 8
	},
/turf/open/floor/plasteel/dark,
/area/ruin/unpowered)
"l" = (
/turf/open/floor/plasteel/dark/side,
/area/ruin/unpowered)
"m" = (
/turf/open/floor/plasteel/dark/corner{
	dir = 4
	},
/area/ruin/unpowered)
"n" = (
/obj/machinery/light{
	pixel_y = 0
	},
/obj/structure/closet/body_bag,
/obj/effect/mob_spawn/human/corpse/assistant,
/turf/open/floor/plasteel/dark/side,
/area/ruin/unpowered)
"o" = (
/obj/structure/railing{
	dir = 4
	},
/obj/structure/window/reinforced{
	dir = 4
	},
/obj/structure/table/reinforced,
/obj/effect/turf_decal/trimline/red/filled/corner{
	dir = 1
	},
/obj/item/electropack{
	pixel_y = 5
	},
/turf/open/floor/plasteel/dark,
/area/ruin/unpowered)
"p" = (
/obj/effect/turf_decal/trimline/red/filled/line,
/obj/machinery/light{
	dir = 1;
	pixel_y = 0
	},
/turf/open/floor/plasteel/dark,
/area/ruin/unpowered)
"q" = (
/turf/open/floor/plasteel/dark/corner,
/area/ruin/unpowered)
"r" = (
/obj/effect/decal/cleanable/blood/gibs/old,
/obj/structure/chair,
/obj/effect/turf_decal/bot_red,
/turf/open/floor/plasteel/elevatorshaft,
/area/ruin/unpowered)
"s" = (
/turf/closed/wall/r_wall,
/area/ruin/unpowered)
"t" = (
/obj/effect/turf_decal/tile/red{
	dir = 1
	},
/obj/effect/turf_decal/tile/red{
	dir = 4
	},
/obj/effect/turf_decal/tile/red{
	dir = 8
	},
/turf/open/floor/plasteel/dark,
/area/ruin/unpowered)
"u" = (
/obj/structure/window/reinforced{
	dir = 4
	},
/obj/structure/railing/right{
	dir = 4
	},
/obj/effect/turf_decal/trimline/red/filled/corner,
/obj/effect/turf_decal/trimline/red/filled/line{
	dir = 8
	},
/turf/open/floor/plasteel/dark,
/area/ruin/unpowered)
"v" = (
/obj/structure/table/reinforced,
/obj/effect/turf_decal/trimline/red/filled/corner{
	dir = 4
	},
/obj/item/razor{
	pixel_y = 5;
	pixel_x = -5
	},
/obj/item/stack/cable_coil{
	pixel_x = 9;
	pixel_y = 3
	},
/turf/open/floor/plasteel/dark,
/area/ruin/unpowered)
"w" = (
/obj/effect/turf_decal/tile/red{
	dir = 8
	},
/obj/effect/turf_decal/tile/red{
	dir = 1
	},
/obj/effect/turf_decal/tile/red,
/turf/open/floor/plasteel/dark,
/area/ruin/unpowered)
"x" = (
/obj/effect/turf_decal/tile/red{
	dir = 4
	},
/obj/effect/turf_decal/tile/red{
	dir = 8
	},
/obj/effect/turf_decal/tile/red{
	dir = 1
	},
/obj/effect/turf_decal/tile/red,
/obj/structure/safe,
/obj/effect/spawner/lootdrop/pins,
/obj/item/melee/baton/loaded,
/turf/open/floor/plasteel/dark,
/area/ruin/unpowered)
"y" = (
/obj/effect/turf_decal/trimline/red/filled/line{
	dir = 4
	},
/turf/open/floor/plasteel/dark,
/area/ruin/unpowered)
"z" = (
/obj/structure/window/reinforced{
	dir = 4
	},
/obj/structure/railing{
	dir = 4
	},
/obj/effect/turf_decal/trimline/red/filled/corner{
	dir = 8
	},
/obj/structure/table/reinforced,
/obj/item/melee/baseball_bat{
	desc = "A staple of security force interrogations.";
	icon_state = "baseball_bat_metal";
	name = "kneecapper";
	pixel_x = -4
	},
/obj/item/melee/baseball_bat{
	pixel_x = -13
	},
/turf/open/floor/plasteel/dark,
/area/ruin/unpowered)
"A" = (
/obj/effect/turf_decal/tile/hex/red{
	dir = 4
	},
/obj/effect/turf_decal/trimline/red/corner{
	dir = 4
	},
/turf/open/floor/engine,
/area/ruin/unpowered)
"B" = (
/obj/effect/turf_decal/tile/hex/red{
	dir = 8
	},
/obj/effect/turf_decal/tile/hex/red{
	dir = 1
	},
/turf/open/floor/engine,
/area/ruin/unpowered)
"D" = (
/turf/open/floor/plasteel/dark/side{
	dir = 4
	},
/area/ruin/unpowered)
"E" = (
/obj/effect/turf_decal/trimline/red/filled/corner,
/obj/structure/table/reinforced,
/obj/item/shears{
	pixel_x = -5;
	pixel_y = -6
	},
/obj/item/reagent_containers/syringe{
	pixel_x = -5;
	pixel_y = 9
	},
/obj/item/reagent_containers/glass/bottle/toxin{
	pixel_x = 7
	},
/turf/open/floor/plasteel/dark,
/area/ruin/unpowered)
"F" = (
/obj/effect/turf_decal/tile/red{
	dir = 8
	},
/obj/effect/turf_decal/tile/red,
/obj/effect/turf_decal/tile/red{
	dir = 1
	},
/obj/structure/window/reinforced{
	dir = 8
	},
/obj/structure/railing/right{
	dir = 8
	},
/obj/structure/table/reinforced,
/obj/item/pen{
	pixel_y = 8;
	pixel_x = 6
	},
/obj/item/folder/red{
	pixel_x = -2
	},
/obj/item/pen/red{
	pixel_x = 2;
	pixel_y = 5
	},
/turf/open/floor/plasteel/dark,
/area/ruin/unpowered)
"G" = (
/obj/machinery/computer/med_data{
	dir = 4
	},
/obj/effect/turf_decal/tile/red{
	dir = 8
	},
/obj/effect/turf_decal/tile/red,
/obj/effect/turf_decal/tile/red{
	dir = 1
	},
/obj/effect/turf_decal/tile/red{
	dir = 4
	},
/obj/structure/window/reinforced{
	dir = 8
	},
/obj/structure/railing{
	dir = 8
	},
/turf/open/floor/plasteel/dark,
/area/ruin/unpowered)
"H" = (
/obj/structure/table/reinforced,
/obj/effect/turf_decal/tile/red{
	dir = 4
	},
/obj/effect/turf_decal/tile/red{
	dir = 1
	},
/obj/effect/turf_decal/tile/red,
/obj/item/storage/lockbox/loyalty{
	pixel_y = 4
	},
/turf/open/floor/plasteel/dark,
/area/ruin/unpowered)
"I" = (
/obj/effect/turf_decal/tile/hex/red{
	dir = 4
	},
/obj/effect/turf_decal/tile/hex/red{
	dir = 1
	},
/turf/open/floor/engine,
/area/ruin/unpowered)
"J" = (
/obj/effect/turf_decal/trimline/red/filled/line{
	dir = 1
	},
/obj/structure/table/reinforced,
/obj/item/wrench{
	pixel_x = -11
	},
/obj/item/reagent_containers/spray/pepper{
	pixel_x = 8;
	pixel_y = 3
	},
/obj/item/reagent_containers/spray/pepper{
	pixel_x = 3
	},
/turf/open/floor/plasteel/dark,
/area/ruin/unpowered)
"K" = (
/obj/effect/turf_decal/tile/hex/red{
	dir = 1
	},
/obj/effect/decal/cleanable/blood/old,
/obj/effect/decal/cleanable/blood/splatter,
/obj/effect/turf_decal/trimline/red/corner{
	dir = 1
	},
/obj/effect/mob_spawn/human/corpse/assistant,
/turf/open/floor/engine,
/area/ruin/unpowered)
"L" = (
/obj/effect/turf_decal/tile/hex/red{
	dir = 8
	},
/obj/effect/turf_decal/tile/hex/red,
/turf/open/floor/engine,
/area/ruin/unpowered)
"N" = (
/obj/structure/table/reinforced,
/obj/effect/turf_decal/trimline/red/filled/line{
	dir = 1
	},
/obj/item/assembly/signaler{
	pixel_y = 5;
	pixel_x = 15
	},
/obj/item/assembly/signaler{
	pixel_y = 3;
	pixel_x = 7
	},
/obj/item/weldingtool{
	pixel_y = 3;
	pixel_x = -6
	},
/turf/open/floor/plasteel/dark,
/area/ruin/unpowered)
"O" = (
/obj/effect/turf_decal/trimline/red/filled/line{
	dir = 1
	},
/obj/machinery/light{
	pixel_y = 0
	},
/turf/open/floor/plasteel/dark,
/area/ruin/unpowered)
"P" = (
/turf/open/floor/plasteel/dark/side{
	dir = 1
	},
/area/ruin/unpowered)
"Q" = (
/obj/effect/turf_decal/tile/hex/red{
	dir = 4
	},
/obj/effect/turf_decal/tile/hex/red,
/obj/effect/decal/cleanable/blood/old,
/turf/open/floor/engine,
/area/ruin/unpowered)
"R" = (
/obj/effect/turf_decal/tile/hex/red{
	dir = 8
	},
/obj/effect/turf_decal/trimline/red/corner{
	dir = 8
	},
/turf/open/floor/engine,
/area/ruin/unpowered)
"S" = (
/obj/effect/turf_decal/tile/red{
	dir = 4
	},
/obj/effect/turf_decal/tile/red{
	dir = 1
	},
/obj/effect/turf_decal/tile/red,
/turf/open/floor/plasteel/dark,
/area/ruin/unpowered)
"T" = (
/obj/effect/turf_decal/tile/red,
/obj/structure/table/reinforced,
/obj/effect/turf_decal/tile/red{
	dir = 8
	},
/obj/effect/turf_decal/tile/red{
	dir = 1
	},
/obj/effect/turf_decal/tile/red{
	dir = 4
	},
/obj/effect/spawner/lootdrop/ruinloot/security,
/turf/open/floor/plasteel/dark,
/area/ruin/unpowered)
"U" = (
/obj/structure/chair/office{
	dir = 8
	},
/turf/open/floor/plasteel/dark/corner{
	dir = 1
	},
/area/ruin/unpowered)
"V" = (
/obj/structure/table/reinforced,
/obj/effect/turf_decal/tile/red{
	dir = 8
	},
/obj/effect/turf_decal/tile/red{
	dir = 1
	},
/obj/effect/turf_decal/tile/red{
	dir = 4
	},
/obj/structure/window/reinforced{
	dir = 8
	},
/obj/structure/railing/left{
	dir = 8
	},
/obj/item/folder/red{
	pixel_x = -2
	},
/obj/item/folder/red{
	pixel_x = 4;
	pixel_y = 3
	},
/obj/item/restraints/handcuffs,
/turf/open/floor/plasteel/dark,
/area/ruin/unpowered)
"W" = (
/obj/effect/turf_decal/trimline/red/filled/line{
	dir = 4
	},
/obj/structure/table/reinforced,
/obj/item/clothing/neck/stethoscope{
	pixel_y = 12;
	pixel_x = 1
	},
/obj/item/flashlight/seclite,
/turf/open/floor/plasteel/dark,
/area/ruin/unpowered)
"X" = (
/obj/effect/abstract/doorway_marker{
	dir = 4
	},
/turf/open/floor/plasteel,
/area/ruin/unpowered)
"Y" = (
/obj/effect/turf_decal/tile/red,
/obj/effect/turf_decal/tile/red{
	dir = 4
	},
/obj/effect/turf_decal/tile/red{
	dir = 8
	},
/turf/open/floor/plasteel/dark,
/area/ruin/unpowered)
"Z" = (
/obj/machinery/light{
	dir = 1;
	pixel_y = 0
	},
/obj/effect/decal/cleanable/blood/old,
/obj/structure/closet/body_bag,
/turf/open/floor/plasteel/dark/side{
	dir = 1
	},
/area/ruin/unpowered)

(1,1,1) = {"
s
s
s
s
s
s
s
"}
(2,1,1) = {"
s
E
W
y
h
v
s
"}
(3,1,1) = {"
s
f
a
Q
A
J
s
"}
(4,1,1) = {"
s
p
L
r
I
O
s
"}
(5,1,1) = {"
s
e
R
B
K
N
s
"}
(6,1,1) = {"
s
z
u
k
g
o
s
"}
(7,1,1) = {"
s
c
V
b
F
G
s
"}
(8,1,1) = {"
s
t
U
D
d
w
s
"}
(9,1,1) = {"
s
Z
l
i
P
n
s
"}
(10,1,1) = {"
s
H
m
b
q
j
s
"}
(11,1,1) = {"
s
x
S
D
Y
T
s
"}
(12,1,1) = {"
s
s
s
X
s
s
s
"}
