//MAP CONVERTED BY dmm2tgm.py THIS HEADER COMMENT PREVENTS RECONVERSION, DO NOT REMOVE
"c" = (
/obj/structure/closet/crate,
/turf/open/floor/plasteel,
/area/ruin/unpowered)
"d" = (
/obj/effect/turf_decal/delivery,
/obj/structure/closet/crate,
/obj/item/stack/sheet/plasteel/twenty,
/turf/open/floor/plasteel,
/area/ruin/unpowered)
"e" = (
/obj/effect/turf_decal/delivery,
/obj/structure/closet/crate/medical,
/obj/item/storage/firstaid/regular{
	empty = 1;
	name = "First-Aid (empty)"
	},
/obj/item/storage/firstaid/o2,
/turf/open/floor/plasteel,
/area/ruin/unpowered)
"g" = (
/turf/open/floor/plasteel,
/area/ruin/unpowered)
"i" = (
/obj/effect/spawner/random/maintenance/eight,
/obj/structure/closet/crate,
/turf/open/floor/plasteel,
/area/ruin/unpowered)
"j" = (
/obj/structure/closet/crate,
/obj/effect/spawner/lootdrop/ruinloot/basic,
/turf/open/floor/plasteel,
/area/ruin/unpowered)
"l" = (
/obj/effect/turf_decal/delivery,
/obj/structure/closet/crate/engineering,
/obj/item/multitool,
/turf/open/floor/plasteel,
/area/ruin/unpowered)
"m" = (
/obj/effect/turf_decal/delivery,
/obj/structure/closet/crate,
/obj/item/stack/sheet/iron/fifty,
/obj/item/stack/sheet/iron/fifty,
/obj/effect/spawner/lootdrop/ruinloot/basic,
/turf/open/floor/plasteel,
/area/ruin/unpowered)
"o" = (
/obj/effect/turf_decal/delivery,
/obj/structure/closet/crate,
/obj/item/modular_computer/tablet/pda/clear,
/obj/effect/spawner/lootdrop/ruinloot/important,
/turf/open/floor/plasteel,
/area/ruin/unpowered)
"p" = (
/obj/effect/turf_decal/delivery,
/obj/structure/closet/crate,
/obj/item/storage/pill_bottle/stimulant,
/obj/effect/spawner/lootdrop/ruinloot/basic,
/turf/open/floor/plasteel,
/area/ruin/unpowered)
"q" = (
/obj/effect/abstract/open_area_marker,
/turf/open/floor/plasteel,
/area/ruin/unpowered)
"r" = (
/obj/effect/spawner/structure/window/reinforced/derelict,
/turf/open/floor/circuit,
/area/ruin/unpowered)
"s" = (
/obj/effect/turf_decal/delivery,
/obj/structure/closet/crate/medical,
/obj/item/storage/firstaid/regular,
/obj/effect/spawner/lootdrop/ruinloot/medical,
/obj/effect/spawner/lootdrop/ruinloot/medical,
/turf/open/floor/plasteel,
/area/ruin/unpowered)
"t" = (
/obj/effect/spawner/lootdrop/glowstick/on,
/turf/open/floor/plasteel,
/area/ruin/unpowered)
"u" = (
/obj/effect/turf_decal/delivery,
/obj/structure/closet/crate,
/obj/item/stack/sheet/cardboard/fifty,
/obj/effect/spawner/lootdrop/ruinloot/basic,
/turf/open/floor/plasteel,
/area/ruin/unpowered)
"x" = (
/obj/effect/turf_decal/delivery,
/obj/structure/closet/crate/engineering,
/obj/item/storage/toolbox/mechanical,
/turf/open/floor/plasteel,
/area/ruin/unpowered)
"z" = (
/obj/structure/closet/crate,
/obj/effect/spawner/random/exotic/antag_gear_weak,
/obj/effect/spawner/random/exotic/antag_gear,
/turf/open/floor/plasteel,
/area/ruin/unpowered)
"C" = (
/obj/structure/closet/crate,
/obj/effect/spawner/lootdrop/ruinloot/armoury,
/turf/open/floor/plasteel,
/area/ruin/unpowered)
"D" = (
/obj/effect/turf_decal/delivery,
/obj/structure/closet/crate,
/obj/item/pai_card,
/turf/open/floor/plasteel,
/area/ruin/unpowered)
"E" = (
/obj/effect/turf_decal/delivery,
/obj/structure/closet/crate/medical,
/obj/item/storage/firstaid/brute,
/obj/item/storage/firstaid/fire,
/obj/effect/spawner/lootdrop/ruinloot/science,
/turf/open/floor/plasteel,
/area/ruin/unpowered)
"G" = (
/obj/effect/abstract/open_area_marker{
	dir = 1
	},
/turf/open/floor/plasteel,
/area/ruin/unpowered)
"M" = (
/obj/effect/turf_decal/delivery,
/obj/structure/closet/crate/internals,
/obj/item/storage/firstaid/toxin,
/obj/item/tank/internals/emergency_oxygen/engi,
/obj/item/tank/internals/emergency_oxygen/engi,
/turf/open/floor/plasteel,
/area/ruin/unpowered)
"N" = (
/obj/structure/closet/crate,
/obj/effect/spawner/lootdrop/ruinloot/science,
/turf/open/floor/plasteel,
/area/ruin/unpowered)
"O" = (
/obj/effect/turf_decal/delivery,
/obj/machinery/suit_storage_unit/standard_unit,
/turf/open/floor/plasteel,
/area/ruin/unpowered)
"U" = (
/turf/closed/wall/riveted_wall,
/area/ruin/unpowered)
"V" = (
/obj/effect/spawner/lootdrop/genetics_filler,
/obj/structure/closet/crate,
/turf/open/floor/plasteel,
/area/ruin/unpowered)
"X" = (
/obj/effect/spawner/random/clothing/gloves,
/obj/structure/closet/crate,
/turf/open/floor/plasteel,
/area/ruin/unpowered)
"Y" = (
/obj/effect/turf_decal/delivery,
/obj/structure/closet/crate/secure/loot,
/turf/open/floor/plasteel,
/area/ruin/unpowered)
"Z" = (
/obj/effect/turf_decal/delivery,
/obj/structure/closet/crate,
/obj/item/target/alien,
/obj/item/target/alien,
/obj/item/target/clown,
/obj/item/target/syndicate,
/turf/open/floor/plasteel,
/area/ruin/unpowered)

(1,1,1) = {"
U
U
U
U
U
U
U
U
U
"}
(2,1,1) = {"
U
g
i
p
Y
Y
g
M
U
"}
(3,1,1) = {"
U
O
g
g
C
g
g
u
U
"}
(4,1,1) = {"
U
O
t
g
g
g
g
c
U
"}
(5,1,1) = {"
U
g
g
U
s
g
d
l
U
"}
(6,1,1) = {"
g
g
g
r
x
g
g
g
g
"}
(7,1,1) = {"
G
g
g
r
g
j
g
g
q
"}
(8,1,1) = {"
g
g
g
r
Z
E
g
g
g
"}
(9,1,1) = {"
U
g
g
U
z
g
g
g
U
"}
(10,1,1) = {"
U
g
g
g
g
g
t
N
U
"}
(11,1,1) = {"
U
V
g
g
g
g
g
X
U
"}
(12,1,1) = {"
U
Y
Y
D
g
m
e
o
U
"}
(13,1,1) = {"
U
U
U
U
U
U
U
U
U
"}
