//MAP CONVERTED BY dmm2tgm.py THIS HEADER COMMENT PREVENTS RECONVERSION, DO NOT REMOVE
"aW" = (
/turf/open/floor/plasteel/white,
/area/ruin/unpowered)
"aY" = (
/obj/effect/decal/remains/human,
/obj/structure/showcase/machinery/cloning_pod,
/turf/open/floor/plasteel/showroomfloor,
/area/ruin/unpowered)
"bb" = (
/obj/structure/table/reinforced,
/obj/effect/spawner/random/structure/crate_abandoned,
/turf/open/floor/plasteel,
/area/ruin/unpowered)
"bs" = (
/obj/machinery/door/airlock/highsecurity,
/obj/effect/mapping_helpers/airlock/locked,
/turf/open/floor/plasteel,
/area/ruin/unpowered)
"bt" = (
/obj/effect/decal/cleanable/blood,
/obj/effect/decal/cleanable/dirt,
/turf/open/floor/plasteel/showroomfloor,
/area/ruin/unpowered)
"cF" = (
/obj/machinery/door/airlock/highsecurity,
/turf/open/floor/plasteel/showroomfloor,
/area/ruin/unpowered)
"de" = (
/turf/open/floor/plasteel/airless,
/area/ruin/unpowered)
"dS" = (
/obj/effect/turf_decal/tile/purple{
	dir = 8
	},
/obj/effect/turf_decal/tile/purple{
	dir = 1
	},
/obj/effect/turf_decal/tile/purple,
/obj/structure/window/reinforced{
	dir = 8;
	pixel_x = -5
	},
/obj/machinery/iv_drip,
/turf/open/floor/plasteel/white,
/area/ruin/unpowered)
"dV" = (
/obj/structure/showcase/machinery/oldpod,
/turf/open/floor/plasteel/showroomfloor,
/area/ruin/unpowered)
"eh" = (
/obj/machinery/computer/rdconsole{
	dir = 8
	},
/turf/open/floor/plasteel/white,
/area/ruin/unpowered)
"fE" = (
/obj/effect/decal/cleanable/dirt,
/obj/structure/closet/secure_closet/personal,
/turf/open/floor/plasteel,
/area/ruin/unpowered)
"fF" = (
/obj/machinery/door/airlock/hatch,
/turf/open/floor/plasteel,
/area/ruin/unpowered)
"gv" = (
/obj/effect/abstract/open_area_marker{
	dir = 4
	},
/turf/open/floor/plasteel/airless,
/area/ruin/unpowered)
"gZ" = (
/obj/structure/chair/office{
	dir = 8
	},
/turf/open/floor/plasteel/dark,
/area/ruin/unpowered)
"hp" = (
/obj/effect/decal/cleanable/dirt,
/obj/structure/showcase/horrific_experiment,
/turf/open/floor/plasteel/showroomfloor,
/area/ruin/unpowered)
"hQ" = (
/obj/effect/turf_decal/tile/purple{
	dir = 1
	},
/obj/effect/turf_decal/tile/purple{
	dir = 4
	},
/obj/effect/turf_decal/tile/purple,
/obj/machinery/chem_heater,
/obj/structure/window/reinforced{
	dir = 1;
	pixel_y = 5
	},
/turf/open/floor/plasteel/white,
/area/ruin/unpowered)
"iW" = (
/obj/effect/decal/cleanable/dirt,
/turf/open/floor/plasteel/showroomfloor,
/area/ruin/unpowered)
"kw" = (
/obj/structure/closet/crate/secure/weapon{
	req_access_txt = "203"
	},
/obj/item/storage/box/firingpins,
/obj/effect/decal/cleanable/dirt,
/turf/open/floor/plasteel/dark,
/area/ruin/unpowered)
"kA" = (
/obj/structure/window/reinforced{
	dir = 1;
	pixel_y = 5
	},
/turf/open/floor/plasteel/white,
/area/ruin/unpowered)
"kC" = (
/obj/effect/decal/cleanable/dirt,
/obj/structure/showcase/machinery/oldpod,
/turf/open/floor/plasteel/showroomfloor,
/area/ruin/unpowered)
"lf" = (
/turf/closed/wall/riveted_wall,
/area/ruin/unpowered)
"lk" = (
/turf/closed/wall/r_wall,
/area/ruin/unpowered)
"lZ" = (
/obj/structure/table/reinforced,
/obj/item/paper/fluff/ruins/oldstation,
/obj/item/storage/toolbox/syndicate,
/turf/open/floor/plasteel,
/area/ruin/unpowered)
"mh" = (
/obj/effect/decal/cleanable/dirt,
/obj/structure/table/reinforced,
/obj/effect/spawner/random/clothing/costume,
/obj/effect/spawner/random/clothing/gloves,
/turf/open/floor/plasteel,
/area/ruin/unpowered)
"mj" = (
/obj/item/gun/energy/e_gun/old,
/obj/effect/decal/cleanable/dirt,
/obj/structure/safe,
/turf/open/floor/plasteel/dark,
/area/ruin/unpowered)
"mW" = (
/obj/machinery/rnd/production/circuit_imprinter,
/obj/item/reagent_containers/dropper,
/obj/structure/window/reinforced{
	dir = 8;
	pixel_x = -5
	},
/turf/open/floor/plasteel/white,
/area/ruin/unpowered)
"nX" = (
/obj/effect/turf_decal/tile/purple{
	dir = 8
	},
/obj/effect/turf_decal/tile/purple{
	dir = 1
	},
/obj/effect/turf_decal/tile/purple{
	dir = 4
	},
/obj/structure/window/reinforced{
	dir = 8;
	pixel_x = -5
	},
/obj/structure/window/reinforced{
	dir = 1;
	pixel_y = 5
	},
/obj/structure/closet/crate/freezer/blood,
/turf/open/floor/plasteel/white,
/area/ruin/unpowered)
"ps" = (
/obj/structure/chair/office/light,
/turf/open/floor/carpet/red,
/area/ruin/unpowered)
"sU" = (
/turf/open/floor/plasteel,
/area/ruin/unpowered)
"td" = (
/obj/effect/decal/cleanable/dirt,
/turf/open/floor/plasteel/white,
/area/ruin/unpowered)
"te" = (
/obj/structure/table/reinforced,
/obj/item/flashlight/glowstick,
/obj/effect/decal/cleanable/dirt,
/turf/open/floor/plasteel,
/area/ruin/unpowered)
"uh" = (
/obj/structure/table/reinforced,
/obj/item/healthanalyzer{
	desc = "A prototype hand-held body scanner able to distinguish vital signs of the subject.";
	name = "prototype health analyzer"
	},
/turf/open/floor/plasteel/dark,
/area/ruin/unpowered)
"uO" = (
/obj/effect/decal/cleanable/dirt,
/turf/open/floor/plasteel,
/area/ruin/unpowered)
"vR" = (
/obj/structure/closet/secure_closet/personal,
/turf/open/floor/plasteel,
/area/ruin/unpowered)
"wp" = (
/turf/open/floor/carpet/red,
/area/ruin/unpowered)
"ww" = (
/obj/effect/decal/cleanable/blood/splatter,
/obj/effect/decal/cleanable/dirt,
/obj/structure/showcase/machinery/cloning_pod,
/turf/open/floor/plasteel/showroomfloor,
/area/ruin/unpowered)
"wJ" = (
/obj/structure/table/reinforced,
/obj/item/assembly/flash/handheld,
/obj/machinery/recharger,
/turf/open/floor/plasteel/dark,
/area/ruin/unpowered)
"yg" = (
/turf/open/floor/plasteel/showroomfloor,
/area/ruin/unpowered)
"yL" = (
/obj/effect/turf_decal/tile/purple{
	dir = 8
	},
/obj/effect/turf_decal/tile/purple,
/obj/effect/turf_decal/tile/purple{
	dir = 4
	},
/obj/structure/table,
/obj/item/stock_parts/manipulator,
/obj/item/stock_parts/capacitor,
/obj/item/stock_parts/micro_laser,
/obj/item/stack/cable_coil,
/obj/item/stock_parts/matter_bin,
/obj/item/stock_parts/scanning_module{
	pixel_x = 2;
	pixel_y = 3
	},
/turf/open/floor/plasteel/white,
/area/ruin/unpowered)
"zy" = (
/obj/structure/table/optable{
	name = "Robotics Operating Table"
	},
/obj/effect/decal/cleanable/dirt,
/obj/structure/window/reinforced{
	dir = 8;
	pixel_x = -5
	},
/turf/open/floor/plasteel/white,
/area/ruin/unpowered)
"Au" = (
/obj/structure/table,
/obj/item/stack/sheet/iron/fifty,
/obj/item/stack/sheet/glass/fifty{
	pixel_x = 3;
	pixel_y = 3
	},
/turf/open/floor/plasteel/white,
/area/ruin/unpowered)
"Cq" = (
/obj/structure/table/reinforced,
/obj/item/folder/red,
/turf/open/floor/carpet/red,
/area/ruin/unpowered)
"Dg" = (
/obj/effect/turf_decal/tile/purple{
	dir = 8
	},
/obj/effect/turf_decal/tile/purple,
/obj/effect/turf_decal/tile/purple{
	dir = 1
	},
/obj/structure/window/reinforced{
	dir = 8;
	pixel_x = -5
	},
/obj/structure/window/reinforced{
	pixel_y = -5
	},
/turf/open/floor/plasteel/white,
/area/ruin/unpowered)
"Dy" = (
/obj/structure/table/reinforced,
/obj/item/reagent_containers/food/drinks/soda_cans/cola,
/turf/open/floor/carpet/red,
/area/ruin/unpowered)
"Ef" = (
/obj/effect/turf_decal/tile/purple{
	dir = 4
	},
/obj/effect/turf_decal/tile/purple,
/obj/effect/turf_decal/tile/purple{
	dir = 8
	},
/obj/structure/window/reinforced{
	pixel_y = -5
	},
/turf/open/floor/plasteel/white,
/area/ruin/unpowered)
"Em" = (
/obj/structure/chair/office/light{
	dir = 4
	},
/turf/open/floor/carpet/red,
/area/ruin/unpowered)
"FZ" = (
/obj/machinery/chem_master,
/obj/item/reagent_containers/glass/beaker,
/turf/open/floor/plasteel/white,
/area/ruin/unpowered)
"Gu" = (
/obj/effect/spawner/structure/window/reinforced/derelict,
/turf/open/floor/circuit,
/area/ruin/unpowered)
"GX" = (
/obj/structure/closet/crate,
/obj/item/storage/backpack/old,
/obj/item/storage/backpack/old,
/obj/item/gun/energy/laser/retro,
/turf/open/floor/plasteel,
/area/ruin/unpowered)
"HT" = (
/obj/effect/turf_decal/tile/purple{
	dir = 8
	},
/obj/effect/turf_decal/tile/purple{
	dir = 1
	},
/obj/effect/turf_decal/tile/purple{
	dir = 4
	},
/obj/structure/window/reinforced{
	dir = 8;
	pixel_x = -5
	},
/turf/open/floor/plasteel/white,
/area/ruin/unpowered)
"Iw" = (
/obj/machinery/the_singularitygen,
/turf/open/floor/plasteel/dark,
/area/ruin/unpowered)
"JG" = (
/obj/effect/decal/cleanable/dirt,
/obj/structure/showcase/machinery/cloning_pod,
/turf/open/floor/plasteel/showroomfloor,
/area/ruin/unpowered)
"Ks" = (
/obj/structure/table/reinforced,
/obj/item/crowbar,
/obj/item/flashlight/glowstick,
/turf/open/floor/plasteel,
/area/ruin/unpowered)
"KM" = (
/obj/effect/decal/cleanable/dirt,
/obj/structure/closet/crate,
/obj/item/retractor,
/obj/item/hemostat,
/obj/item/scalpel{
	pixel_y = 12
	},
/obj/item/cautery{
	pixel_x = 4
	},
/obj/item/clothing/neck/stethoscope,
/obj/item/circular_saw,
/turf/open/floor/plasteel,
/area/ruin/unpowered)
"KT" = (
/obj/effect/decal/cleanable/dirt,
/turf/open/floor/plasteel/dark,
/area/ruin/unpowered)
"Ln" = (
/obj/structure/table/reinforced,
/obj/item/paper,
/obj/item/pen,
/turf/open/floor/carpet/red,
/area/ruin/unpowered)
"LZ" = (
/obj/structure/closet/secure_closet/security/science,
/turf/open/floor/carpet/red,
/area/ruin/unpowered)
"OX" = (
/obj/machinery/computer{
	dir = 4
	},
/obj/effect/decal/cleanable/dirt,
/turf/open/floor/plasteel/dark,
/area/ruin/unpowered)
"Pd" = (
/obj/structure/table/reinforced,
/obj/item/clothing/gloves/color/yellow,
/obj/item/clothing/gloves/color/yellow,
/turf/open/floor/plasteel/dark,
/area/ruin/unpowered)
"Pw" = (
/obj/structure/showcase/machinery/cloning_pod,
/turf/open/floor/plasteel/showroomfloor,
/area/ruin/unpowered)
"QB" = (
/obj/structure/window/reinforced{
	pixel_y = -5
	},
/turf/open/floor/plasteel/white,
/area/ruin/unpowered)
"Rr" = (
/turf/open/floor/plasteel/dark,
/area/ruin/unpowered)
"SG" = (
/obj/structure/table/reinforced,
/obj/effect/spawner/random/clothing/costume,
/obj/effect/spawner/random/clothing/gloves,
/turf/open/floor/plasteel,
/area/ruin/unpowered)
"Uh" = (
/obj/machinery/rnd/destructive_analyzer,
/obj/structure/window/reinforced{
	dir = 8;
	pixel_x = -5
	},
/turf/open/floor/plasteel/white,
/area/ruin/unpowered)
"UA" = (
/obj/effect/decal/cleanable/dirt,
/obj/structure/closet/secure_closet/personal,
/obj/item/gun/energy/laser/retro,
/turf/open/floor/plasteel,
/area/ruin/unpowered)
"Vu" = (
/obj/structure/table/reinforced,
/obj/item/clothing/suit/armor/vest/old,
/obj/item/clothing/head/helmet/old,
/turf/open/floor/plasteel/dark,
/area/ruin/unpowered)
"VC" = (
/obj/machinery/computer{
	dir = 4
	},
/turf/open/floor/plasteel/dark,
/area/ruin/unpowered)
"Wc" = (
/obj/item/clothing/suit/space/hardsuit/ancient,
/obj/structure/rack,
/turf/open/floor/plasteel/dark,
/area/ruin/unpowered)
"Wh" = (
/obj/structure/table/reinforced,
/turf/open/floor/carpet/red,
/area/ruin/unpowered)
"Wt" = (
/obj/structure/chair/office{
	dir = 8
	},
/obj/effect/decal/cleanable/dirt,
/turf/open/floor/plasteel/dark,
/area/ruin/unpowered)
"WT" = (
/obj/effect/turf_decal/tile/purple{
	dir = 1
	},
/obj/effect/turf_decal/tile/purple{
	dir = 4
	},
/obj/effect/turf_decal/tile/purple,
/turf/open/floor/plasteel/white,
/area/ruin/unpowered)
"Yp" = (
/obj/machinery/rnd/production/protolathe,
/turf/open/floor/plasteel/white,
/area/ruin/unpowered)
"Zo" = (
/obj/structure/table,
/obj/item/tank/internals/anesthetic,
/obj/item/clothing/mask/breath/medical,
/obj/effect/decal/cleanable/dirt,
/obj/structure/window/reinforced{
	dir = 8;
	pixel_x = -5
	},
/turf/open/floor/plasteel/white,
/area/ruin/unpowered)

(1,1,1) = {"
lk
lk
lk
lk
lk
lk
lk
lk
lk
lf
lf
lf
lf
lf
lf
lf
lf
"}
(2,1,1) = {"
lk
dV
dV
kC
iW
hp
aY
Pw
lk
GX
sU
sU
wp
wp
wp
LZ
lf
"}
(3,1,1) = {"
lk
iW
bt
iW
iW
iW
yg
yg
cF
sU
uO
sU
Dy
ps
wp
Em
lf
"}
(4,1,1) = {"
lk
dV
dV
dV
iW
ww
hp
JG
lk
fE
uO
uO
Wh
Wh
Cq
Ln
lf
"}
(5,1,1) = {"
lk
lk
Gu
Gu
Gu
Gu
lk
lk
lk
UA
uO
uO
uO
uO
sU
uO
lf
"}
(6,1,1) = {"
lk
wJ
VC
VC
Vu
OX
Pd
Gu
Ks
uO
uO
uO
uO
uO
uO
sU
lf
"}
(7,1,1) = {"
lk
Rr
Rr
Wt
KT
gZ
Rr
Gu
lZ
uO
sU
uO
sU
uO
uO
sU
lf
"}
(8,1,1) = {"
lk
KT
Rr
Rr
KT
Rr
Rr
Gu
te
uO
vR
vR
bb
mh
bb
SG
lf
"}
(9,1,1) = {"
lk
mj
KT
kw
uh
Iw
Wc
lk
lf
fF
lf
lf
lf
Gu
Gu
lf
lf
"}
(10,1,1) = {"
lk
lk
bs
lk
Gu
Gu
lk
lk
sU
sU
sU
lf
sU
sU
sU
sU
lf
"}
(11,1,1) = {"
lf
sU
sU
uO
uO
uO
uO
uO
sU
uO
sU
lf
sU
sU
sU
sU
lf
"}
(12,1,1) = {"
lf
sU
uO
uO
uO
uO
sU
sU
sU
uO
sU
fF
sU
sU
de
de
lf
"}
(13,1,1) = {"
lf
HT
Uh
mW
Dg
sU
sU
nX
Zo
zy
dS
lf
sU
de
de
de
lf
"}
(14,1,1) = {"
lf
aW
td
td
QB
sU
sU
kA
td
aW
td
lf
lf
de
de
de
lf
"}
(15,1,1) = {"
lf
aW
aW
td
aW
uO
sU
aW
aW
aW
aW
Au
lf
de
de
de
lf
"}
(16,1,1) = {"
lf
WT
eh
Yp
Ef
KM
uO
hQ
aW
FZ
aW
yL
lf
de
de
de
lf
"}
(17,1,1) = {"
lf
lf
lf
lf
lf
lf
lf
lf
lf
lf
lf
lf
lf
de
gv
de
lf
"}
