//MAP CONVERTED BY dmm2tgm.py THIS HEADER COMMENT PREVENTS RECONVERSION, DO NOT REMOVE
"aa" = (
/turf/template_noop,
/area/template_noop)
"ac" = (
/obj/effect/spawner/structure/window/reinforced/derelict,
/turf/open/floor/circuit,
/area/ruin/unpowered)
"ah" = (
/turf/closed/mineral/random,
/area/ruin/unpowered)
"ai" = (
/turf/open/floor/plating/asteroid,
/area/ruin/unpowered)
"aj" = (
/obj/structure/flora/rock,
/turf/open/floor/plating/asteroid,
/area/ruin/unpowered)
"al" = (
/obj/structure/flora/ausbushes/genericbush,
/turf/open/floor/grass,
/area/ruin/unpowered)
"am" = (
/mob/living/simple_animal/hostile/poison/bees,
/mob/living/simple_animal/hostile/poison/bees,
/mob/living/simple_animal/hostile/poison/bees,
/mob/living/simple_animal/hostile/poison/bees,
/mob/living/simple_animal/hostile/poison/bees,
/mob/living/simple_animal/hostile/poison/bees,
/turf/open/floor/grass,
/area/ruin/unpowered)
"an" = (
/mob/living/simple_animal/hostile/poison/bees,
/turf/open/floor/grass,
/area/ruin/unpowered)
"ao" = (
/obj/structure/flora/ausbushes/lavendergrass,
/turf/open/floor/grass,
/area/ruin/unpowered)
"ap" = (
/mob/living/simple_animal/hostile/asteroid/goldgrub{
	will_burrow = 0
	},
/turf/open/floor/plating/asteroid,
/area/ruin/unpowered)
"aq" = (
/obj/structure/flora/ausbushes/grassybush,
/turf/open/floor/grass,
/area/ruin/unpowered)
"ar" = (
/obj/structure/flora/rock/pile,
/turf/open/floor/plating/asteroid,
/area/ruin/unpowered)
"as" = (
/mob/living/simple_animal/hostile/asteroid/basilisk,
/turf/open/floor/plating/asteroid,
/area/ruin/unpowered)
"at" = (
/turf/closed/wall/r_wall,
/area/ruin/unpowered)
"au" = (
/obj/structure/flora/ausbushes/leafybush,
/mob/living/simple_animal/hostile/poison/bees,
/turf/open/floor/grass,
/area/ruin/unpowered)
"av" = (
/obj/structure/flora/ausbushes/brflowers,
/turf/open/floor/grass,
/area/ruin/unpowered)
"aw" = (
/obj/structure/flora/rock,
/obj/machinery/light,
/turf/open/floor/plating/asteroid,
/area/ruin/unpowered)
"ax" = (
/obj/structure/table/reinforced,
/obj/item/clipboard,
/obj/item/clothing/mask/surgical,
/obj/item/razor,
/obj/machinery/light{
	dir = 8
	},
/turf/open/floor/plasteel/dark/side,
/area/ruin/unpowered)
"ay" = (
/obj/effect/turf_decal/tile/green{
	dir = 1
	},
/obj/effect/turf_decal/tile/green,
/obj/effect/turf_decal/tile/green{
	dir = 4
	},
/obj/effect/turf_decal/tile/green{
	dir = 8
	},
/turf/open/floor/plasteel/dark,
/area/ruin/unpowered)
"az" = (
/obj/structure/table/reinforced,
/obj/item/storage/box/syringes{
	pixel_x = 5;
	pixel_y = 5
	},
/obj/item/storage/box/beakers,
/obj/machinery/light{
	dir = 4
	},
/turf/open/floor/plasteel/dark/side,
/area/ruin/unpowered)
"aA" = (
/obj/structure/flora/ausbushes/ywflowers,
/turf/open/floor/grass,
/area/ruin/unpowered)
"aB" = (
/obj/machinery/light,
/mob/living/simple_animal/hostile/poison/bees,
/turf/open/floor/grass,
/area/ruin/unpowered)
"aC" = (
/obj/structure/flora/ausbushes/ppflowers,
/turf/open/floor/grass,
/area/ruin/unpowered)
"aD" = (
/obj/machinery/door/airlock/highsecurity{
	name = "Bio Containment";
	req_one_access_txt = "47"
	},
/obj/effect/turf_decal/tile/neutral,
/obj/effect/turf_decal/tile/neutral{
	dir = 4
	},
/obj/effect/turf_decal/tile/neutral{
	dir = 1
	},
/obj/effect/turf_decal/tile/neutral{
	dir = 8
	},
/obj/structure/fans/tiny,
/turf/open/floor/plasteel/dark,
/area/ruin/unpowered)
"aE" = (
/obj/machinery/power/shieldwallgen/anchored,
/turf/open/floor/plating,
/area/ruin/unpowered)
"aG" = (
/obj/structure/table/reinforced,
/obj/item/gun/energy/floragun,
/turf/open/floor/plasteel/dark/side,
/area/ruin/unpowered)
"aI" = (
/obj/structure/table/reinforced,
/obj/machinery/computer/med_data/laptop{
	dir = 8;
	pixel_y = 1
	},
/turf/open/floor/plasteel/dark/side,
/area/ruin/unpowered)
"aK" = (
/obj/structure/window/reinforced{
	dir = 4
	},
/turf/template_noop,
/area/template_noop)
"aL" = (
/obj/effect/turf_decal/tile/neutral,
/obj/effect/turf_decal/tile/neutral{
	dir = 4
	},
/obj/effect/turf_decal/tile/neutral{
	dir = 1
	},
/obj/effect/turf_decal/tile/neutral{
	dir = 8
	},
/turf/open/floor/plasteel/dark,
/area/ruin/unpowered)
"aN" = (
/obj/structure/table/reinforced,
/obj/item/folder,
/turf/open/floor/plasteel/dark/side,
/area/ruin/unpowered)
"aO" = (
/obj/structure/chair/office/light{
	dir = 8
	},
/obj/effect/turf_decal/tile/green{
	dir = 1
	},
/obj/effect/turf_decal/tile/green,
/obj/effect/turf_decal/tile/green{
	dir = 4
	},
/obj/effect/turf_decal/tile/green{
	dir = 8
	},
/turf/open/floor/plasteel/dark,
/area/ruin/unpowered)
"aP" = (
/obj/structure/table/reinforced,
/obj/item/reagent_containers/glass/bottle/random_virus,
/obj/item/reagent_containers/dropper,
/turf/open/floor/plasteel/dark/side,
/area/ruin/unpowered)
"aQ" = (
/obj/structure/window/reinforced{
	dir = 8
	},
/turf/template_noop,
/area/template_noop)
"aR" = (
/obj/machinery/light/small{
	dir = 4
	},
/obj/effect/turf_decal/tile/neutral,
/obj/effect/turf_decal/tile/neutral{
	dir = 4
	},
/obj/effect/turf_decal/tile/neutral{
	dir = 1
	},
/obj/effect/turf_decal/tile/neutral{
	dir = 8
	},
/turf/open/floor/plasteel/dark,
/area/ruin/unpowered)
"aS" = (
/obj/structure/rack,
/obj/item/melee/baton/cattleprod,
/obj/effect/spawner/random/maintenance,
/turf/open/floor/plasteel/dark/side,
/area/ruin/unpowered)
"aT" = (
/obj/structure/rack,
/obj/item/clothing/suit/space/eva,
/obj/item/tank/internals/emergency_oxygen/double,
/obj/item/clothing/head/helmet/space/eva,
/turf/open/floor/plasteel/dark/side,
/area/ruin/unpowered)
"aU" = (
/obj/structure/rack,
/obj/item/crowbar,
/obj/item/shield/riot,
/obj/machinery/light{
	dir = 1
	},
/turf/open/floor/plasteel/dark/side,
/area/ruin/unpowered)
"aV" = (
/obj/machinery/smartfridge/chemistry,
/turf/open/floor/plasteel/dark/side,
/area/ruin/unpowered)
"aW" = (
/obj/structure/table/reinforced,
/obj/item/gun/syringe,
/turf/open/floor/plasteel/dark/side,
/area/ruin/unpowered)
"aX" = (
/obj/structure/table/reinforced,
/obj/item/grenade/chem_grenade/antiweed{
	pixel_x = 3;
	pixel_y = 5
	},
/obj/item/grenade/chem_grenade/antiweed{
	pixel_x = 4
	},
/obj/item/grenade/chem_grenade/antiweed{
	pixel_x = -3;
	pixel_y = -1
	},
/obj/machinery/light{
	dir = 1
	},
/turf/open/floor/plasteel/dark/side,
/area/ruin/unpowered)
"aY" = (
/obj/structure/table/reinforced,
/obj/item/gun/energy/temperature{
	pin = /obj/item/firing_pin
	},
/turf/open/floor/plasteel/dark/side,
/area/ruin/unpowered)
"aZ" = (
/obj/structure/table/reinforced,
/obj/item/cultivator,
/obj/item/shovel,
/turf/open/floor/plasteel/dark/side,
/area/ruin/unpowered)
"ba" = (
/obj/machinery/light/small{
	dir = 8
	},
/obj/effect/turf_decal/tile/neutral,
/obj/effect/turf_decal/tile/neutral{
	dir = 4
	},
/obj/effect/turf_decal/tile/neutral{
	dir = 1
	},
/obj/effect/turf_decal/tile/neutral{
	dir = 8
	},
/turf/open/floor/plasteel/dark,
/area/ruin/unpowered)
"bb" = (
/obj/machinery/door/airlock/hatch{
	name = "Bio-Research Station"
	},
/obj/effect/turf_decal/tile/green{
	dir = 1
	},
/obj/effect/turf_decal/tile/green,
/obj/effect/turf_decal/tile/green{
	dir = 4
	},
/obj/effect/turf_decal/tile/green{
	dir = 8
	},
/turf/open/floor/plasteel/dark,
/area/ruin/unpowered)
"be" = (
/obj/structure/reagent_dispensers/fueltank,
/turf/open/floor/plasteel/dark/side,
/area/ruin/unpowered)
"bf" = (
/obj/structure/reagent_dispensers/watertank,
/turf/open/floor/plasteel/dark/side,
/area/ruin/unpowered)
"bg" = (
/obj/machinery/light,
/obj/machinery/portable_atmospherics/canister/oxygen,
/turf/open/floor/plasteel/dark/side,
/area/ruin/unpowered)
"bh" = (
/obj/machinery/disposal/bin,
/obj/structure/disposalpipe/trunk,
/turf/open/floor/plasteel/dark/side,
/area/ruin/unpowered)
"bi" = (
/obj/structure/table/reinforced,
/obj/item/reagent_containers/hypospray/medipen/stimpack,
/obj/item/reagent_containers/glass/bottle/mutagen,
/turf/open/floor/plasteel/dark/side,
/area/ruin/unpowered)
"bj" = (
/obj/structure/table/reinforced,
/obj/item/surgicaldrill,
/obj/item/hemostat,
/obj/item/scalpel,
/obj/item/surgical_drapes,
/obj/item/retractor,
/obj/item/cautery,
/obj/item/circular_saw,
/obj/machinery/light,
/turf/open/floor/plasteel/dark/side,
/area/ruin/unpowered)
"bk" = (
/obj/structure/table/optable,
/turf/open/floor/plasteel/dark/side,
/area/ruin/unpowered)
"bl" = (
/obj/machinery/computer/operating{
	dir = 8
	},
/turf/open/floor/plasteel/dark/side,
/area/ruin/unpowered)
"bm" = (
/obj/structure/closet/wardrobe/science_white,
/obj/structure/disposalpipe/segment,
/turf/open/floor/plasteel/dark/side,
/area/ruin/unpowered)
"bn" = (
/obj/structure/table/reinforced,
/obj/item/food/carrotfries,
/turf/open/floor/plasteel/dark/side,
/area/ruin/unpowered)
"bp" = (
/obj/structure/bed,
/obj/item/bedsheet/green,
/obj/structure/disposalpipe/segment,
/turf/open/floor/plasteel/dark/side,
/area/ruin/unpowered)
"br" = (
/obj/structure/table/reinforced,
/obj/machinery/microwave,
/turf/open/floor/plasteel/dark/side,
/area/ruin/unpowered)
"bt" = (
/obj/machinery/power/shieldwallgen/anchored,
/turf/open/floor/plating/airless,
/area/ruin/unpowered)
"bu" = (
/obj/structure/flora/ausbushes/sunnybush,
/turf/open/floor/plating,
/area/ruin/unpowered)
"bv" = (
/turf/open/floor/plating,
/area/ruin/unpowered)
"bw" = (
/obj/machinery/light{
	dir = 1
	},
/mob/living/simple_animal/hostile/carp,
/turf/open/floor/plating,
/area/ruin/unpowered)
"bx" = (
/obj/structure/flora/ausbushes/palebush,
/turf/open/floor/plating,
/area/ruin/unpowered)
"by" = (
/obj/structure/disposalpipe/segment{
	dir = 6
	},
/turf/closed/wall/r_wall,
/area/ruin/unpowered)
"bz" = (
/obj/machinery/space_heater,
/obj/structure/disposalpipe/segment{
	dir = 9
	},
/obj/machinery/light{
	dir = 8
	},
/turf/open/floor/plasteel/dark/side,
/area/ruin/unpowered)
"bA" = (
/obj/structure/table/reinforced,
/obj/machinery/reagentgrinder,
/turf/open/floor/plasteel/dark/side,
/area/ruin/unpowered)
"bB" = (
/obj/structure/alien/weeds,
/turf/open/floor/plating/airless,
/area/ruin/unpowered)
"bC" = (
/obj/structure/alien/weeds/node,
/obj/machinery/light{
	dir = 1
	},
/turf/open/floor/plating/airless,
/area/ruin/unpowered)
"bD" = (
/obj/item/clothing/mask/facehugger/dead,
/obj/structure/alien/weeds,
/turf/open/floor/plating/airless,
/area/ruin/unpowered)
"bE" = (
/obj/structure/flora/ausbushes/sparsegrass,
/turf/open/floor/plating,
/area/ruin/unpowered)
"bF" = (
/obj/structure/disposalpipe/segment,
/turf/closed/wall/r_wall,
/area/ruin/unpowered)
"bG" = (
/obj/machinery/door/airlock/external,
/obj/effect/mapping_helpers/airlock/cyclelink_helper,
/obj/effect/turf_decal/tile/green{
	dir = 1
	},
/obj/effect/turf_decal/tile/green,
/obj/effect/turf_decal/tile/green{
	dir = 4
	},
/obj/effect/turf_decal/tile/green{
	dir = 8
	},
/turf/open/floor/plasteel/dark,
/area/ruin/unpowered)
"bH" = (
/obj/structure/alien/resin/wall,
/turf/open/floor/plating/airless,
/area/ruin/unpowered)
"bI" = (
/obj/structure/flora/ausbushes/reedbush,
/turf/open/floor/plating,
/area/ruin/unpowered)
"bJ" = (
/mob/living/simple_animal/crab{
	faction = list("carp")
	},
/turf/open/floor/plating,
/area/ruin/unpowered)
"bK" = (
/obj/structure/disposalpipe/segment,
/turf/open/floor/plating/airless,
/area/template_noop)
"bL" = (
/obj/machinery/light/small{
	dir = 8
	},
/obj/effect/turf_decal/tile/green{
	dir = 1
	},
/obj/effect/turf_decal/tile/green,
/obj/effect/turf_decal/tile/green{
	dir = 4
	},
/obj/effect/turf_decal/tile/green{
	dir = 8
	},
/turf/open/floor/plasteel/dark,
/area/ruin/unpowered)
"bM" = (
/obj/machinery/light/small{
	dir = 4
	},
/obj/effect/turf_decal/tile/green{
	dir = 1
	},
/obj/effect/turf_decal/tile/green,
/obj/effect/turf_decal/tile/green{
	dir = 4
	},
/obj/effect/turf_decal/tile/green{
	dir = 8
	},
/turf/open/floor/plasteel/dark,
/area/ruin/unpowered)
"bN" = (
/obj/structure/grille/broken,
/obj/item/shard{
	icon_state = "small"
	},
/turf/open/floor/plating/airless,
/area/ruin/unpowered)
"bO" = (
/obj/item/shard,
/turf/open/floor/plating/airless,
/area/ruin/unpowered)
"bP" = (
/obj/structure/lattice,
/turf/template_noop,
/area/template_noop)
"bR" = (
/obj/structure/disposalpipe/trunk{
	dir = 1
	},
/obj/structure/disposaloutlet,
/turf/open/floor/plating/airless,
/area/template_noop)
"bT" = (
/obj/structure/grille,
/obj/item/shard{
	icon_state = "medium"
	},
/turf/open/floor/plating/airless,
/area/ruin/unpowered)
"bU" = (
/obj/structure/grille/broken,
/turf/open/floor/plating/airless,
/area/ruin/unpowered)
"bV" = (
/obj/machinery/power/shieldwallgen,
/turf/template_noop,
/area/template_noop)
"bW" = (
/obj/item/shard,
/turf/template_noop,
/area/template_noop)
"bX" = (
/turf/open/floor/plating/airless,
/area/ruin/unpowered)
"lo" = (
/obj/machinery/door/airlock/external,
/obj/effect/mapping_helpers/airlock/cyclelink_helper{
	dir = 1
	},
/obj/effect/turf_decal/tile/green{
	dir = 1
	},
/obj/effect/turf_decal/tile/green,
/obj/effect/turf_decal/tile/green{
	dir = 4
	},
/obj/effect/turf_decal/tile/green{
	dir = 8
	},
/obj/structure/fans/tiny,
/turf/open/floor/plasteel/dark,
/area/ruin/unpowered)
"rY" = (
/obj/machinery/light/small{
	dir = 8
	},
/obj/item/stack/cable_coil/cut,
/obj/item/stack/tile/plasteel{
	pixel_x = 3;
	pixel_y = -4
	},
/obj/item/wirecutters,
/obj/effect/turf_decal/tile/neutral,
/obj/effect/turf_decal/tile/neutral{
	dir = 4
	},
/obj/effect/turf_decal/tile/neutral{
	dir = 1
	},
/obj/effect/turf_decal/tile/neutral{
	dir = 8
	},
/turf/open/floor/plating,
/area/ruin/unpowered)
"Bb" = (
/obj/structure/alien/weeds,
/obj/structure/alien/weeds/node,
/mob/living/simple_animal/hostile/alien/drone,
/turf/open/floor/plating/airless,
/area/ruin/unpowered)
"GF" = (
/obj/structure/alien/weeds,
/mob/living/simple_animal/hostile/alien/sentinel,
/turf/open/floor/plating/airless,
/area/ruin/unpowered)
"Ng" = (
/obj/structure/alien/weeds,
/obj/structure/alien/weeds/node,
/turf/open/floor/plating/airless,
/area/ruin/unpowered)
"QU" = (
/obj/item/clothing/mask/facehugger/dead,
/obj/structure/alien/weeds,
/mob/living/simple_animal/hostile/alien/maid,
/turf/open/floor/plating/airless,
/area/ruin/unpowered)
"Vt" = (
/obj/effect/abstract/doorway_marker{
	dir = 1
	},
/turf/open/floor/plating,
/area/ruin/unpowered)

(1,1,1) = {"
bt
ac
ac
ac
ac
bt
aa
aa
aa
aa
aa
aa
bt
ac
ac
ac
ac
bt
aa
"}
(2,1,1) = {"
ac
ah
ai
ar
ah
ac
aK
aK
aK
aK
aK
aK
ac
bu
bv
bI
bv
ac
aa
"}
(3,1,1) = {"
ac
ah
ap
ai
ai
aD
aL
aR
aL
aL
aR
aL
aD
bv
bv
bJ
bv
ac
aa
"}
(4,1,1) = {"
ac
ai
ah
ai
aw
ac
at
at
bb
bb
at
at
ac
bw
bv
bv
bv
ac
aa
"}
(5,1,1) = {"
ac
aj
ai
as
ar
ac
at
aS
ay
ay
be
at
ac
bx
bE
bv
bv
ac
aa
"}
(6,1,1) = {"
bt
ac
ac
ac
ac
aE
at
aT
ay
ay
bf
at
aE
ac
ac
ac
ac
bt
aa
"}
(7,1,1) = {"
aa
aa
aa
at
at
at
at
aU
ay
ay
bg
at
at
by
bF
bK
bK
bR
aa
"}
(8,1,1) = {"
aa
aa
aa
ac
ax
aG
aN
aV
ay
ay
bh
bm
bp
bz
at
at
at
aa
aa
"}
(9,1,1) = {"
aa
aa
aa
ac
ay
ay
aO
ay
ay
ay
ay
ay
ay
ay
bG
bL
lo
aa
aa
"}
(10,1,1) = {"
aa
aa
aa
ac
ay
ay
ay
ay
ay
ay
ay
ay
ay
ay
bG
bM
lo
aa
aa
"}
(11,1,1) = {"
aa
aa
aa
ac
az
aI
aP
aW
ay
ay
bi
bn
br
bA
at
at
at
aa
aa
"}
(12,1,1) = {"
aa
aa
aa
at
at
at
at
aX
ay
ay
bj
at
at
at
at
aa
aa
aa
aa
"}
(13,1,1) = {"
bt
ac
ac
ac
ac
aE
at
aY
ay
ay
bk
at
aE
ac
ac
ac
ac
bt
aa
"}
(14,1,1) = {"
ac
al
an
an
aA
ac
at
aZ
ay
ay
bl
at
ac
bB
Bb
QU
bH
ac
aa
"}
(15,1,1) = {"
at
am
am
ao
aB
ac
at
at
bb
bb
at
at
ac
bC
bH
bH
bB
bT
aa
"}
(16,1,1) = {"
Vt
an
aq
au
am
aD
aL
ba
aL
aL
rY
aL
aD
bD
bB
Ng
bO
bU
bW
"}
(17,1,1) = {"
at
ao
an
av
aC
ac
aQ
aQ
aQ
aQ
aQ
aQ
ac
GF
bB
bB
bX
bP
aa
"}
(18,1,1) = {"
bt
ac
ac
ac
ac
bt
aa
aa
aa
aa
aa
aa
bt
ac
ac
bN
bP
aa
aa
"}
(19,1,1) = {"
aa
aa
aa
aa
aa
aa
aa
aa
aa
aa
aa
aa
aa
aa
aa
aa
aa
bV
aa
"}
