//MAP CONVERTED BY dmm2tgm.py THIS HEADER COMMENT PREVENTS RECONVERSION, DO NOT REMOVE
"a" = (
/obj/structure/fans/tiny,
/obj/machinery/door/poddoor/shutters{
	id = "exploration_ex_cargo2"
	},
/turf/open/floor/plasteel,
/area/ruin/unpowered)
"b" = (
/obj/effect/abstract/open_area_marker{
	dir = 4
	},
/turf/open/floor/plasteel,
/area/ruin/unpowered)
"c" = (
/obj/item/kirbyplants/random,
/turf/open/floor/plasteel,
/area/ruin/unpowered)
"e" = (
/obj/effect/spawner/random/decoration/glowstick,
/turf/open/floor/plasteel,
/area/ruin/unpowered)
"f" = (
/obj/effect/turf_decal/box,
/obj/structure/reagent_dispensers/watertank,
/turf/open/floor/plasteel,
/area/ruin/unpowered)
"h" = (
/obj/effect/abstract/open_area_marker{
	dir = 8
	},
/turf/open/floor/plasteel,
/area/ruin/unpowered)
"i" = (
/obj/effect/spawner/structure/window/reinforced/derelict,
/turf/open/floor/circuit,
/area/ruin/unpowered)
"j" = (
/obj/effect/turf_decal/tile/yellow{
	dir = 8
	},
/obj/effect/turf_decal/tile/yellow{
	dir = 1
	},
/obj/effect/turf_decal/tile/yellow{
	dir = 4
	},
/turf/open/floor/plating/asteroid/no_generation,
/area/ruin/unpowered)
"k" = (
/turf/open/floor/plasteel,
/area/ruin/unpowered)
"l" = (
/obj/effect/turf_decal/tile/yellow{
	dir = 8
	},
/obj/effect/turf_decal/tile/yellow{
	dir = 1
	},
/obj/effect/turf_decal/tile/yellow,
/obj/effect/turf_decal/tile/yellow{
	dir = 4
	},
/turf/open/floor/plating/asteroid/no_generation,
/area/ruin/unpowered)
"n" = (
/obj/effect/turf_decal/box,
/obj/structure/ore_box,
/turf/open/floor/plasteel,
/area/ruin/unpowered)
"p" = (
/obj/effect/turf_decal/tile/yellow{
	dir = 1
	},
/obj/effect/turf_decal/tile/dark{
	dir = 8
	},
/obj/effect/turf_decal/tile/dark{
	dir = 4
	},
/turf/open/floor/plating/asteroid/no_generation,
/area/ruin/unpowered)
"q" = (
/obj/effect/spawner/random/vending/snackvend,
/turf/open/floor/plasteel,
/area/ruin/unpowered)
"r" = (
/obj/effect/turf_decal/stripes/corner{
	dir = 8
	},
/obj/machinery/light/broken,
/turf/open/floor/plasteel,
/area/ruin/unpowered)
"s" = (
/obj/effect/turf_decal/stripes/line,
/turf/open/floor/plasteel,
/area/ruin/unpowered)
"t" = (
/obj/effect/turf_decal/stripes/corner,
/obj/effect/turf_decal/dust,
/obj/machinery/light/red,
/turf/open/floor/plasteel,
/area/ruin/unpowered)
"u" = (
/obj/effect/spawner/random/vending/colavend,
/turf/open/floor/plasteel,
/area/ruin/unpowered)
"v" = (
/obj/machinery/door/airlock/external/glass,
/obj/structure/fans/tiny,
/turf/open/floor/plasteel,
/area/ruin/unpowered)
"w" = (
/obj/effect/turf_decal/box,
/obj/effect/decal/cleanable/greenglow/filled,
/turf/open/floor/plasteel,
/area/ruin/unpowered)
"x" = (
/obj/effect/turf_decal/tile/yellow,
/obj/effect/turf_decal/tile/dark{
	dir = 8
	},
/obj/effect/turf_decal/tile/dark{
	dir = 4
	},
/turf/open/floor/plating/asteroid/no_generation,
/area/ruin/unpowered)
"z" = (
/obj/effect/turf_decal/tile/yellow{
	dir = 1
	},
/obj/effect/turf_decal/tile/yellow,
/obj/effect/turf_decal/tile/dark{
	dir = 8
	},
/turf/open/floor/plating/asteroid/no_generation,
/area/ruin/unpowered)
"A" = (
/turf/open/floor/plating/asteroid/no_generation,
/area/ruin/unpowered)
"B" = (
/obj/effect/turf_decal/box,
/obj/machinery/space_heater,
/turf/open/floor/plasteel,
/area/ruin/unpowered)
"D" = (
/obj/effect/turf_decal/box,
/obj/machinery/portable_atmospherics/canister/oxygen,
/turf/open/floor/plasteel,
/area/ruin/unpowered)
"E" = (
/obj/effect/turf_decal/stripes/line{
	dir = 1
	},
/turf/open/floor/plasteel,
/area/ruin/unpowered)
"F" = (
/turf/closed/wall/riveted_wall,
/area/ruin/unpowered)
"G" = (
/obj/effect/turf_decal/stripes/corner{
	dir = 4
	},
/obj/machinery/light/red{
	dir = 1
	},
/turf/open/floor/plasteel,
/area/ruin/unpowered)
"H" = (
/obj/effect/turf_decal/box,
/turf/open/floor/plasteel,
/area/ruin/unpowered)
"I" = (
/obj/structure/reagent_dispensers/water_cooler,
/turf/open/floor/plasteel,
/area/ruin/unpowered)
"J" = (
/obj/effect/turf_decal/tile/yellow{
	dir = 1
	},
/obj/effect/turf_decal/tile/yellow,
/obj/effect/turf_decal/tile/dark{
	dir = 4
	},
/turf/open/floor/plating/asteroid/no_generation,
/area/ruin/unpowered)
"K" = (
/obj/structure/table/wood,
/obj/item/flashlight/lamp/green{
	pixel_x = 1;
	pixel_y = 5
	},
/turf/open/floor/plasteel,
/area/ruin/unpowered)
"L" = (
/obj/effect/turf_decal/tile/yellow{
	dir = 8
	},
/obj/effect/turf_decal/tile/yellow{
	dir = 1
	},
/turf/open/floor/plating/asteroid/no_generation,
/area/ruin/unpowered)
"M" = (
/obj/effect/turf_decal/box,
/obj/machinery/portable_atmospherics/pump,
/turf/open/floor/plasteel,
/area/ruin/unpowered)
"P" = (
/obj/effect/turf_decal/stripes/corner,
/turf/open/floor/plasteel,
/area/ruin/unpowered)
"R" = (
/obj/effect/turf_decal/tile/yellow{
	dir = 1
	},
/obj/effect/turf_decal/tile/yellow,
/obj/effect/turf_decal/tile/dark{
	dir = 8
	},
/obj/effect/turf_decal/tile/dark{
	dir = 4
	},
/obj/structure/lattice,
/turf/open/floor/plating/asteroid/no_generation,
/area/ruin/unpowered)
"S" = (
/obj/effect/turf_decal/stripes/corner{
	dir = 8
	},
/obj/effect/turf_decal/dust,
/obj/machinery/light/red,
/turf/open/floor/plasteel,
/area/ruin/unpowered)
"T" = (
/obj/effect/turf_decal/stripes/corner{
	dir = 1
	},
/obj/machinery/light/red{
	dir = 1
	},
/turf/open/floor/plasteel,
/area/ruin/unpowered)
"V" = (
/obj/effect/turf_decal/loading_area,
/turf/open/floor/plasteel,
/area/ruin/unpowered)
"W" = (
/obj/structure/fans/tiny,
/obj/machinery/door/poddoor/shutters{
	id = "exploration_ex_cargo1"
	},
/turf/open/floor/plasteel,
/area/ruin/unpowered)
"X" = (
/obj/effect/turf_decal/tile/yellow{
	dir = 1
	},
/obj/effect/turf_decal/tile/yellow{
	dir = 8
	},
/obj/effect/turf_decal/tile/yellow,
/turf/open/floor/plating/asteroid/no_generation,
/area/ruin/unpowered)
"Y" = (
/obj/machinery/door/poddoor/shutters{
	id = "exploration_ex_cargo1"
	},
/obj/structure/fans/tiny,
/obj/machinery/button/door{
	id = "exploration_ex_cargo1";
	name = "Cargo Shutters Control";
	pixel_x = 32;
	req_access_txt = "49"
	},
/turf/open/floor/plasteel,
/area/ruin/unpowered)
"Z" = (
/obj/machinery/door/poddoor/shutters{
	id = "exploration_ex_cargo2"
	},
/obj/structure/fans/tiny,
/obj/machinery/button/door{
	id = "exploration_ex_cargo2";
	name = "Cargo Shutters Control";
	pixel_x = 32;
	req_access_txt = "49"
	},
/turf/open/floor/plasteel,
/area/ruin/unpowered)

(1,1,1) = {"
F
F
F
F
F
F
F
F
F
F
F
F
F
k
h
k
F
"}
(2,1,1) = {"
F
q
k
k
k
k
k
k
k
k
k
k
k
k
k
k
F
"}
(3,1,1) = {"
F
u
k
k
k
k
k
k
k
k
k
k
k
k
k
k
F
"}
(4,1,1) = {"
F
c
k
k
F
F
i
i
i
i
i
F
F
k
k
k
F
"}
(5,1,1) = {"
F
k
k
k
F
R
p
A
A
A
z
R
F
k
k
k
F
"}
(6,1,1) = {"
F
H
e
k
i
p
A
A
A
A
A
z
i
k
k
k
F
"}
(7,1,1) = {"
F
D
k
t
F
A
A
A
A
A
A
A
F
G
e
k
F
"}
(8,1,1) = {"
F
w
V
s
W
A
A
A
A
A
A
A
a
E
k
k
F
"}
(9,1,1) = {"
F
n
V
s
Y
A
A
A
A
A
A
A
Z
E
k
k
F
"}
(10,1,1) = {"
F
f
k
S
F
A
A
A
l
A
A
A
F
T
k
k
F
"}
(11,1,1) = {"
F
H
k
P
F
A
A
A
l
A
A
A
F
M
k
k
F
"}
(12,1,1) = {"
F
k
k
s
v
A
A
X
l
j
A
A
F
B
k
k
F
"}
(13,1,1) = {"
F
k
k
r
F
A
A
A
L
A
A
A
F
k
k
k
F
"}
(14,1,1) = {"
F
k
e
k
i
A
A
A
A
A
A
A
i
k
k
k
F
"}
(15,1,1) = {"
F
k
k
k
i
A
A
A
A
A
A
A
i
k
k
k
F
"}
(16,1,1) = {"
F
k
k
k
i
J
A
A
A
A
A
x
i
k
k
k
F
"}
(17,1,1) = {"
F
k
k
k
F
R
J
A
A
A
x
R
F
k
k
k
F
"}
(18,1,1) = {"
F
k
k
k
F
F
i
i
i
i
i
F
F
k
k
c
F
"}
(19,1,1) = {"
F
k
k
k
k
k
k
k
k
k
k
k
k
k
k
I
F
"}
(20,1,1) = {"
F
k
k
k
k
k
k
k
k
k
k
k
k
k
k
K
F
"}
(21,1,1) = {"
F
k
b
k
F
F
F
F
F
F
F
F
F
F
F
F
F
"}
