//MAP CONVERTED BY dmm2tgm.py THIS HEADER COMMENT PREVENTS RECONVERSION, DO NOT REMOVE
"ac" = (
/obj/structure/table,
/obj/item/storage/toolbox/mechanical,
/turf/open/floor/plasteel/durasteel,
/area/ruin/unpowered)
"bA" = (
/obj/machinery/light/small{
	dir = 1
	},
/obj/machinery/modular_computer/console/preset/civilian,
/turf/open/floor/plasteel/durasteel,
/area/ruin/unpowered)
"da" = (
/obj/structure/table/reinforced,
/obj/item/paper_bin,
/obj/item/pen,
/turf/open/floor/plasteel/durasteel,
/area/ruin/unpowered)
"dS" = (
/obj/structure/table/wood/fancy/royalblack,
/obj/item/reagent_containers/food/condiment/saltshaker,
/obj/item/reagent_containers/food/condiment/peppermill,
/turf/open/floor/plasteel/durasteel,
/area/ruin/unpowered)
"ea" = (
/obj/machinery/ntnet_relay,
/turf/open/floor/plasteel/durasteel,
/area/ruin/unpowered)
"eE" = (
/obj/machinery/light{
	dir = 1
	},
/turf/open/floor/plasteel/durasteel,
/area/ruin/unpowered)
"eP" = (
/obj/structure/extinguisher_cabinet{
	pixel_y = -32
	},
/turf/open/floor/plasteel/durasteel,
/area/ruin/unpowered)
"gj" = (
/obj/machinery/portable_atmospherics/canister/oxygen,
/turf/open/floor/plasteel/durasteel,
/area/ruin/unpowered)
"hp" = (
/obj/structure/table/wood/fancy/royalblack,
/obj/item/reagent_containers/food/condiment/milk,
/obj/item/reagent_containers/food/condiment/soymilk,
/turf/open/floor/plasteel/durasteel,
/area/ruin/unpowered)
"kd" = (
/turf/template_noop,
/area/template_noop)
"mX" = (
/turf/closed/wall/riveted_wall,
/area/ruin/unpowered)
"om" = (
/obj/structure/safe/floor,
/obj/item/reagent_containers/hypospray/combat/nanites,
/obj/item/melee/baton/loaded,
/turf/open/floor/plasteel/durasteel,
/area/ruin/unpowered)
"oS" = (
/obj/machinery/computer/telescience{
	dir = 8
	},
/turf/open/floor/resin,
/area/ruin/unpowered)
"rG" = (
/obj/effect/abstract/doorway_marker,
/turf/open/floor/plasteel/durasteel,
/area/ruin/unpowered)
"sf" = (
/obj/machinery/light/small{
	dir = 4
	},
/obj/machinery/stasis,
/turf/open/floor/plasteel/durasteel,
/area/ruin/unpowered)
"ta" = (
/obj/structure/chair{
	dir = 4
	},
/turf/open/floor/plasteel/durasteel,
/area/ruin/unpowered)
"tJ" = (
/obj/machinery/light/small{
	dir = 1
	},
/obj/effect/spawner/random/vending/colavend,
/turf/open/floor/plasteel/durasteel,
/area/ruin/unpowered)
"uq" = (
/obj/machinery/vending/coffee,
/turf/open/floor/plasteel/durasteel,
/area/ruin/unpowered)
"uR" = (
/obj/structure/chair{
	dir = 1
	},
/obj/machinery/airalarm/directional/north,
/obj/effect/mapping_helpers/airalarm/syndicate_access,
/turf/open/floor/plasteel/durasteel,
/area/ruin/unpowered)
"vN" = (
/obj/structure/chair{
	dir = 1
	},
/obj/structure/extinguisher_cabinet{
	pixel_y = -32
	},
/turf/open/floor/plasteel/durasteel,
/area/ruin/unpowered)
"wl" = (
/obj/structure/chair/comfy/black,
/turf/open/floor/plasteel/durasteel,
/area/ruin/unpowered)
"wr" = (
/obj/machinery/vending/games,
/turf/open/floor/plasteel/durasteel,
/area/ruin/unpowered)
"wC" = (
/obj/machinery/portable_atmospherics/pump,
/turf/open/floor/plasteel/durasteel,
/area/ruin/unpowered)
"Av" = (
/obj/structure/table/wood/fancy/royalblack,
/obj/item/radio,
/turf/open/floor/plasteel/durasteel,
/area/ruin/unpowered)
"Az" = (
/obj/structure/chair{
	dir = 8
	},
/turf/open/floor/plasteel/durasteel,
/area/ruin/unpowered)
"AA" = (
/obj/effect/spawner/structure/window/reinforced/derelict,
/turf/open/floor/circuit,
/area/ruin/unpowered)
"AG" = (
/obj/structure/table/reinforced,
/obj/item/phone,
/turf/open/floor/plasteel/durasteel,
/area/ruin/unpowered)
"Bs" = (
/turf/open/floor/plating/asteroid/airless,
/area/ruin/unpowered)
"Bz" = (
/obj/machinery/door/airlock/hatch,
/turf/open/floor/plasteel/durasteel,
/area/ruin/unpowered)
"BY" = (
/obj/machinery/sleeper/syndie{
	dir = 8
	},
/turf/open/floor/plasteel/durasteel,
/area/ruin/unpowered)
"CU" = (
/obj/structure/table/reinforced,
/obj/item/flashlight/lamp,
/turf/open/floor/plasteel/durasteel,
/area/ruin/unpowered)
"CV" = (
/obj/structure/table,
/obj/item/storage/toolbox/electrical,
/turf/open/floor/plasteel/durasteel,
/area/ruin/unpowered)
"Eq" = (
/obj/machinery/vending/cigarette/syndicate,
/turf/open/floor/plasteel/durasteel,
/area/ruin/unpowered)
"EC" = (
/obj/structure/table/wood/fancy/royalblack,
/turf/open/floor/plasteel/durasteel,
/area/ruin/unpowered)
"FJ" = (
/obj/structure/chair{
	dir = 8
	},
/obj/effect/turf_decal/stripes/corner{
	dir = 4
	},
/turf/open/floor/plasteel/durasteel,
/area/ruin/unpowered)
"GX" = (
/obj/structure/chair{
	dir = 1
	},
/turf/open/floor/plasteel/durasteel,
/area/ruin/unpowered)
"Il" = (
/obj/machinery/light{
	dir = 1
	},
/obj/machinery/autolathe/hacked,
/obj/item/stack/sheet/iron/fifty,
/obj/item/stack/sheet/glass/fifty,
/turf/open/floor/plasteel/durasteel,
/area/ruin/unpowered)
"Ip" = (
/turf/open/floor/plasteel/durasteel,
/area/ruin/unpowered)
"JT" = (
/obj/machinery/newscaster{
	pixel_y = 32
	},
/turf/open/floor/plasteel/durasteel,
/area/ruin/unpowered)
"KK" = (
/obj/machinery/computer/camera_advanced/syndie{
	dir = 8
	},
/turf/open/floor/resin,
/area/ruin/unpowered)
"Mq" = (
/obj/structure/table/wood/fancy/royalblack,
/obj/item/restraints/handcuffs/cable/zipties,
/turf/open/floor/plasteel/durasteel,
/area/ruin/unpowered)
"RJ" = (
/obj/structure/table,
/obj/item/storage/toolbox/syndicate,
/obj/item/gps/science,
/turf/open/floor/plasteel/durasteel,
/area/ruin/unpowered)
"Sb" = (
/obj/machinery/status_display,
/turf/closed/wall/riveted_wall,
/area/ruin/unpowered)
"Sw" = (
/obj/machinery/light/small,
/obj/structure/chair{
	dir = 1
	},
/turf/open/floor/plasteel/durasteel,
/area/ruin/unpowered)
"Ui" = (
/turf/closed/mineral/random,
/area/ruin/unpowered)
"Vm" = (
/obj/effect/turf_decal/stripes/line{
	dir = 4
	},
/turf/open/floor/plasteel/durasteel,
/area/ruin/unpowered)
"WZ" = (
/turf/open/floor/resin,
/area/ruin/unpowered)
"Xj" = (
/obj/machinery/telepad,
/turf/open/floor/resin,
/area/ruin/unpowered)
"Xl" = (
/obj/machinery/portable_atmospherics/canister/air,
/turf/open/floor/plasteel/durasteel,
/area/ruin/unpowered)
"XP" = (
/obj/machinery/power/port_gen/pacman,
/obj/item/stack/sheet/mineral/plasma{
	amount = 30
	},
/turf/open/floor/plasteel/durasteel,
/area/ruin/unpowered)
"Ys" = (
/obj/item/flashlight,
/obj/structure/closet/cabinet,
/obj/item/radio,
/obj/item/crowbar/red,
/turf/open/floor/plasteel/durasteel,
/area/ruin/unpowered)
"ZY" = (
/obj/machinery/portable_atmospherics/scrubber,
/turf/open/floor/plasteel/durasteel,
/area/ruin/unpowered)

(1,1,1) = {"
kd
kd
kd
kd
kd
kd
kd
kd
kd
kd
kd
kd
kd
kd
kd
kd
kd
kd
kd
kd
kd
"}
(2,1,1) = {"
kd
kd
Bs
Bs
kd
kd
kd
kd
kd
kd
kd
kd
kd
kd
kd
kd
kd
kd
kd
kd
kd
"}
(3,1,1) = {"
kd
kd
Bs
Ui
Ui
Ui
Ui
kd
Ui
Bs
kd
kd
kd
kd
kd
Ui
Ui
Ui
Ui
Ui
kd
"}
(4,1,1) = {"
kd
Bs
Bs
Ui
Ui
Ui
Ui
Ui
Ui
Ui
kd
kd
kd
kd
kd
Ui
mX
mX
Sb
mX
mX
"}
(5,1,1) = {"
kd
Bs
Ui
Ui
Ui
Ui
Ui
Ui
Ui
Ui
kd
Bs
kd
kd
kd
Ui
mX
Eq
Ip
Ip
rG
"}
(6,1,1) = {"
kd
Bs
Ui
Ui
Ui
Ui
Ui
Ui
Ui
Ui
Ui
Ui
Ui
kd
Ui
Ui
mX
tJ
Ip
GX
mX
"}
(7,1,1) = {"
kd
Bs
Ui
Ui
Ui
Ui
Ui
Ui
Ui
Ui
Ui
Ui
Ui
Ui
Ui
Ui
mX
uq
Ip
GX
mX
"}
(8,1,1) = {"
kd
kd
Ui
mX
mX
mX
mX
mX
mX
mX
mX
mX
mX
mX
mX
mX
mX
AG
Ip
vN
mX
"}
(9,1,1) = {"
kd
Ui
Ui
mX
ZY
wC
gj
Xl
Xl
Xl
mX
wr
Ip
Bz
Ip
Ip
Bz
Ip
Ip
GX
mX
"}
(10,1,1) = {"
Ui
Ui
Ui
mX
Ip
WZ
WZ
WZ
WZ
Ip
AA
Ip
Ip
mX
CU
da
mX
Ip
Ip
Sw
mX
"}
(11,1,1) = {"
kd
Ui
Ui
mX
XP
WZ
WZ
WZ
WZ
Ip
mX
Ip
eP
mX
bA
Az
AA
Ip
Ip
mX
mX
"}
(12,1,1) = {"
kd
kd
Ui
mX
ea
WZ
WZ
WZ
WZ
Ip
Bz
Ip
Ip
mX
Ip
Ip
AA
Az
Az
mX
Ui
"}
(13,1,1) = {"
kd
kd
Ui
mX
Il
WZ
Xj
WZ
WZ
Ip
Bz
Ip
Ip
mX
Bz
mX
mX
mX
mX
mX
Ui
"}
(14,1,1) = {"
kd
kd
Ui
mX
RJ
WZ
WZ
WZ
WZ
Ip
mX
eE
Ip
Ip
ta
ta
om
mX
Ui
Ui
Ui
"}
(15,1,1) = {"
kd
Ui
Ui
mX
ac
WZ
oS
KK
WZ
Ip
AA
Ip
Ip
Ip
dS
EC
uR
mX
Ui
Ui
Ui
"}
(16,1,1) = {"
kd
Ui
Ui
mX
CV
Ip
Ip
Ip
Ip
Ip
mX
JT
Ip
wl
hp
EC
Sw
mX
Ui
Ui
Ui
"}
(17,1,1) = {"
kd
kd
Ui
mX
mX
mX
mX
AA
AA
AA
mX
Ip
Ip
Ip
Av
EC
GX
mX
Ui
Ui
kd
"}
(18,1,1) = {"
kd
kd
Ui
Ui
Ui
Ui
mX
Ip
Ip
Ip
Bz
Vm
Vm
Vm
FJ
Az
Ip
mX
Ui
kd
kd
"}
(19,1,1) = {"
kd
kd
Ui
Ui
Ui
Ui
mX
Ys
BY
sf
mX
EC
Mq
Mq
mX
mX
mX
mX
Ui
Ui
kd
"}
(20,1,1) = {"
kd
kd
Ui
Ui
Ui
Ui
mX
mX
mX
mX
mX
mX
mX
mX
mX
Ui
Ui
Ui
Ui
Ui
kd
"}
(21,1,1) = {"
kd
kd
Ui
Ui
Ui
Ui
Ui
Ui
Ui
Ui
Ui
Ui
Ui
Ui
Ui
Ui
Ui
Ui
Ui
Ui
kd
"}
(22,1,1) = {"
kd
kd
kd
Ui
Ui
kd
kd
Ui
Ui
Ui
Ui
Ui
Ui
Ui
Ui
Ui
Ui
Ui
Ui
kd
kd
"}
(23,1,1) = {"
kd
kd
kd
kd
kd
kd
kd
Ui
kd
kd
kd
Ui
Ui
Ui
Ui
Ui
Ui
kd
kd
kd
kd
"}
