//MAP CONVERTED BY dmm2tgm.py THIS HEADER COMMENT PREVENTS RECONVERSION, DO NOT REMOVE
"gy" = (
/obj/effect/turf_decal/tile/neutral{
	dir = 1
	},
/obj/effect/turf_decal/tile/neutral{
	dir = 8
	},
/obj/effect/decal/cleanable/blood/drip,
/turf/open/floor/plasteel/dark,
/area/ruin/unpowered)
"iA" = (
/obj/structure/table,
/obj/item/storage/box/bodybags{
	pixel_x = 3;
	pixel_y = 12
	},
/obj/item/storage/box/bodybags{
	pixel_x = -4;
	pixel_y = 4
	},
/obj/effect/turf_decal/tile/neutral,
/obj/effect/turf_decal/tile/neutral{
	dir = 4
	},
/turf/open/floor/plasteel/dark,
/area/ruin/unpowered)
"le" = (
/obj/structure/closet/crate/bin,
/obj/effect/turf_decal/tile/neutral{
	dir = 1
	},
/obj/effect/turf_decal/tile/neutral{
	dir = 8
	},
/obj/effect/spawner/random/maintenance/seven,
/turf/open/floor/plasteel/dark,
/area/ruin/unpowered)
"mj" = (
/turf/closed/wall/riveted_wall,
/area/ruin/unpowered)
"nW" = (
/obj/structure/bodycontainer/morgue,
/obj/machinery/light{
	dir = 8
	},
/obj/effect/turf_decal/tile/neutral,
/obj/effect/turf_decal/tile/neutral{
	dir = 4
	},
/turf/open/floor/plasteel/dark,
/area/ruin/unpowered)
"qf" = (
/obj/effect/turf_decal/tile/neutral{
	dir = 1
	},
/obj/effect/turf_decal/tile/neutral{
	dir = 8
	},
/obj/effect/decal/cleanable/blood/drip{
	pixel_x = -11
	},
/turf/open/floor/plasteel/dark,
/area/ruin/unpowered)
"BO" = (
/obj/effect/abstract/doorway_marker{
	dir = 1
	},
/turf/open/floor/plasteel,
/area/ruin/unpowered)
"Fk" = (
/obj/effect/abstract/doorway_marker,
/turf/open/floor/plasteel,
/area/ruin/unpowered)
"FA" = (
/obj/effect/turf_decal/tile/neutral{
	dir = 1
	},
/obj/effect/turf_decal/tile/neutral,
/obj/effect/turf_decal/tile/neutral{
	dir = 4
	},
/obj/effect/turf_decal/tile/neutral{
	dir = 8
	},
/obj/effect/decal/cleanable/blood/bubblegum,
/obj/effect/decal/cleanable/blood/gibs{
	pixel_y = -7
	},
/turf/open/floor/plasteel/dark,
/area/ruin/unpowered)
"KO" = (
/obj/structure/bodycontainer/morgue,
/obj/effect/turf_decal/tile/neutral,
/obj/effect/turf_decal/tile/neutral{
	dir = 4
	},
/turf/open/floor/plasteel/dark,
/area/ruin/unpowered)
"OJ" = (
/obj/effect/turf_decal/tile/neutral{
	dir = 1
	},
/obj/effect/turf_decal/tile/neutral,
/obj/effect/turf_decal/tile/neutral{
	dir = 4
	},
/obj/effect/turf_decal/tile/neutral{
	dir = 8
	},
/obj/effect/decal/cleanable/blood/drip,
/turf/open/floor/plasteel/dark,
/area/ruin/unpowered)
"Px" = (
/obj/effect/turf_decal/tile/neutral{
	dir = 1
	},
/obj/effect/turf_decal/tile/neutral{
	dir = 8
	},
/obj/structure/closet/body_bag,
/obj/effect/mob_spawn/human/corpse/cat_butcher,
/turf/open/floor/plasteel/dark,
/area/ruin/unpowered)
"Qv" = (
/obj/structure/bodycontainer/morgue,
/obj/item/radio/intercom{
	name = "Station Intercom";
	pixel_x = -26
	},
/obj/effect/turf_decal/tile/neutral,
/obj/effect/turf_decal/tile/neutral{
	dir = 4
	},
/obj/machinery/camera/directional/east{
	network = list("outpost")
	},
/turf/open/floor/plasteel/dark,
/area/ruin/unpowered)
"Td" = (
/obj/structure/table,
/obj/item/clothing/gloves/color/latex,
/obj/structure/extinguisher_cabinet{
	pixel_x = -26
	},
/obj/effect/turf_decal/tile/neutral,
/obj/effect/turf_decal/tile/neutral{
	dir = 4
	},
/obj/item/reagent_containers/glass/bottle/atropine{
	pixel_x = -6;
	pixel_y = 12
	},
/turf/open/floor/plasteel/dark,
/area/ruin/unpowered)
"XV" = (
/obj/effect/turf_decal/tile/neutral{
	dir = 1
	},
/obj/effect/turf_decal/tile/neutral{
	dir = 8
	},
/obj/structure/closet/body_bag,
/obj/effect/mob_spawn/human/corpse/assistant,
/turf/open/floor/plasteel/dark,
/area/ruin/unpowered)
"Yb" = (
/obj/effect/turf_decal/tile/neutral{
	dir = 1
	},
/obj/effect/turf_decal/tile/neutral,
/obj/effect/turf_decal/tile/neutral{
	dir = 4
	},
/obj/effect/turf_decal/tile/neutral{
	dir = 8
	},
/obj/effect/decal/cleanable/blood/footprints,
/obj/effect/decal/cleanable/blood/footprints{
	dir = 1
	},
/obj/effect/decal/cleanable/blood/bubblegum{
	pixel_y = -16;
	pixel_x = -4
	},
/turf/open/floor/plasteel/dark,
/area/ruin/unpowered)
"YI" = (
/obj/effect/turf_decal/tile/neutral{
	dir = 1
	},
/obj/effect/turf_decal/tile/neutral,
/obj/effect/turf_decal/tile/neutral{
	dir = 4
	},
/obj/effect/turf_decal/tile/neutral{
	dir = 8
	},
/obj/effect/decal/cleanable/blood/footprints,
/obj/effect/decal/cleanable/blood/footprints{
	dir = 1
	},
/turf/open/floor/plasteel/dark,
/area/ruin/unpowered)

(1,1,1) = {"
mj
mj
mj
mj
mj
mj
mj
mj
"}
(2,1,1) = {"
mj
KO
iA
Qv
nW
Td
KO
mj
"}
(3,1,1) = {"
BO
OJ
FA
YI
YI
YI
Yb
Fk
"}
(4,1,1) = {"
mj
Px
gy
XV
XV
qf
le
mj
"}
(5,1,1) = {"
mj
mj
mj
mj
mj
mj
mj
mj
"}
