//MAP CONVERTED BY dmm2tgm.py THIS HEADER COMMENT PREVENTS RECONVERSION, DO NOT REMOVE
"bo" = (
/obj/structure/table/reinforced,
/obj/effect/spawner/random/maintenance,
/obj/effect/turf_decal/bot,
/obj/effect/turf_decal/tile/yellow{
	dir = 4
	},
/obj/effect/turf_decal/tile/yellow,
/obj/effect/decal/cleanable/dirt/dust,
/turf/open/floor/plasteel,
/area/ruin/unpowered)
"bH" = (
/obj/effect/turf_decal/tile/yellow{
	dir = 1
	},
/obj/effect/turf_decal/tile/yellow{
	dir = 4
	},
/obj/effect/turf_decal/bot,
/obj/effect/spawner/random/structure/crate_abandoned,
/turf/open/floor/plasteel,
/area/ruin/unpowered)
"ce" = (
/obj/structure/reagent_dispensers/watertank,
/obj/effect/turf_decal/delivery,
/turf/open/floor/plasteel,
/area/ruin/unpowered)
"cq" = (
/obj/structure/table/reinforced,
/obj/item/storage/toolbox/mechanical,
/obj/item/flashlight{
	pixel_y = -12
	},
/turf/open/floor/plasteel,
/area/ruin/unpowered)
"cZ" = (
/obj/effect/turf_decal/tile/yellow,
/obj/effect/turf_decal/tile/yellow{
	dir = 4
	},
/turf/open/floor/plasteel,
/area/ruin/unpowered)
"eC" = (
/obj/structure/reagent_dispensers/fueltank,
/obj/effect/decal/cleanable/oil,
/obj/effect/turf_decal/delivery,
/obj/effect/turf_decal/tile/yellow{
	dir = 1
	},
/obj/effect/turf_decal/tile/yellow{
	dir = 8
	},
/turf/open/floor/plasteel,
/area/ruin/unpowered)
"fw" = (
/obj/effect/turf_decal/tile/yellow{
	dir = 1
	},
/obj/effect/turf_decal/tile/yellow,
/obj/effect/turf_decal/tile/yellow{
	dir = 8
	},
/turf/open/floor/plasteel,
/area/ruin/unpowered)
"ic" = (
/obj/effect/turf_decal/tile/yellow,
/obj/effect/turf_decal/tile/yellow{
	dir = 8
	},
/turf/open/floor/plasteel,
/area/ruin/unpowered)
"mi" = (
/obj/structure/table/reinforced,
/obj/item/storage/toolbox/electrical,
/obj/effect/turf_decal/bot,
/obj/effect/decal/cleanable/dirt/dust,
/turf/open/floor/plasteel,
/area/ruin/unpowered)
"mj" = (
/turf/closed/wall/riveted_wall,
/area/ruin/unpowered)
"nS" = (
/obj/effect/turf_decal/tile/yellow{
	dir = 1
	},
/obj/effect/turf_decal/tile/yellow{
	dir = 4
	},
/turf/open/floor/plasteel,
/area/ruin/unpowered)
"rB" = (
/obj/effect/turf_decal/tile/yellow,
/obj/effect/turf_decal/tile/yellow{
	dir = 4
	},
/obj/effect/turf_decal/tile/yellow{
	dir = 8
	},
/turf/open/floor/plasteel,
/area/ruin/unpowered)
"vW" = (
/obj/effect/abstract/doorway_marker{
	dir = 8
	},
/turf/open/floor/plasteel,
/area/ruin/unpowered)
"wE" = (
/obj/machinery/vending/assist,
/obj/machinery/light,
/obj/effect/turf_decal/delivery,
/obj/effect/decal/cleanable/dirt/dust,
/turf/open/floor/plasteel,
/area/ruin/unpowered)
"xk" = (
/obj/machinery/vending/tool,
/obj/effect/turf_decal/delivery,
/obj/effect/decal/cleanable/dirt/dust,
/turf/open/floor/plasteel,
/area/ruin/unpowered)
"xR" = (
/obj/structure/table/reinforced,
/obj/item/stack/package_wrap,
/obj/item/hand_labeler,
/obj/effect/turf_decal/tile/neutral,
/turf/open/floor/plasteel,
/area/ruin/unpowered)
"xZ" = (
/obj/structure/table/reinforced,
/obj/item/storage/belt/utility,
/obj/item/weldingtool,
/obj/item/clothing/head/welding,
/obj/effect/turf_decal/bot,
/obj/effect/decal/cleanable/dirt/dust,
/turf/open/floor/plasteel,
/area/ruin/unpowered)
"yL" = (
/obj/structure/table/reinforced,
/obj/item/storage/box/lights/mixed{
	pixel_x = -1;
	pixel_y = 6
	},
/turf/open/floor/plasteel,
/area/ruin/unpowered)
"Bi" = (
/obj/effect/turf_decal/bot,
/obj/item/clothing/head/hardhat/orange{
	name = "protective hat";
	pixel_y = 9
	},
/obj/item/clothing/head/hardhat/orange{
	name = "protective hat";
	pixel_y = 9
	},
/obj/item/clothing/head/hardhat/orange{
	name = "protective hat";
	pixel_y = 9
	},
/obj/item/clothing/suit/hazardvest{
	desc = "A high-visibility lifejacket complete with whistle and slot for oxygen tanks.";
	name = "emergency lifejacket"
	},
/obj/item/clothing/suit/hazardvest{
	desc = "A high-visibility lifejacket complete with whistle and slot for oxygen tanks.";
	name = "emergency lifejacket"
	},
/obj/item/clothing/suit/hazardvest{
	desc = "A high-visibility lifejacket complete with whistle and slot for oxygen tanks.";
	name = "emergency lifejacket"
	},
/obj/structure/closet/crate/cardboard,
/turf/open/floor/plasteel,
/area/ruin/unpowered)
"BO" = (
/obj/effect/abstract/doorway_marker{
	dir = 1
	},
/turf/open/floor/plasteel,
/area/ruin/unpowered)
"BT" = (
/obj/structure/table/reinforced,
/obj/item/stock_parts/cell/high,
/obj/item/stock_parts/cell/high,
/obj/machinery/cell_charger,
/obj/effect/turf_decal/bot,
/obj/effect/decal/cleanable/dirt/dust,
/turf/open/floor/plasteel,
/area/ruin/unpowered)
"Cd" = (
/obj/effect/turf_decal/bot,
/obj/machinery/space_heater,
/turf/open/floor/plasteel,
/area/ruin/unpowered)
"FF" = (
/obj/item/tank/internals/emergency_oxygen/double{
	pixel_x = 3
	},
/obj/item/tank/internals/emergency_oxygen/double{
	pixel_x = 3
	},
/obj/item/tank/internals/emergency_oxygen/double{
	pixel_x = 3
	},
/obj/structure/closet/crate/internals,
/obj/effect/turf_decal/bot,
/obj/machinery/light{
	dir = 4
	},
/obj/item/clothing/mask/breath{
	pixel_x = -3;
	pixel_y = -3
	},
/obj/item/clothing/mask/breath{
	pixel_x = -3;
	pixel_y = -3
	},
/obj/item/clothing/mask/breath{
	pixel_x = -3;
	pixel_y = -3
	},
/turf/open/floor/plasteel,
/area/ruin/unpowered)
"IM" = (
/obj/machinery/autolathe,
/turf/open/floor/plasteel,
/area/ruin/unpowered)
"KX" = (
/obj/effect/turf_decal/tile/yellow{
	dir = 1
	},
/obj/effect/turf_decal/tile/yellow{
	dir = 4
	},
/obj/effect/turf_decal/tile/yellow{
	dir = 8
	},
/turf/open/floor/plasteel,
/area/ruin/unpowered)
"Lo" = (
/obj/structure/table/reinforced,
/obj/item/stack/sheet/iron{
	amount = 30;
	pixel_x = -3;
	pixel_y = 4
	},
/obj/item/stack/sheet/glass{
	amount = 30;
	pixel_x = 12;
	pixel_y = 2
	},
/obj/effect/turf_decal/bot,
/obj/effect/decal/cleanable/dirt/dust,
/turf/open/floor/plasteel,
/area/ruin/unpowered)
"LZ" = (
/obj/effect/turf_decal/tile/yellow{
	dir = 1
	},
/obj/effect/turf_decal/tile/yellow{
	dir = 8
	},
/turf/open/floor/plasteel,
/area/ruin/unpowered)
"MB" = (
/obj/effect/turf_decal/tile/yellow{
	dir = 8
	},
/obj/effect/turf_decal/tile/yellow,
/obj/effect/turf_decal/bot,
/obj/machinery/suit_storage_unit{
	mask_type = /obj/item/clothing/mask/breath;
	suit_type = /obj/item/clothing/suit/space/hardsuit/rig_engineeringalt
	},
/turf/open/floor/plasteel,
/area/ruin/unpowered)
"NH" = (
/turf/template_noop,
/area/template_noop)
"NT" = (
/turf/open/floor/plasteel,
/area/ruin/unpowered)
"Ss" = (
/obj/effect/turf_decal/tile/yellow{
	dir = 1
	},
/obj/effect/turf_decal/tile/yellow,
/obj/effect/turf_decal/tile/yellow{
	dir = 4
	},
/turf/open/floor/plasteel,
/area/ruin/unpowered)
"SC" = (
/obj/structure/table/reinforced,
/obj/item/stack/rods{
	amount = 25
	},
/obj/effect/turf_decal/bot,
/obj/effect/decal/cleanable/dirt/dust,
/turf/open/floor/plasteel,
/area/ruin/unpowered)

(1,1,1) = {"
NH
mj
mj
vW
mj
mj
NH
NH
"}
(2,1,1) = {"
mj
mj
MB
NT
bH
mj
mj
mj
"}
(3,1,1) = {"
mj
xZ
KX
NT
LZ
fw
BT
mj
"}
(4,1,1) = {"
mj
bo
nS
xR
IM
ic
xk
mj
"}
(5,1,1) = {"
BO
NT
NT
cq
yL
ic
wE
mj
"}
(6,1,1) = {"
mj
eC
Ss
cZ
cZ
rB
Lo
mj
"}
(7,1,1) = {"
mj
ce
Cd
Bi
FF
mi
SC
mj
"}
(8,1,1) = {"
mj
mj
mj
mj
mj
mj
mj
mj
"}
