//MAP CONVERTED BY dmm2tgm.py THIS HEADER COMMENT PREVENTS RECONVERSION, DO NOT REMOVE
"a" = (
/obj/effect/turf_decal/tile/blue{
	dir = 8
	},
/obj/effect/turf_decal/tile/blue{
	dir = 1
	},
/obj/effect/turf_decal/tile/blue{
	dir = 4
	},
/obj/effect/turf_decal/tile/blue,
/obj/machinery/vending/drugs,
/turf/open/floor/plasteel/white,
/area/ruin/unpowered)
"b" = (
/obj/effect/turf_decal/tile/blue,
/obj/effect/turf_decal/tile/blue{
	dir = 1
	},
/obj/effect/turf_decal/tile/blue{
	dir = 8
	},
/turf/open/floor/plasteel/white,
/area/ruin/unpowered)
"c" = (
/turf/open/floor/material,
/area/ruin/unpowered)
"d" = (
/obj/effect/spawner/structure/window/reinforced/derelict,
/turf/open/floor/circuit,
/area/ruin/unpowered)
"e" = (
/obj/effect/abstract/open_area_marker{
	dir = 8
	},
/turf/open/floor/material,
/area/ruin/unpowered)
"f" = (
/obj/effect/turf_decal/tile/blue,
/obj/machinery/medipen_refiller,
/obj/effect/turf_decal/tile/blue{
	dir = 8
	},
/turf/open/floor/plasteel/white,
/area/ruin/unpowered)
"g" = (
/obj/effect/abstract/open_area_marker{
	dir = 4
	},
/turf/open/floor/material,
/area/ruin/unpowered)
"h" = (
/obj/effect/turf_decal/tile/blue{
	dir = 8
	},
/obj/effect/turf_decal/tile/blue{
	dir = 1
	},
/obj/effect/turf_decal/tile/blue{
	dir = 4
	},
/obj/effect/turf_decal/tile/blue,
/obj/structure/closet/secure_closet/medical1,
/turf/open/floor/plasteel/white,
/area/ruin/unpowered)
"i" = (
/obj/effect/turf_decal/tile/blue{
	dir = 8
	},
/obj/effect/turf_decal/tile/blue{
	dir = 1
	},
/obj/effect/turf_decal/tile/blue{
	dir = 4
	},
/obj/effect/turf_decal/tile/blue,
/obj/machinery/computer/crew{
	dir = 4
	},
/turf/open/floor/plasteel/white,
/area/ruin/unpowered)
"j" = (
/obj/effect/turf_decal/trimline/blue/corner{
	dir = 4
	},
/obj/effect/turf_decal/trimline/blue/filled/corner{
	dir = 4
	},
/turf/open/floor/plasteel/white,
/area/ruin/unpowered)
"k" = (
/obj/effect/turf_decal/tile/blue{
	dir = 4
	},
/turf/open/floor/plasteel/white,
/area/ruin/unpowered)
"l" = (
/obj/effect/turf_decal/trimline/blue/corner,
/obj/effect/turf_decal/trimline/blue/filled/corner,
/turf/open/floor/plasteel/white,
/area/ruin/unpowered)
"m" = (
/obj/effect/turf_decal/tile/blue{
	dir = 8
	},
/turf/open/floor/plasteel,
/area/ruin/unpowered)
"n" = (
/obj/structure/table/glass,
/obj/machinery/door/window{
	dir = 4
	},
/obj/effect/spawner/lootdrop/ruinloot/medical,
/obj/effect/spawner/lootdrop/ruinloot/medical,
/obj/effect/turf_decal/tile/blue{
	dir = 8
	},
/obj/effect/turf_decal/tile/blue{
	dir = 1
	},
/turf/open/floor/plasteel/white,
/area/ruin/unpowered)
"o" = (
/obj/effect/turf_decal/trimline/blue/filled/line{
	dir = 4
	},
/turf/open/floor/plasteel/white,
/area/ruin/unpowered)
"p" = (
/obj/effect/turf_decal/tile/blue,
/obj/effect/turf_decal/tile/blue{
	dir = 8
	},
/turf/open/floor/plasteel/white,
/area/ruin/unpowered)
"q" = (
/obj/effect/turf_decal/trimline/blue/line{
	dir = 1
	},
/obj/effect/turf_decal/trimline/blue/filled/line{
	dir = 1
	},
/turf/open/floor/plasteel/white,
/area/ruin/unpowered)
"r" = (
/obj/effect/turf_decal/trimline/blue/corner{
	dir = 8
	},
/obj/effect/turf_decal/trimline/blue/filled/corner{
	dir = 8
	},
/turf/open/floor/plasteel/white,
/area/ruin/unpowered)
"s" = (
/obj/structure/table/glass,
/obj/structure/window/reinforced{
	dir = 8
	},
/obj/effect/spawner/lootdrop/ruinloot/medical,
/obj/structure/window/reinforced,
/obj/effect/turf_decal/tile/blue,
/obj/effect/turf_decal/tile/blue{
	dir = 4
	},
/turf/open/floor/plasteel/white,
/area/ruin/unpowered)
"t" = (
/turf/closed/wall/riveted_wall,
/area/ruin/unpowered)
"u" = (
/obj/effect/turf_decal/tile/blue{
	dir = 1
	},
/turf/open/floor/plasteel/white,
/area/ruin/unpowered)
"v" = (
/obj/structure/table,
/obj/effect/turf_decal/tile/blue{
	dir = 4
	},
/obj/effect/turf_decal/tile/blue,
/obj/effect/turf_decal/tile/blue{
	dir = 8
	},
/obj/effect/turf_decal/tile/blue{
	dir = 1
	},
/obj/item/stack/sheet/iron/ten,
/turf/open/floor/plasteel/white,
/area/ruin/unpowered)
"w" = (
/obj/effect/turf_decal/trimline/blue/line,
/obj/effect/turf_decal/trimline/blue/filled/line,
/turf/open/floor/plasteel/white,
/area/ruin/unpowered)
"x" = (
/obj/effect/turf_decal/trimline/blue/line{
	dir = 4
	},
/obj/effect/turf_decal/trimline/blue/filled/line{
	dir = 4
	},
/turf/open/floor/plasteel/white,
/area/ruin/unpowered)
"y" = (
/obj/effect/abstract/doorway_marker,
/turf/open/floor/plasteel/white,
/area/ruin/unpowered)
"z" = (
/obj/effect/turf_decal/tile/blue,
/obj/structure/table,
/obj/item/reagent_containers/glass/bottle/oxandrolone{
	pixel_x = -6;
	pixel_y = 3
	},
/obj/item/reagent_containers/glass/bottle/sal_acid{
	pixel_x = 3
	},
/obj/effect/turf_decal/tile/blue{
	dir = 4
	},
/obj/effect/turf_decal/tile/blue{
	dir = 8
	},
/obj/effect/turf_decal/tile/blue{
	dir = 1
	},
/turf/open/floor/plasteel/white,
/area/ruin/unpowered)
"A" = (
/obj/effect/turf_decal/tile/blue{
	dir = 4
	},
/obj/effect/turf_decal/tile/blue{
	dir = 1
	},
/obj/effect/turf_decal/tile/blue,
/obj/effect/turf_decal/tile/blue{
	dir = 8
	},
/obj/machinery/door/airlock/public/glass,
/turf/open/floor/plasteel/white,
/area/ruin/unpowered)
"B" = (
/obj/effect/turf_decal/trimline/blue/filled/line{
	dir = 8
	},
/turf/open/floor/plasteel/white,
/area/ruin/unpowered)
"C" = (
/obj/effect/turf_decal/tile/blue{
	dir = 1
	},
/obj/effect/turf_decal/tile/blue{
	dir = 4
	},
/turf/open/floor/plasteel/white,
/area/ruin/unpowered)
"D" = (
/turf/open/floor/plasteel,
/area/ruin/unpowered)
"E" = (
/obj/effect/turf_decal/trimline/blue/line{
	dir = 8
	},
/obj/effect/turf_decal/trimline/blue/filled/line{
	dir = 8
	},
/turf/open/floor/plasteel/white,
/area/ruin/unpowered)
"F" = (
/obj/effect/turf_decal/tile/blue{
	dir = 1
	},
/obj/effect/turf_decal/tile/blue{
	dir = 4
	},
/obj/effect/turf_decal/tile/blue{
	dir = 8
	},
/turf/open/floor/plasteel/white,
/area/ruin/unpowered)
"G" = (
/obj/effect/turf_decal/tile/blue,
/turf/open/floor/plasteel/white,
/area/ruin/unpowered)
"I" = (
/obj/structure/table,
/obj/effect/turf_decal/tile/blue{
	dir = 8
	},
/obj/effect/turf_decal/tile/blue{
	dir = 4
	},
/obj/effect/turf_decal/tile/blue,
/obj/effect/turf_decal/tile/blue{
	dir = 1
	},
/obj/item/stack/sheet/glass/five,
/turf/open/floor/plasteel/white,
/area/ruin/unpowered)
"J" = (
/obj/structure/table/glass,
/obj/structure/window/reinforced{
	dir = 4
	},
/obj/effect/spawner/lootdrop/ruinloot/medical,
/obj/structure/window/reinforced{
	dir = 1
	},
/obj/effect/turf_decal/tile/blue{
	dir = 8
	},
/obj/effect/turf_decal/tile/blue{
	dir = 1
	},
/turf/open/floor/plasteel/white,
/area/ruin/unpowered)
"K" = (
/obj/structure/table/glass,
/obj/structure/window/reinforced{
	dir = 4
	},
/obj/effect/spawner/lootdrop/ruinloot/medical,
/obj/structure/window/reinforced,
/obj/effect/turf_decal/tile/blue{
	dir = 8
	},
/obj/effect/turf_decal/tile/blue{
	dir = 1
	},
/turf/open/floor/plasteel/white,
/area/ruin/unpowered)
"L" = (
/obj/effect/turf_decal/tile/blue{
	dir = 1
	},
/obj/effect/turf_decal/tile/blue{
	dir = 4
	},
/obj/effect/turf_decal/tile/blue,
/obj/effect/turf_decal/tile/blue{
	dir = 8
	},
/obj/machinery/door/airlock/public/glass,
/turf/open/floor/plasteel/white,
/area/ruin/unpowered)
"M" = (
/obj/effect/turf_decal/tile/blue{
	dir = 1
	},
/obj/effect/turf_decal/tile/blue{
	dir = 4
	},
/obj/effect/turf_decal/tile/blue,
/obj/effect/turf_decal/tile/blue{
	dir = 8
	},
/obj/machinery/vending/wardrobe/medi_wardrobe,
/turf/open/floor/plasteel/white,
/area/ruin/unpowered)
"N" = (
/obj/effect/turf_decal/tile/blue,
/obj/effect/turf_decal/tile/blue{
	dir = 1
	},
/obj/effect/turf_decal/tile/blue{
	dir = 4
	},
/turf/open/floor/plasteel/white,
/area/ruin/unpowered)
"O" = (
/obj/effect/turf_decal/tile/blue,
/obj/effect/turf_decal/tile/blue{
	dir = 4
	},
/obj/effect/turf_decal/tile/blue{
	dir = 8
	},
/turf/open/floor/plasteel/white,
/area/ruin/unpowered)
"P" = (
/obj/effect/turf_decal/tile/blue{
	dir = 8
	},
/turf/open/floor/plasteel/white,
/area/ruin/unpowered)
"Q" = (
/obj/machinery/medipen_refiller,
/obj/effect/turf_decal/tile/blue,
/obj/effect/turf_decal/tile/blue{
	dir = 8
	},
/turf/open/floor/plasteel/white,
/area/ruin/unpowered)
"R" = (
/obj/machinery/vending/medical,
/obj/effect/turf_decal/tile/blue{
	dir = 8
	},
/obj/effect/turf_decal/tile/blue{
	dir = 8
	},
/obj/effect/turf_decal/tile/blue{
	dir = 1
	},
/obj/effect/turf_decal/tile/blue{
	dir = 4
	},
/obj/effect/turf_decal/tile/blue,
/turf/open/floor/plasteel/white,
/area/ruin/unpowered)
"S" = (
/obj/effect/turf_decal/tile/blue,
/turf/open/floor/plasteel,
/area/ruin/unpowered)
"T" = (
/obj/structure/table/glass,
/obj/structure/window/reinforced{
	dir = 8
	},
/obj/effect/spawner/lootdrop/ruinloot/medical,
/obj/structure/window/reinforced{
	dir = 1
	},
/obj/effect/turf_decal/tile/blue,
/obj/effect/turf_decal/tile/blue{
	dir = 4
	},
/turf/open/floor/plasteel/white,
/area/ruin/unpowered)
"U" = (
/obj/machinery/mecha_part_fabricator/med,
/obj/effect/turf_decal/tile/blue{
	dir = 4
	},
/obj/effect/turf_decal/tile/blue,
/obj/effect/turf_decal/tile/blue{
	dir = 8
	},
/obj/effect/turf_decal/tile/blue{
	dir = 1
	},
/turf/open/floor/plasteel/white,
/area/ruin/unpowered)
"V" = (
/obj/structure/closet/secure_closet/medical3,
/obj/effect/turf_decal/tile/blue{
	dir = 8
	},
/obj/effect/turf_decal/tile/blue{
	dir = 1
	},
/obj/effect/turf_decal/tile/blue{
	dir = 4
	},
/obj/effect/turf_decal/tile/blue,
/turf/open/floor/plasteel/white,
/area/ruin/unpowered)
"W" = (
/obj/effect/turf_decal/trimline/blue/corner{
	dir = 1
	},
/obj/effect/turf_decal/trimline/blue/filled/corner{
	dir = 1
	},
/turf/open/floor/plasteel/white,
/area/ruin/unpowered)
"X" = (
/turf/open/floor/plasteel/white,
/area/ruin/unpowered)
"Y" = (
/obj/structure/table/glass,
/obj/machinery/door/window{
	dir = 8
	},
/obj/item/storage/firstaid,
/obj/effect/turf_decal/tile/blue,
/obj/effect/turf_decal/tile/blue{
	dir = 4
	},
/turf/open/floor/plasteel/white,
/area/ruin/unpowered)
"Z" = (
/obj/effect/turf_decal/tile/blue{
	dir = 8
	},
/obj/effect/turf_decal/tile/blue,
/turf/open/floor/plasteel,
/area/ruin/unpowered)

(1,1,1) = {"
t
c
e
c
t
t
t
t
t
t
t
t
t
"}
(2,1,1) = {"
t
c
D
S
t
a
R
i
J
n
K
M
t
"}
(3,1,1) = {"
t
c
D
Z
d
F
X
P
u
X
P
b
y
"}
(4,1,1) = {"
t
c
D
Z
L
X
l
x
o
x
j
p
t
"}
(5,1,1) = {"
t
c
D
Z
d
C
w
I
U
v
q
f
t
"}
(6,1,1) = {"
t
c
c
Z
A
X
r
E
B
E
W
Q
t
"}
(7,1,1) = {"
t
c
c
Z
d
N
X
G
k
X
G
O
t
"}
(8,1,1) = {"
t
c
c
m
t
h
V
V
T
Y
s
z
t
"}
(9,1,1) = {"
t
c
g
D
t
t
t
t
t
t
t
t
t
"}
