//MAP CONVERTED BY dmm2tgm.py THIS HEADER COMMENT PREVENTS RECONVERSION, DO NOT REMOVE
"a" = (
/turf/template_noop,
/area/template_noop)
"d" = (
/obj/effect/decal/cleanable/dirt,
/turf/open/floor/plating/airless,
/area/ruin)
"e" = (
/obj/structure/closet,
/obj/item/gps/spaceruin,
/turf/open/floor/mineral/plastitanium,
/area/ruin)
"g" = (
/obj/effect/decal/cleanable/oil,
/turf/open/floor/plating/airless,
/area/ruin)
"i" = (
/obj/item/shard,
/obj/item/electronics/apc,
/obj/effect/mapping_helpers/broken_floor,
/turf/open/floor/plasteel,
/area/ruin)
"k" = (
/obj/machinery/portable_atmospherics/canister/oxygen,
/turf/open/floor/mineral/plastitanium,
/area/ruin)
"l" = (
/turf/open/floor/plating/airless,
/area/ruin)
"n" = (
/obj/effect/abstract/doorway_marker{
	dir = 8
	},
/turf/open/floor/plating/airless,
/area/ruin)
"p" = (
/obj/effect/decal/cleanable/robot_debris/old,
/turf/open/floor/plating/airless,
/area/ruin)
"s" = (
/obj/structure/frame/computer,
/turf/open/floor/mineral/plastitanium,
/area/ruin)
"v" = (
/obj/effect/decal/cleanable/dirt,
/turf/open/floor/plasteel,
/area/ruin)
"y" = (
/turf/closed/wall/r_wall,
/area/ruin)
"z" = (
/obj/structure/lattice,
/turf/template_noop,
/area/template_noop)
"A" = (
/obj/machinery/teleport/hub,
/turf/open/floor/mineral/plastitanium,
/area/ruin)
"C" = (
/obj/structure/closet/crate,
/obj/item/aicard,
/obj/item/multitool,
/obj/item/weldingtool,
/obj/item/wrench,
/obj/item/circuitboard/computer/teleporter,
/turf/open/floor/mineral/plastitanium,
/area/ruin)
"D" = (
/obj/item/stock_parts/cell,
/obj/effect/mapping_helpers/broken_floor,
/turf/open/floor/plasteel,
/area/ruin)
"E" = (
/turf/open/floor/mineral/plastitanium,
/area/ruin)
"G" = (
/obj/effect/mapping_helpers/broken_floor,
/turf/open/floor/plasteel,
/area/ruin)
"H" = (
/turf/open/floor/plasteel,
/area/ruin)
"I" = (
/obj/effect/decal/cleanable/dirt,
/obj/item/flashlight,
/turf/open/floor/plating/airless,
/area/ruin)
"J" = (
/obj/effect/decal/cleanable/dirt,
/obj/item/beacon,
/obj/effect/mapping_helpers/broken_floor,
/turf/open/floor/plasteel,
/area/ruin)
"K" = (
/obj/effect/decal/cleanable/blood/old,
/turf/open/floor/plasteel,
/area/ruin)
"L" = (
/obj/item/storage/toolbox/electrical{
	pixel_x = 1;
	pixel_y = -1
	},
/turf/open/floor/mineral/plastitanium,
/area/ruin)
"N" = (
/obj/item/shard{
	icon_state = "medium"
	},
/turf/open/floor/mineral/plastitanium,
/area/ruin)
"P" = (
/obj/effect/abstract/doorway_marker{
	dir = 4
	},
/turf/open/floor/plating/airless,
/area/ruin)
"Q" = (
/obj/effect/abstract/doorway_marker,
/turf/open/floor/plating/airless,
/area/ruin)
"S" = (
/obj/machinery/teleport/station,
/turf/open/floor/mineral/plastitanium,
/area/ruin)
"V" = (
/obj/structure/reagent_dispensers/fueltank,
/turf/open/floor/mineral/plastitanium,
/area/ruin)
"W" = (
/obj/structure/rack,
/obj/item/clothing/gloves/color/yellow,
/turf/open/floor/mineral/plastitanium,
/area/ruin)
"Z" = (
/obj/effect/spawner/random/structure/crate_abandoned,
/turf/open/floor/mineral/plastitanium,
/area/ruin)

(1,1,1) = {"
a
z
y
y
n
y
y
z
a
"}
(2,1,1) = {"
a
y
y
E
l
k
y
y
a
"}
(3,1,1) = {"
y
y
N
D
I
K
E
y
y
"}
(4,1,1) = {"
y
s
H
d
p
l
G
C
y
"}
(5,1,1) = {"
y
S
l
l
J
g
d
l
Q
"}
(6,1,1) = {"
y
A
H
p
l
l
H
V
y
"}
(7,1,1) = {"
y
y
W
v
l
i
L
y
y
"}
(8,1,1) = {"
z
y
y
Z
l
e
y
y
z
"}
(9,1,1) = {"
a
a
y
y
P
y
y
a
a
"}
