//MAP CONVERTED BY dmm2tgm.py THIS HEADER COMMENT PREVENTS RECONVERSION, DO NOT REMOVE
"a" = (
/turf/closed/wall,
/area/maintenance/port/aft)
"b" = (
/obj/machinery/door/airlock/maintenance{
	req_access_txt = "12"
	},
/obj/effect/mapping_helpers/airlock/abandoned,
/turf/open/floor/plating,
/area/maintenance/port/aft)
"c" = (
/obj/effect/spawner/structure/window/reinforced,
/turf/open/floor/plating,
/area/maintenance/port/aft)
"e" = (
/obj/structure/table/wood,
/obj/effect/turf_decal/stripes/line{
	dir = 8
	},
/obj/item/clothing/under/wzzzz/victorianreddress,
/turf/open/floor/plating,
/area/maintenance/port/aft)
"g" = (
/turf/open/floor/partyhard/steel{
	icon_state = "dd-3"
	},
/area/maintenance/port/aft)
"i" = (
/turf/open/floor/partyhard/steel{
	icon_state = "dd-9"
	},
/area/maintenance/port/aft)
"j" = (
/turf/open/floor/partyhard/steel{
	icon_state = "dd-4"
	},
/area/maintenance/port/aft)
"k" = (
/obj/machinery/door/airlock/maintenance{
	name = "Incinerator Access";
	req_access_txt = "12"
	},
/obj/effect/mapping_helpers/airlock/abandoned,
/obj/structure/barricade/wooden{
	name = "wooden barricade (CLOSED)"
	},
/turf/open/floor/plating,
/area/maintenance/port/aft)
"l" = (
/turf/open/floor/partyhard/steel{
	icon_state = "dd-7"
	},
/area/maintenance/port/aft)
"m" = (
/obj/structure/chair/sofa/right,
/turf/open/floor/partyhard/steel{
	icon_state = "s-3"
	},
/area/maintenance/port/aft)
"n" = (
/obj/item/clothing/under/wzzzz/victorianvest,
/obj/item/melee/baseball_bat/ablative,
/turf/open/floor/partyhard/steel{
	icon_state = "dd-2"
	},
/area/maintenance/port/aft)
"o" = (
/turf/open/floor/partyhard/steel{
	icon_state = "dd-8"
	},
/area/maintenance/port/aft)
"p" = (
/obj/machinery/light{
	dir = 8
	},
/turf/open/floor/partyhard/steel{
	icon_state = "dd-7"
	},
/area/maintenance/port/aft)
"q" = (
/turf/open/floor/partyhard/steel{
	icon_state = "dd-6"
	},
/area/maintenance/port/aft)
"r" = (
/turf/open/floor/partyhard/steel{
	icon_state = "dd-10"
	},
/area/maintenance/port/aft)
"t" = (
/obj/structure/chair/sofa,
/turf/open/floor/partyhard/steel{
	icon_state = "w-2"
	},
/area/maintenance/port/aft)
"u" = (
/obj/structure/chair/sofa,
/turf/open/floor/partyhard/steel{
	icon_state = "s-3"
	},
/area/maintenance/port/aft)
"v" = (
/obj/structure/chair/sofa,
/turf/open/floor/partyhard/steel{
	icon_state = "s-2"
	},
/area/maintenance/port/aft)
"w" = (
/obj/structure/barricade/wooden{
	name = "wooden barricade (CLOSED)"
	},
/obj/machinery/door/airlock/maintenance{
	req_access_txt = "12"
	},
/obj/effect/mapping_helpers/airlock/abandoned,
/turf/open/floor/plating,
/area/maintenance/port/aft)
"x" = (
/turf/template_noop,
/area/template_noop)
"y" = (
/turf/open/floor/plating,
/area/maintenance/port/aft)
"z" = (
/turf/open/floor/partyhard/steel{
	icon_state = "dd-5"
	},
/area/maintenance/port/aft)
"A" = (
/obj/effect/turf_decal/stripes/line{
	dir = 8
	},
/turf/open/floor/plating,
/area/maintenance/port/aft)
"B" = (
/obj/machinery/light/small{
	dir = 4
	},
/obj/effect/turf_decal/stripes/line{
	dir = 8
	},
/turf/open/floor/plating,
/area/maintenance/port/aft)
"C" = (
/obj/effect/turf_decal/trimline/neutral/line{
	icon_state = "trimline";
	dir = 9
	},
/turf/open/floor/partyhard/steel{
	icon_state = "dd-2"
	},
/area/maintenance/port/aft)
"D" = (
/obj/effect/turf_decal/trimline/neutral/line{
	icon_state = "trimline";
	dir = 1
	},
/turf/open/floor/partyhard/steel{
	icon_state = "dd-2"
	},
/area/maintenance/port/aft)
"E" = (
/obj/effect/turf_decal/trimline/neutral/line{
	icon_state = "trimline";
	dir = 5
	},
/turf/open/floor/partyhard/steel{
	icon_state = "dd-2"
	},
/area/maintenance/port/aft)
"F" = (
/obj/effect/turf_decal/trimline/neutral/line{
	icon_state = "trimline";
	dir = 8
	},
/turf/open/floor/partyhard/steel{
	icon_state = "dd-2"
	},
/area/maintenance/port/aft)
"G" = (
/obj/effect/turf_decal/trimline/neutral/line{
	icon_state = "trimline";
	dir = 4
	},
/turf/open/floor/partyhard/steel{
	icon_state = "dd-2"
	},
/area/maintenance/port/aft)
"H" = (
/obj/effect/turf_decal/trimline/neutral/line{
	icon_state = "trimline";
	dir = 10
	},
/turf/open/floor/partyhard/steel{
	icon_state = "dd-2"
	},
/area/maintenance/port/aft)
"I" = (
/obj/effect/turf_decal/trimline/neutral/line,
/turf/open/floor/partyhard/steel{
	icon_state = "dd-2"
	},
/area/maintenance/port/aft)
"J" = (
/obj/effect/turf_decal/trimline/neutral/line{
	icon_state = "trimline";
	dir = 6
	},
/turf/open/floor/partyhard/steel{
	icon_state = "dd-2"
	},
/area/maintenance/port/aft)
"K" = (
/obj/effect/decal/cleanable/blood/gibs,
/obj/item/clothing/under/wzzzz/victorianvest,
/obj/item/melee/baseball_bat/ablative,
/turf/open/floor/partyhard/steel{
	icon_state = "dd-2"
	},
/area/maintenance/port/aft)
"L" = (
/obj/structure/table/wood,
/obj/effect/turf_decal/stripes/line{
	dir = 8
	},
/obj/item/clothing/under/wzzzz/victorianblackdress,
/turf/open/floor/plating,
/area/maintenance/port/aft)
"M" = (
/obj/item/clothing/under/wzzzz/victorianblred,
/obj/item/melee/baseball_bat/ablative,
/turf/open/floor/partyhard/steel{
	icon_state = "dd-2"
	},
/area/maintenance/port/aft)
"N" = (
/obj/structure/chair/sofa,
/turf/open/floor/partyhard/steel{
	icon_state = "w-3"
	},
/area/maintenance/port/aft)
"O" = (
/obj/structure/chair/sofa/left,
/turf/open/floor/partyhard/steel{
	icon_state = "s-3"
	},
/area/maintenance/port/aft)
"P" = (
/obj/structure/chair/sofa/right{
	icon_state = "sofaend_right";
	dir = 1
	},
/turf/open/floor/partyhard/steel{
	icon_state = "s-3"
	},
/area/maintenance/port/aft)
"Q" = (
/obj/structure/chair/sofa{
	icon_state = "sofamiddle";
	dir = 1
	},
/turf/open/floor/partyhard/steel{
	icon_state = "s-2"
	},
/area/maintenance/port/aft)
"R" = (
/obj/structure/chair/sofa{
	icon_state = "sofamiddle";
	dir = 1
	},
/turf/open/floor/partyhard/steel{
	icon_state = "w-3"
	},
/area/maintenance/port/aft)
"S" = (
/obj/structure/chair/sofa{
	icon_state = "sofamiddle";
	dir = 1
	},
/turf/open/floor/partyhard/steel{
	icon_state = "s-3"
	},
/area/maintenance/port/aft)
"T" = (
/obj/structure/chair/sofa{
	icon_state = "sofamiddle";
	dir = 1
	},
/turf/open/floor/partyhard/steel{
	icon_state = "w-2"
	},
/area/maintenance/port/aft)
"U" = (
/obj/structure/chair/sofa/left{
	icon_state = "sofaend_left";
	dir = 1
	},
/turf/open/floor/partyhard/steel{
	icon_state = "s-3"
	},
/area/maintenance/port/aft)
"V" = (
/obj/structure/sign/warning/nosmoking{
	pixel_x = -28
	},
/turf/open/floor/plating,
/area/maintenance/port/aft)
"W" = (
/obj/machinery/effector,
/turf/closed/wall,
/area/maintenance/port/aft)

(1,1,1) = {"
a
a
a
a
a
k
a
a
c
a
a
a
a
a
"}
(2,1,1) = {"
a
y
V
y
y
y
a
x
x
x
x
x
x
c
"}
(3,1,1) = {"
a
y
W
a
a
a
a
a
a
a
a
W
x
c
"}
(4,1,1) = {"
b
y
a
m
g
l
p
l
l
q
P
a
x
c
"}
(5,1,1) = {"
a
y
a
t
i
C
F
F
H
r
Q
a
x
c
"}
(6,1,1) = {"
a
y
a
u
i
D
n
M
I
r
R
a
x
c
"}
(7,1,1) = {"
a
y
a
v
i
D
K
M
I
r
S
a
x
c
"}
(8,1,1) = {"
c
y
a
N
i
E
G
G
J
r
T
a
x
c
"}
(9,1,1) = {"
c
y
a
O
j
o
o
o
o
z
U
a
x
a
"}
(10,1,1) = {"
c
y
W
e
A
B
A
A
A
A
L
W
x
a
"}
(11,1,1) = {"
a
y
a
a
a
a
w
w
a
a
a
a
a
a
"}
