//MAP CONVERTED BY dmm2tgm.py THIS HEADER COMMENT PREVENTS RECONVERSION, DO NOT REMOVE
"a" = (
/turf/open/space/basic,
/area/space)
"b" = (
/obj/effect/turf_decal/tile/blue,
/obj/effect/turf_decal/tile/blue{
	dir = 4
	},
/obj/effect/turf_decal/tile/blue{
	dir = 8
	},
/turf/open/floor/plasteel/dark,
/area/bridge)
"c" = (
/obj/effect/turf_decal/tile/blue,
/turf/open/floor/plasteel/dark,
/area/bridge)
"f" = (
/obj/effect/turf_decal/tile/blue{
	dir = 1
	},
/obj/effect/turf_decal/tile/blue,
/obj/effect/turf_decal/tile/blue{
	dir = 8
	},
/obj/effect/turf_decal/tile/blue{
	dir = 4
	},
/turf/open/floor/plasteel/dark,
/area/bridge)
"h" = (
/obj/structure/lattice,
/turf/open/space/basic,
/area/space/nearstation)
"j" = (
/obj/effect/turf_decal/tile/blue{
	dir = 4
	},
/obj/effect/turf_decal/tile/blue{
	dir = 1
	},
/obj/effect/turf_decal/tile/blue{
	dir = 8
	},
/obj/effect/turf_decal/tile/blue,
/turf/open/floor/plasteel/dark,
/area/bridge)
"m" = (
/turf/closed/wall/r_wall,
/area/maintenance/bottom_station_maints/north)
"n" = (
/obj/effect/turf_decal/tile/blue,
/obj/effect/turf_decal/tile/blue{
	dir = 1
	},
/obj/effect/turf_decal/tile/blue{
	dir = 8
	},
/turf/open/floor/plasteel/dark,
/area/bridge)
"o" = (
/turf/template_noop,
/area/template_noop)
"p" = (
/obj/effect/turf_decal/tile/blue{
	dir = 8
	},
/turf/open/floor/plasteel/dark,
/area/bridge)
"q" = (
/obj/effect/turf_decal/tile/blue{
	dir = 4
	},
/obj/effect/turf_decal/tile/blue,
/obj/effect/turf_decal/tile/blue{
	dir = 1
	},
/turf/open/floor/plasteel/dark,
/area/bridge)
"r" = (
/obj/effect/spawner/structure/window/reinforced,
/turf/open/floor/plating,
/area/maintenance/bottom_station_maints/north)
"s" = (
/turf/closed/wall,
/area/bridge)
"t" = (
/obj/effect/turf_decal/tile/blue{
	dir = 4
	},
/obj/effect/turf_decal/tile/blue,
/obj/effect/turf_decal/tile/blue{
	dir = 8
	},
/obj/effect/turf_decal/tile/blue{
	dir = 1
	},
/turf/open/floor/plasteel/dark,
/area/bridge)
"u" = (
/obj/structure/table,
/turf/open/floor/plating,
/area/maintenance/bottom_station_maints)
"v" = (
/obj/effect/turf_decal/tile/blue,
/obj/effect/turf_decal/tile/blue{
	dir = 4
	},
/turf/open/floor/plasteel/dark,
/area/bridge)
"y" = (
/obj/effect/turf_decal/tile/blue{
	dir = 1
	},
/obj/effect/turf_decal/tile/blue{
	dir = 8
	},
/turf/open/floor/plasteel/dark,
/area/bridge)
"z" = (
/obj/effect/spawner/structure/window/reinforced,
/obj/machinery/door/firedoor/window,
/turf/open/floor/plating,
/area/bridge)
"B" = (
/obj/effect/turf_decal/tile/blue,
/obj/effect/turf_decal/tile/blue{
	dir = 8
	},
/obj/effect/turf_decal/tile/blue{
	dir = 1
	},
/obj/effect/turf_decal/tile/blue{
	dir = 4
	},
/turf/open/floor/plasteel/dark,
/area/bridge)
"C" = (
/turf/open/floor/plating,
/area/maintenance/bottom_station_maints)
"D" = (
/turf/closed/wall/r_wall,
/area/maintenance/bottom_station_maints)
"E" = (
/obj/effect/turf_decal/tile/blue{
	dir = 4
	},
/obj/effect/turf_decal/tile/blue{
	dir = 1
	},
/obj/effect/turf_decal/tile/blue,
/obj/effect/turf_decal/tile/blue{
	dir = 8
	},
/turf/open/floor/plasteel/dark,
/area/bridge)
"F" = (
/obj/effect/turf_decal/tile/blue{
	dir = 1
	},
/obj/effect/turf_decal/tile/blue{
	dir = 8
	},
/obj/effect/turf_decal/tile/blue{
	dir = 4
	},
/turf/open/floor/plasteel/dark,
/area/bridge)
"G" = (
/obj/effect/turf_decal/tile/blue{
	dir = 1
	},
/obj/effect/turf_decal/tile/blue{
	dir = 4
	},
/obj/effect/turf_decal/tile/blue{
	dir = 8
	},
/obj/effect/turf_decal/tile/blue,
/turf/open/floor/plasteel/dark,
/area/bridge)
"H" = (
/obj/effect/turf_decal/tile/blue{
	dir = 4
	},
/obj/effect/turf_decal/tile/blue{
	dir = 8
	},
/obj/effect/turf_decal/tile/blue,
/turf/open/floor/plasteel/dark,
/area/bridge)
"I" = (
/turf/open/floor/plasteel/monofloor/dark,
/area/bridge)
"K" = (
/obj/effect/turf_decal/tile/blue{
	dir = 4
	},
/obj/effect/turf_decal/tile/blue{
	dir = 1
	},
/obj/effect/turf_decal/tile/blue{
	dir = 8
	},
/turf/open/floor/plasteel/dark,
/area/bridge)
"O" = (
/turf/closed/wall/r_wall,
/area/bridge)
"Q" = (
/obj/effect/turf_decal/tile/blue{
	dir = 4
	},
/turf/open/floor/plasteel/dark,
/area/bridge)
"S" = (
/obj/effect/turf_decal/tile/blue{
	dir = 1
	},
/turf/open/floor/plasteel/dark,
/area/bridge)
"V" = (
/turf/open/floor/plasteel/dark,
/area/bridge)
"W" = (
/obj/effect/turf_decal/tile/blue{
	dir = 4
	},
/obj/effect/turf_decal/tile/blue{
	dir = 1
	},
/obj/effect/turf_decal/tile/blue,
/turf/open/floor/plasteel/dark,
/area/bridge)
"X" = (
/obj/effect/turf_decal/tile/blue{
	dir = 4
	},
/obj/effect/turf_decal/tile/blue,
/obj/effect/turf_decal/tile/blue{
	dir = 1
	},
/obj/effect/turf_decal/tile/blue{
	dir = 8
	},
/turf/open/floor/plasteel/dark,
/area/bridge)
"Y" = (
/obj/effect/turf_decal/tile/blue{
	dir = 4
	},
/obj/effect/turf_decal/tile/blue,
/turf/open/floor/plasteel/dark,
/area/bridge)
"Z" = (
/obj/effect/turf_decal/tile/blue{
	dir = 8
	},
/obj/effect/turf_decal/tile/blue{
	dir = 1
	},
/obj/effect/turf_decal/tile/blue{
	dir = 4
	},
/turf/open/floor/plasteel/dark,
/area/bridge)

(1,1,1) = {"
o
o
o
o
o
o
o
O
z
z
z
z
z
z
O
z
z
z
z
O
O
z
z
z
z
O
z
z
z
z
z
z
O
o
o
o
"}
(2,1,1) = {"
o
o
o
o
o
o
o
I
I
I
I
I
I
I
I
I
I
I
I
I
I
I
I
I
I
I
I
I
I
I
I
I
I
o
o
o
"}
(3,1,1) = {"
o
o
o
o
o
o
o
I
I
I
I
I
I
I
I
I
I
I
I
I
I
I
I
I
I
I
I
I
I
I
I
I
I
o
o
o
"}
(4,1,1) = {"
o
o
o
o
o
o
o
I
I
I
I
I
I
I
I
I
I
I
I
I
I
I
I
I
I
I
I
I
I
I
I
I
I
o
o
o
"}
(5,1,1) = {"
o
o
o
o
o
o
o
I
I
I
I
I
I
I
I
I
I
I
I
I
I
I
I
I
I
I
I
I
I
I
I
I
I
o
o
o
"}
(6,1,1) = {"
o
o
o
o
o
o
o
I
I
I
I
I
I
I
I
I
I
I
I
I
I
I
I
I
I
I
I
I
I
I
I
I
I
o
o
o
"}
(7,1,1) = {"
o
o
o
o
o
o
o
I
I
I
I
I
I
I
I
I
I
I
I
I
I
I
I
I
I
I
I
I
I
I
I
I
I
o
o
o
"}
(8,1,1) = {"
o
o
o
o
o
o
o
I
I
I
I
I
I
I
I
I
I
I
I
I
I
I
I
I
I
I
I
I
I
I
I
I
I
o
o
o
"}
(9,1,1) = {"
o
o
o
o
o
o
o
I
I
I
I
I
I
I
I
I
I
I
I
I
I
I
I
I
I
I
I
I
I
I
I
I
I
o
o
o
"}
(10,1,1) = {"
o
o
o
o
o
o
o
I
I
I
s
z
z
z
s
z
z
z
s
I
I
s
z
z
z
s
z
z
z
s
I
I
I
o
o
o
"}
(11,1,1) = {"
o
o
o
o
o
o
o
I
I
I
z
c
t
q
V
V
V
c
v
X
X
q
Q
V
V
V
V
V
H
z
I
I
I
o
o
o
"}
(12,1,1) = {"
o
o
o
o
o
o
o
I
I
I
z
B
E
E
W
V
c
t
X
X
X
X
X
q
Y
V
c
b
j
z
I
I
I
o
o
o
"}
(13,1,1) = {"
o
o
o
o
o
o
o
I
I
I
z
B
E
E
E
q
K
S
V
V
y
X
X
X
X
X
X
X
j
z
I
I
I
o
o
o
"}
(14,1,1) = {"
o
o
o
o
o
o
o
I
I
I
z
Z
E
E
E
E
W
V
V
V
V
V
n
X
X
X
X
X
j
z
I
I
I
o
o
o
"}
(15,1,1) = {"
o
o
o
o
o
o
m
I
I
I
z
V
p
E
E
E
E
W
V
V
V
V
V
n
X
X
X
X
K
z
I
I
I
o
o
o
"}
(16,1,1) = {"
o
o
o
o
o
o
m
I
I
I
z
V
V
p
E
E
E
E
W
V
V
V
V
V
n
X
X
K
V
z
I
I
I
o
o
o
"}
(17,1,1) = {"
o
o
o
o
o
o
m
I
I
I
s
V
V
V
p
E
E
E
E
W
V
V
V
V
V
y
y
V
V
s
I
I
I
o
o
o
"}
(18,1,1) = {"
o
o
o
o
o
o
m
I
I
I
I
V
V
V
V
p
E
E
E
E
W
V
V
V
V
V
V
V
V
I
I
I
I
O
a
o
"}
(19,1,1) = {"
o
o
o
o
o
o
m
I
I
I
I
V
V
V
V
V
p
E
E
E
E
W
V
V
V
V
V
V
V
I
I
I
I
O
h
o
"}
(20,1,1) = {"
o
o
o
o
o
o
m
I
I
I
I
V
V
V
V
V
V
p
E
E
E
E
W
V
V
V
V
V
V
I
I
I
I
O
a
o
"}
(21,1,1) = {"
o
o
o
o
o
o
O
I
I
I
s
V
Y
Y
V
V
V
V
p
E
E
E
E
W
V
V
V
V
V
s
I
I
I
D
D
o
"}
(22,1,1) = {"
o
o
o
o
o
o
O
I
I
I
z
E
E
E
E
Q
V
V
c
K
E
E
E
E
W
V
V
V
V
z
I
I
I
D
u
o
"}
(23,1,1) = {"
o
o
o
o
o
o
O
I
I
I
z
Z
E
E
E
E
Q
c
K
V
p
E
E
E
E
q
Q
V
V
z
I
I
I
D
C
o
"}
(24,1,1) = {"
o
o
o
o
o
o
O
I
I
I
z
V
p
E
E
E
E
K
V
V
V
p
E
E
E
E
G
q
Y
z
I
I
I
D
C
o
"}
(25,1,1) = {"
o
o
o
o
o
o
O
I
I
I
z
V
V
p
E
E
E
E
Q
V
V
V
p
E
E
E
G
F
S
z
I
I
I
D
C
o
"}
(26,1,1) = {"
o
o
o
o
o
o
O
I
I
I
z
V
V
V
p
E
E
E
E
V
V
V
V
p
f
j
F
V
V
z
I
I
I
D
C
o
"}
(27,1,1) = {"
o
o
o
o
o
o
O
I
I
I
z
V
V
V
V
V
y
G
S
V
V
V
V
V
p
y
V
V
V
z
I
I
I
D
C
o
"}
(28,1,1) = {"
o
o
o
o
o
o
O
I
I
I
s
z
z
z
s
z
z
z
s
I
I
s
z
z
z
s
z
z
z
s
I
I
I
D
C
o
"}
(29,1,1) = {"
o
o
o
o
o
o
O
I
I
I
I
I
I
I
I
I
I
I
I
I
I
I
I
I
I
I
I
I
I
I
I
I
I
D
C
o
"}
(30,1,1) = {"
o
o
o
o
o
o
O
I
I
I
I
I
I
I
I
I
I
I
I
I
I
I
I
I
I
I
I
o
o
o
o
o
o
o
o
o
"}
(31,1,1) = {"
o
o
o
o
o
o
O
I
I
I
I
I
I
I
I
I
I
I
I
I
I
I
I
I
I
I
I
o
o
o
o
o
o
o
o
o
"}
(32,1,1) = {"
o
o
o
o
o
o
O
I
I
I
I
I
I
I
I
I
I
I
I
I
I
I
I
I
I
I
I
o
o
o
o
o
o
o
o
o
"}
(33,1,1) = {"
o
o
o
o
o
o
O
O
O
O
O
O
O
O
O
I
I
I
I
I
I
I
I
I
I
I
I
o
o
o
o
o
o
o
o
o
"}
(34,1,1) = {"
o
o
o
o
o
o
o
o
o
o
o
o
o
o
m
I
I
I
I
I
I
I
I
I
I
I
I
o
o
o
o
o
o
o
o
o
"}
(35,1,1) = {"
o
o
o
o
o
o
o
o
o
o
o
o
o
o
m
I
I
I
I
I
I
I
I
I
I
I
I
o
o
o
o
o
o
o
o
o
"}
(36,1,1) = {"
o
o
o
o
o
o
o
o
o
o
o
o
o
o
m
I
I
I
I
I
I
I
I
I
I
I
I
o
o
o
o
o
o
o
o
o
"}
(37,1,1) = {"
o
o
o
o
o
o
o
o
o
o
o
o
o
o
m
m
m
m
m
m
m
m
m
r
m
m
m
o
o
o
o
o
o
o
o
o
"}
