//MAP CONVERTED BY dmm2tgm.py THIS HEADER COMMENT PREVENTS RECONVERSION, DO NOT REMOVE
"ab" = (
/turf/template_noop,
/area/template_noop)
"aD" = (
/turf/closed/wall,
/area/maintenance/bottom_station_maints/north)
"jH" = (
/obj/structure/lattice,
/obj/structure/grille,
/turf/open/space/basic,
/area/space/nearstation)
"lr" = (
/obj/effect/spawner/structure/window/reinforced,
/turf/open/floor/plating,
/area/maintenance/bottom_station_maints/north)
"Ws" = (
/turf/closed/wall/r_wall,
/area/maintenance/bottom_station_maints/north)
"YS" = (
/turf/open/space/basic,
/area/space)
"Zl" = (
/obj/structure/lattice,
/turf/open/space/basic,
/area/space/nearstation)

(1,1,1) = {"
ab
ab
ab
ab
ab
ab
ab
YS
YS
YS
jH
YS
YS
YS
YS
Zl
YS
YS
YS
YS
YS
YS
Zl
YS
YS
YS
YS
YS
YS
YS
Zl
YS
YS
ab
ab
ab
"}
(2,1,1) = {"
ab
ab
ab
ab
ab
ab
ab
YS
YS
YS
jH
YS
YS
YS
YS
Zl
YS
YS
YS
YS
YS
YS
Zl
YS
YS
YS
YS
YS
YS
YS
Zl
YS
YS
ab
ab
ab
"}
(3,1,1) = {"
ab
ab
ab
ab
ab
ab
ab
YS
YS
YS
jH
YS
YS
YS
YS
Zl
Zl
Zl
Zl
Zl
Zl
Zl
Zl
Zl
Zl
Zl
Zl
Zl
Zl
Zl
Zl
Zl
Zl
ab
ab
ab
"}
(4,1,1) = {"
ab
ab
ab
ab
ab
ab
ab
YS
YS
YS
YS
YS
YS
YS
YS
jH
YS
YS
YS
YS
YS
YS
Zl
YS
YS
YS
YS
YS
YS
YS
Zl
YS
YS
ab
ab
ab
"}
(5,1,1) = {"
ab
ab
ab
ab
ab
ab
ab
YS
YS
YS
YS
YS
YS
YS
YS
jH
YS
YS
YS
YS
YS
YS
Zl
YS
YS
YS
YS
YS
YS
YS
Zl
YS
YS
ab
ab
ab
"}
(6,1,1) = {"
ab
ab
ab
ab
ab
ab
ab
YS
YS
YS
YS
YS
YS
YS
YS
jH
YS
YS
YS
YS
YS
YS
Zl
YS
YS
YS
YS
YS
YS
YS
Zl
YS
YS
ab
ab
ab
"}
(7,1,1) = {"
ab
ab
ab
ab
ab
ab
ab
YS
YS
YS
YS
YS
YS
YS
YS
jH
YS
YS
YS
YS
YS
YS
Zl
YS
YS
YS
YS
YS
YS
YS
Zl
YS
YS
ab
ab
ab
"}
(8,1,1) = {"
ab
ab
ab
ab
ab
ab
ab
Zl
jH
Zl
Zl
Zl
Zl
Zl
Zl
jH
YS
YS
YS
YS
YS
YS
Zl
YS
YS
YS
YS
YS
YS
Zl
Zl
Zl
Zl
ab
ab
ab
"}
(9,1,1) = {"
ab
ab
ab
ab
ab
ab
ab
YS
YS
YS
YS
YS
YS
YS
YS
jH
YS
YS
YS
YS
YS
YS
Zl
YS
YS
YS
YS
YS
YS
YS
Zl
YS
YS
ab
ab
ab
"}
(10,1,1) = {"
ab
ab
ab
ab
ab
ab
ab
YS
YS
YS
YS
YS
YS
YS
YS
jH
YS
YS
YS
YS
YS
YS
Zl
YS
YS
YS
YS
YS
YS
YS
Zl
YS
YS
ab
ab
ab
"}
(11,1,1) = {"
ab
ab
ab
ab
ab
ab
ab
YS
YS
YS
YS
YS
YS
YS
YS
jH
YS
YS
YS
Zl
jH
jH
jH
jH
jH
jH
jH
jH
jH
jH
Zl
YS
YS
ab
ab
ab
"}
(12,1,1) = {"
ab
ab
ab
ab
ab
ab
ab
YS
YS
YS
YS
YS
YS
YS
YS
jH
YS
YS
YS
YS
YS
YS
Zl
YS
YS
YS
YS
YS
YS
YS
Zl
YS
YS
ab
ab
ab
"}
(13,1,1) = {"
ab
ab
ab
ab
ab
ab
ab
YS
YS
YS
Zl
YS
YS
YS
YS
jH
YS
YS
YS
YS
YS
YS
Zl
YS
YS
YS
YS
YS
YS
YS
Zl
YS
YS
ab
ab
ab
"}
(14,1,1) = {"
ab
ab
ab
ab
ab
ab
ab
YS
YS
YS
Zl
YS
YS
YS
YS
jH
YS
YS
YS
YS
YS
YS
Zl
YS
YS
YS
YS
YS
YS
YS
Zl
YS
YS
ab
ab
ab
"}
(15,1,1) = {"
ab
ab
ab
ab
ab
ab
Ws
Zl
Zl
Zl
Zl
Zl
Zl
Zl
Zl
Zl
Zl
Zl
Zl
Zl
Zl
Zl
Zl
Zl
Zl
Zl
Zl
Zl
Zl
Zl
Zl
Zl
Zl
ab
ab
ab
"}
(16,1,1) = {"
ab
ab
ab
ab
ab
ab
Ws
YS
YS
YS
Zl
YS
YS
YS
YS
Zl
YS
YS
YS
YS
YS
YS
Zl
YS
YS
YS
YS
YS
YS
YS
Zl
YS
YS
ab
ab
ab
"}
(17,1,1) = {"
ab
ab
ab
ab
ab
ab
Ws
YS
YS
YS
Zl
YS
YS
YS
YS
Zl
YS
YS
YS
YS
YS
YS
Zl
YS
YS
YS
YS
YS
YS
YS
Zl
YS
YS
ab
ab
ab
"}
(18,1,1) = {"
ab
ab
ab
ab
ab
ab
Ws
YS
YS
YS
Zl
YS
YS
Zl
Zl
Zl
Zl
Zl
Zl
Zl
Zl
Zl
Zl
Zl
Zl
YS
YS
YS
YS
YS
Zl
YS
YS
YS
YS
YS
"}
(19,1,1) = {"
ab
ab
ab
ab
ab
ab
Ws
YS
YS
YS
Zl
YS
YS
YS
YS
Zl
YS
YS
YS
YS
YS
YS
Zl
YS
YS
YS
YS
YS
YS
YS
Zl
YS
YS
YS
YS
YS
"}
(20,1,1) = {"
ab
ab
ab
ab
ab
ab
Ws
YS
YS
YS
Zl
YS
YS
YS
YS
Zl
YS
YS
YS
YS
YS
YS
Zl
YS
YS
YS
YS
YS
YS
YS
Zl
YS
YS
YS
YS
YS
"}
(21,1,1) = {"
ab
ab
ab
ab
ab
ab
Ws
YS
YS
YS
Zl
YS
YS
YS
YS
Zl
YS
YS
YS
YS
YS
YS
Zl
YS
YS
YS
YS
YS
YS
Zl
Zl
Zl
Zl
Zl
Zl
Zl
"}
(22,1,1) = {"
ab
ab
ab
ab
ab
ab
Ws
YS
YS
YS
Zl
YS
YS
YS
YS
Zl
YS
YS
YS
YS
YS
YS
Zl
YS
YS
YS
YS
YS
YS
YS
Zl
YS
YS
YS
YS
YS
"}
(23,1,1) = {"
ab
ab
ab
ab
ab
ab
Ws
YS
YS
YS
Zl
YS
YS
YS
YS
Zl
YS
YS
YS
YS
YS
YS
Zl
YS
YS
YS
YS
YS
YS
YS
Zl
YS
YS
YS
YS
YS
"}
(24,1,1) = {"
ab
ab
ab
ab
ab
ab
Ws
YS
YS
YS
Zl
YS
YS
YS
YS
Zl
YS
YS
YS
YS
YS
YS
Zl
YS
YS
YS
YS
YS
YS
YS
Zl
YS
YS
YS
YS
YS
"}
(25,1,1) = {"
ab
ab
ab
ab
ab
ab
Ws
Zl
Zl
Zl
Zl
Zl
Zl
Zl
Zl
Zl
Zl
Zl
Zl
Zl
Zl
Zl
Zl
Zl
Zl
Zl
Zl
Zl
Zl
Zl
Zl
Zl
Zl
Zl
Zl
Zl
"}
(26,1,1) = {"
ab
ab
ab
ab
ab
ab
aD
Zl
YS
YS
Zl
YS
YS
YS
YS
Zl
YS
YS
YS
YS
YS
YS
Zl
YS
YS
YS
YS
YS
YS
YS
Zl
YS
YS
YS
YS
YS
"}
(27,1,1) = {"
ab
ab
ab
ab
ab
ab
aD
Zl
YS
YS
Zl
YS
YS
YS
YS
Zl
YS
YS
YS
YS
YS
YS
Zl
YS
YS
YS
YS
YS
YS
YS
Zl
YS
YS
YS
YS
YS
"}
(28,1,1) = {"
ab
ab
ab
ab
ab
ab
aD
Zl
YS
YS
Zl
YS
YS
YS
YS
Zl
YS
YS
YS
YS
YS
YS
Zl
YS
YS
YS
YS
YS
YS
YS
Zl
YS
YS
YS
YS
YS
"}
(29,1,1) = {"
ab
ab
ab
ab
ab
ab
aD
Zl
YS
YS
YS
YS
YS
YS
YS
Zl
YS
YS
YS
YS
YS
YS
Zl
YS
YS
YS
YS
YS
YS
YS
Zl
YS
YS
YS
YS
YS
"}
(30,1,1) = {"
ab
ab
ab
ab
ab
ab
aD
Zl
YS
YS
YS
YS
YS
YS
YS
Zl
YS
YS
YS
YS
YS
YS
Zl
YS
YS
YS
YS
YS
YS
YS
Zl
YS
YS
YS
YS
Ws
"}
(31,1,1) = {"
ab
ab
ab
ab
ab
ab
aD
Zl
YS
YS
YS
YS
YS
YS
YS
Zl
YS
YS
YS
YS
YS
YS
Zl
YS
YS
YS
YS
YS
YS
YS
Zl
YS
YS
YS
YS
Ws
"}
(32,1,1) = {"
ab
ab
ab
ab
ab
ab
aD
jH
jH
jH
jH
jH
jH
jH
Zl
Zl
Zl
Zl
Zl
Zl
Zl
Zl
Zl
Zl
Zl
Zl
Zl
Zl
Zl
Zl
Zl
Zl
Zl
Zl
Zl
lr
"}
(33,1,1) = {"
ab
ab
ab
ab
ab
ab
aD
lr
lr
lr
lr
lr
lr
lr
Ws
Zl
YS
YS
YS
YS
YS
YS
Zl
YS
YS
YS
YS
YS
YS
YS
Zl
YS
YS
YS
YS
lr
"}
(34,1,1) = {"
ab
ab
ab
ab
ab
ab
ab
ab
ab
ab
ab
ab
ab
ab
Ws
Zl
YS
YS
YS
YS
YS
YS
Zl
YS
YS
YS
YS
YS
YS
YS
Zl
YS
YS
YS
YS
lr
"}
(35,1,1) = {"
ab
ab
ab
ab
ab
ab
ab
ab
ab
ab
ab
ab
ab
ab
Ws
Zl
YS
YS
YS
YS
YS
YS
Zl
YS
YS
YS
YS
YS
YS
YS
Zl
YS
YS
YS
YS
lr
"}
(36,1,1) = {"
ab
ab
ab
ab
ab
ab
ab
ab
ab
ab
ab
ab
ab
ab
Ws
Zl
YS
YS
YS
YS
YS
YS
Zl
YS
YS
YS
YS
YS
YS
YS
Zl
YS
YS
YS
YS
Ws
"}
(37,1,1) = {"
ab
ab
ab
ab
ab
ab
ab
ab
ab
ab
ab
ab
ab
ab
Ws
Ws
Ws
Ws
Ws
Ws
Ws
Ws
Ws
lr
Ws
Ws
Ws
Ws
lr
Ws
Ws
Ws
Ws
lr
Ws
Ws
"}
