//MAP CONVERTED BY dmm2tgm.py THIS HEADER COMMENT PREVENTS RECONVERSION, DO NOT REMOVE
"a" = (
/turf/template_noop,
/area/template_noop)
"c" = (
/obj/effect/turf_decal/trimline/blue/filled/line,
/obj/machinery/atmospherics/pipe/smart/manifold4w/scrubbers/hidden/layer2{
	dir = 8
	},
/obj/machinery/atmospherics/pipe/smart/manifold4w/supply/hidden/layer4,
/obj/machinery/power/apc/auto_name/south,
/obj/structure/cable,
/turf/open/floor/plasteel/white,
/area/medical/medbay/zone2)
"d" = (
/obj/machinery/light{
	dir = 1;
	pixel_y = 0
	},
/turf/open/floor/plasteel/monofloor/white,
/area/medical/medbay/zone2)
"e" = (
/obj/machinery/atmospherics/pipe/smart/manifold4w/supply/hidden/layer4,
/obj/machinery/atmospherics/pipe/smart/manifold4w/scrubbers/hidden/layer2{
	dir = 8
	},
/obj/structure/cable,
/turf/open/floor/carpet/blue,
/area/medical/medbay/zone2)
"g" = (
/obj/machinery/atmospherics/components/unary/vent_scrubber/on/layer2{
	dir = 4
	},
/turf/open/floor/plasteel/monofloor/white,
/area/medical/medbay/zone2)
"h" = (
/obj/structure/chair/sofa/right{
	dir = 8
	},
/obj/item/toy/plush/moth,
/turf/open/floor/carpet/blue,
/area/medical/medbay/zone2)
"j" = (
/obj/machinery/light,
/turf/open/floor/carpet/blue,
/area/medical/medbay/zone2)
"k" = (
/obj/effect/turf_decal/trimline/blue/filled/line{
	dir = 6
	},
/turf/open/floor/plasteel/white,
/area/medical/medbay/zone2)
"l" = (
/obj/structure/closet/secure_closet/psychology,
/turf/open/floor/plasteel/monofloor/white,
/area/medical/medbay/zone2)
"m" = (
/obj/machinery/atmospherics/pipe/smart/manifold4w/general/visible,
/turf/open/floor/plasteel/monofloor/white,
/area/medical/medbay/zone2)
"n" = (
/obj/structure/cable,
/obj/machinery/atmospherics/pipe/smart/manifold4w/scrubbers/hidden/layer2{
	dir = 8
	},
/obj/machinery/atmospherics/pipe/smart/manifold4w/supply/hidden/layer4,
/turf/open/floor/plating,
/area/medical/medbay/zone2)
"o" = (
/obj/structure/table/wood,
/obj/item/paper_bin/carbon,
/obj/item/pen,
/obj/item/radio/intercom{
	pixel_y = -35
	},
/turf/open/floor/plasteel/monofloor/white,
/area/medical/medbay/zone2)
"p" = (
/obj/effect/turf_decal/trimline/blue/filled/line{
	dir = 10
	},
/obj/structure/table,
/obj/item/stack/ducts/fifty,
/obj/item/stack/ducts/fifty,
/obj/item/stack/ducts/fifty,
/obj/item/stack/ducts/fifty,
/obj/item/plunger,
/turf/open/floor/plasteel/white,
/area/medical/medbay/zone2)
"q" = (
/obj/effect/turf_decal/trimline/blue/filled/line,
/obj/machinery/atmospherics/pipe/smart/manifold4w/supply/hidden/layer4,
/obj/item/radio/intercom{
	pixel_y = -35
	},
/turf/open/floor/plasteel/white,
/area/medical/medbay/zone2)
"r" = (
/obj/machinery/door/airlock/maintenance{
	dir = 4;
	name = "Medbay Maintenance";
	req_access_txt = "5"
	},
/obj/structure/cable,
/obj/machinery/atmospherics/pipe/smart/manifold4w/scrubbers/hidden/layer2{
	dir = 8
	},
/obj/machinery/atmospherics/pipe/smart/manifold4w/supply/hidden/layer4,
/obj/effect/mapping_helpers/airlock/locked,
/turf/open/floor/plating,
/area/medical/medbay/zone2)
"s" = (
/obj/machinery/atmospherics/pipe/smart/manifold4w/scrubbers/hidden/layer2{
	dir = 8
	},
/turf/open/floor/plasteel/monofloor/white,
/area/medical/medbay/zone2)
"t" = (
/obj/structure/ladder,
/turf/open/floor/plasteel/monofloor/white,
/area/medical/medbay/zone2)
"u" = (
/obj/effect/turf_decal/trimline/blue/filled/line{
	dir = 8
	},
/obj/machinery/atmospherics/components/unary/vent_pump/on/layer4,
/obj/machinery/firealarm{
	dir = 4;
	pixel_x = -24
	},
/turf/open/floor/plasteel/white,
/area/medical/medbay/zone2)
"v" = (
/obj/effect/turf_decal/trimline/blue/filled/line{
	dir = 4
	},
/obj/machinery/atmospherics/pipe/smart/manifold4w/supply/hidden/layer4,
/obj/machinery/atmospherics/pipe/smart/manifold4w/scrubbers/hidden/layer2{
	dir = 8
	},
/obj/structure/cable,
/turf/open/floor/plasteel/monofloor/white,
/area/medical/medbay/zone2)
"w" = (
/obj/effect/turf_decal/trimline/blue/filled/line,
/obj/machinery/atmospherics/pipe/smart/manifold4w/scrubbers/hidden/layer2{
	dir = 8
	},
/obj/machinery/atmospherics/pipe/smart/manifold4w/supply/hidden/layer4,
/obj/structure/cable,
/turf/open/floor/plasteel/white,
/area/medical/medbay/zone2)
"x" = (
/obj/effect/turf_decal/trimline/blue/filled/line,
/obj/machinery/atmospherics/pipe/smart/manifold4w/supply/hidden/layer4,
/obj/machinery/airalarm{
	dir = 1;
	pixel_y = -23
	},
/obj/machinery/light,
/turf/open/floor/plasteel/white,
/area/medical/medbay/zone2)
"z" = (
/obj/machinery/firealarm/directional/east,
/obj/structure/chair/sofa{
	dir = 8
	},
/obj/machinery/camera{
	c_tag = "Psychology";
	dir = 8;
	network = list("ss13","medbay");
	pixel_y = -22
	},
/turf/open/floor/carpet/blue,
/area/medical/medbay/zone2)
"A" = (
/obj/effect/turf_decal/trimline/blue/filled/line{
	dir = 1
	},
/turf/open/floor/plasteel/white,
/area/medical/medbay/zone2)
"C" = (
/turf/open/floor/plasteel/monofloor/white,
/area/medical/medbay/zone2)
"D" = (
/obj/machinery/door/airlock/medical/glass{
	name = "Chemistry Storage";
	req_access_txt = "33"
	},
/turf/open/floor/plasteel/white,
/area/medical/medbay/zone2)
"E" = (
/obj/machinery/atmospherics/pipe/smart/manifold4w/general/visible,
/obj/effect/turf_decal/trimline/blue/filled/line{
	dir = 8
	},
/obj/machinery/light{
	dir = 8
	},
/obj/machinery/requests_console{
	department = "Medbay";
	departmentType = 1;
	name = "Medbay RC";
	pixel_x = -30
	},
/turf/open/floor/plasteel/white,
/area/medical/medbay/zone2)
"F" = (
/turf/closed/wall/r_wall,
/area/medical/medbay/zone2)
"G" = (
/obj/machinery/atmospherics/pipe/smart/manifold4w/scrubbers/hidden/layer2{
	dir = 8
	},
/obj/machinery/atmospherics/pipe/smart/manifold4w/supply/hidden/layer4,
/obj/structure/cable,
/obj/effect/turf_decal/trimline/blue/filled/line{
	dir = 6
	},
/turf/open/floor/plasteel/white,
/area/medical/medbay/zone2)
"I" = (
/obj/machinery/atmospherics/pipe/smart/manifold4w/supply/hidden/layer4,
/obj/machinery/atmospherics/pipe/smart/manifold4w/scrubbers/hidden/layer2{
	dir = 8
	},
/obj/structure/cable,
/obj/structure/bookcase/random/reference,
/turf/open/floor/plating,
/area/medical/medbay/zone2)
"J" = (
/obj/effect/turf_decal/trimline/blue/filled/line{
	dir = 9
	},
/obj/structure/table,
/obj/item/storage/toolbox/mechanical{
	pixel_y = 11
	},
/obj/item/clothing/head/welding,
/obj/item/construction/plumbing{
	pixel_y = -10
	},
/obj/machinery/firealarm{
	dir = 4;
	pixel_x = -24
	},
/turf/open/floor/plasteel/white,
/area/medical/medbay/zone2)
"K" = (
/obj/structure/filingcabinet,
/turf/open/floor/plasteel/monofloor/white,
/area/medical/medbay/zone2)
"L" = (
/obj/machinery/atmospherics/components/unary/cryo_cell,
/obj/effect/turf_decal/trimline/blue/filled/line{
	dir = 1
	},
/turf/open/floor/plasteel/white,
/area/medical/medbay/zone2)
"N" = (
/obj/machinery/atmospherics/components/unary/portables_connector/visible,
/obj/machinery/portable_atmospherics/canister/oxygen,
/obj/effect/turf_decal/trimline/blue/filled/line{
	dir = 9
	},
/obj/structure/sign/warning/nosmoking/circle{
	pixel_x = -32
	},
/turf/open/floor/plasteel/white,
/area/medical/medbay/zone2)
"O" = (
/obj/effect/turf_decal/trimline/blue/filled/line{
	dir = 5
	},
/obj/machinery/light/small{
	dir = 1;
	pixel_y = 0
	},
/obj/structure/sign/departments/chemistry{
	pixel_y = 32
	},
/obj/machinery/airalarm{
	dir = 8;
	pixel_x = 23
	},
/turf/open/floor/plasteel/white,
/area/medical/medbay/zone2)
"P" = (
/obj/effect/turf_decal/trimline/blue/filled/line{
	dir = 5
	},
/obj/machinery/light{
	dir = 4
	},
/turf/open/floor/plasteel/white,
/area/medical/medbay/zone2)
"Q" = (
/turf/open/floor/carpet/blue,
/area/medical/medbay/zone2)
"R" = (
/obj/effect/turf_decal/trimline/blue/filled/line,
/obj/machinery/atmospherics/pipe/smart/manifold4w/supply/hidden/layer4,
/turf/open/floor/plasteel/white,
/area/medical/medbay/zone2)
"S" = (
/obj/structure/table/wood,
/obj/machinery/computer/med_data/laptop{
	dir = 4
	},
/turf/open/floor/plasteel/monofloor/white,
/area/medical/medbay/zone2)
"T" = (
/obj/machinery/atmospherics/components/unary/thermomachine/freezer,
/obj/effect/turf_decal/trimline/blue/filled/line{
	dir = 1
	},
/obj/structure/sign/warning/coldtemp{
	pixel_y = 32
	},
/turf/open/floor/plasteel/white,
/area/medical/medbay/zone2)
"U" = (
/obj/machinery/atmospherics/components/unary/portables_connector/visible,
/obj/machinery/portable_atmospherics/canister/oxygen,
/obj/item/wrench/medical,
/obj/effect/turf_decal/trimline/blue/filled/line{
	dir = 1
	},
/obj/machinery/camera/autoname,
/turf/open/floor/plasteel/white,
/area/medical/medbay/zone2)
"V" = (
/obj/machinery/atmospherics/pipe/smart/manifold4w/supply/hidden/layer4,
/obj/machinery/atmospherics/pipe/smart/manifold4w/scrubbers/hidden/layer2{
	dir = 8
	},
/obj/structure/cable,
/obj/structure/sign/departments/psychology{
	pixel_y = -32
	},
/obj/machinery/door/airlock/medical{
	name = "Psychology";
	req_access_txt = "70"
	},
/obj/machinery/door/firedoor,
/turf/open/floor/plasteel/monofloor/white,
/area/medical/medbay/zone2)
"X" = (
/obj/machinery/airalarm{
	dir = 8;
	pixel_x = 23
	},
/obj/structure/chair/sofa/left{
	dir = 8
	},
/turf/open/floor/carpet/blue,
/area/medical/medbay/zone2)
"Y" = (
/obj/structure/extinguisher_cabinet{
	pixel_x = -5;
	pixel_y = 30
	},
/obj/structure/chair/office/light{
	dir = 8
	},
/obj/effect/landmark/start/psychologist,
/turf/open/floor/plasteel/monofloor/white,
/area/medical/medbay/zone2)
"Z" = (
/obj/structure/table/glass,
/obj/item/reagent_containers/glass/beaker/cryoxadone{
	pixel_x = 7;
	pixel_y = 9
	},
/obj/item/reagent_containers/glass/beaker/cryoxadone{
	pixel_x = 7;
	pixel_y = 1
	},
/obj/item/reagent_containers/glass/beaker/cryoxadone{
	pixel_y = 1
	},
/obj/item/reagent_containers/glass/beaker/cryoxadone{
	pixel_x = -7;
	pixel_y = 1
	},
/obj/item/wrench/medical,
/obj/effect/turf_decal/tile/blue{
	dir = 8
	},
/obj/effect/turf_decal/tile/blue{
	dir = 4
	},
/obj/effect/turf_decal/tile/blue{
	dir = 1
	},
/obj/item/storage/pill_bottle/mannitol{
	pixel_y = 10
	},
/obj/effect/turf_decal/tile/blue,
/obj/machinery/atmospherics/pipe/smart/manifold4w/supply/hidden/layer4,
/turf/open/floor/plasteel/white,
/area/medical/medbay/zone2)

(1,1,1) = {"
a
a
a
a
a
a
a
a
a
a
a
a
a
a
a
a
a
a
a
a
a
a
a
a
a
a
a
a
a
a
a
a
a
a
a
a
a
a
a
a
"}
(2,1,1) = {"
a
a
a
a
a
a
a
a
a
a
a
a
a
a
a
a
a
a
a
a
a
a
a
a
a
a
a
a
a
a
a
a
a
a
a
a
a
a
a
a
"}
(3,1,1) = {"
a
a
a
a
a
a
a
a
a
a
a
a
a
a
a
a
a
a
a
a
a
a
a
a
a
a
a
a
a
a
a
a
a
a
a
a
a
a
a
a
"}
(4,1,1) = {"
a
a
a
a
a
a
a
a
a
a
a
a
a
a
a
a
a
a
a
a
a
a
a
a
a
a
a
a
a
a
a
a
a
a
a
a
a
a
a
a
"}
(5,1,1) = {"
a
a
a
a
a
a
a
a
a
a
a
a
a
a
a
a
a
a
a
a
a
a
a
a
a
a
a
a
a
a
a
a
a
a
a
a
a
a
a
a
"}
(6,1,1) = {"
a
a
a
a
a
a
a
a
a
a
a
a
a
a
a
a
a
a
a
a
a
a
a
a
a
a
a
a
a
a
a
a
a
a
a
a
a
a
a
a
"}
(7,1,1) = {"
a
a
a
a
a
a
a
a
a
a
a
a
a
a
a
a
a
a
a
a
a
a
a
a
a
a
a
a
a
a
a
a
a
a
a
a
a
a
a
a
"}
(8,1,1) = {"
a
a
a
a
a
a
a
a
a
a
a
a
a
a
a
a
a
a
a
a
a
a
a
a
a
a
a
a
a
a
a
a
a
a
a
a
a
a
a
a
"}
(9,1,1) = {"
a
a
a
a
a
a
a
a
a
a
a
a
a
a
a
a
a
a
a
a
a
a
a
a
a
a
a
a
a
a
a
a
a
a
a
a
a
a
a
a
"}
(10,1,1) = {"
a
a
a
a
a
a
a
a
a
a
a
a
a
a
F
F
F
F
F
F
a
a
a
a
a
a
a
a
a
a
a
a
a
a
a
a
a
a
a
a
"}
(11,1,1) = {"
a
a
a
a
a
a
a
a
a
a
a
a
a
a
F
N
E
u
Z
F
a
a
a
a
a
a
a
a
a
a
a
a
a
a
a
a
a
a
a
a
"}
(12,1,1) = {"
a
a
a
a
a
a
a
a
a
a
a
a
a
a
F
U
m
t
q
F
a
a
a
a
a
a
a
a
a
a
a
a
a
a
a
a
a
a
a
a
"}
(13,1,1) = {"
a
a
a
a
a
a
a
a
a
a
a
a
a
a
F
L
m
C
R
F
a
a
a
a
a
a
a
a
a
a
a
a
a
a
a
a
a
a
a
a
"}
(14,1,1) = {"
a
a
a
a
a
a
a
a
a
a
a
F
F
F
F
T
m
g
x
F
a
a
a
a
a
a
a
a
a
a
a
a
a
a
a
a
a
a
a
a
"}
(15,1,1) = {"
a
a
a
a
a
a
a
a
a
a
a
F
J
p
F
L
m
s
c
F
a
a
a
a
a
a
a
a
a
a
a
a
a
a
a
a
a
a
a
a
"}
(16,1,1) = {"
a
a
a
a
a
a
a
a
a
a
a
F
O
k
D
A
C
C
w
F
a
a
a
a
a
a
a
a
a
a
a
a
a
a
a
a
a
a
a
a
"}
(17,1,1) = {"
a
a
a
a
a
a
a
a
a
a
a
F
F
F
F
P
v
v
G
F
a
a
a
a
a
a
a
a
a
a
a
a
a
a
a
a
a
a
a
a
"}
(18,1,1) = {"
a
a
a
a
a
a
a
a
a
a
a
F
S
o
F
F
V
F
F
F
a
a
a
a
a
a
a
a
a
a
a
a
a
a
a
a
a
a
a
a
"}
(19,1,1) = {"
a
a
a
a
a
a
a
a
a
a
a
F
Y
C
Q
Q
e
I
n
F
a
a
a
a
a
a
a
a
a
a
a
a
a
a
a
a
a
a
a
a
"}
(20,1,1) = {"
a
a
a
a
a
a
a
a
a
a
a
F
d
C
Q
Q
j
F
r
F
a
a
a
a
a
a
a
a
a
a
a
a
a
a
a
a
a
a
a
a
"}
(21,1,1) = {"
a
a
a
a
a
a
a
a
a
a
a
F
K
l
h
z
X
F
a
a
a
a
a
a
a
a
a
a
a
a
a
a
a
a
a
a
a
a
a
a
"}
(22,1,1) = {"
a
a
a
a
a
a
a
a
a
a
a
F
F
F
F
F
F
F
a
a
a
a
a
a
a
a
a
a
a
a
a
a
a
a
a
a
a
a
a
a
"}
(23,1,1) = {"
a
a
a
a
a
a
a
a
a
a
a
a
a
a
a
a
a
a
a
a
a
a
a
a
a
a
a
a
a
a
a
a
a
a
a
a
a
a
a
a
"}
(24,1,1) = {"
a
a
a
a
a
a
a
a
a
a
a
a
a
a
a
a
a
a
a
a
a
a
a
a
a
a
a
a
a
a
a
a
a
a
a
a
a
a
a
a
"}
(25,1,1) = {"
a
a
a
a
a
a
a
a
a
a
a
a
a
a
a
a
a
a
a
a
a
a
a
a
a
a
a
a
a
a
a
a
a
a
a
a
a
a
a
a
"}
(26,1,1) = {"
a
a
a
a
a
a
a
a
a
a
a
a
a
a
a
a
a
a
a
a
a
a
a
a
a
a
a
a
a
a
a
a
a
a
a
a
a
a
a
a
"}
(27,1,1) = {"
a
a
a
a
a
a
a
a
a
a
a
a
a
a
a
a
a
a
a
a
a
a
a
a
a
a
a
a
a
a
a
a
a
a
a
a
a
a
a
a
"}
(28,1,1) = {"
a
a
a
a
a
a
a
a
a
a
a
a
a
a
a
a
a
a
a
a
a
a
a
a
a
a
a
a
a
a
a
a
a
a
a
a
a
a
a
a
"}
(29,1,1) = {"
a
a
a
a
a
a
a
a
a
a
a
a
a
a
a
a
a
a
a
a
a
a
a
a
a
a
a
a
a
a
a
a
a
a
a
a
a
a
a
a
"}
(30,1,1) = {"
a
a
a
a
a
a
a
a
a
a
a
a
a
a
a
a
a
a
a
a
a
a
a
a
a
a
a
a
a
a
a
a
a
a
a
a
a
a
a
a
"}
(31,1,1) = {"
a
a
a
a
a
a
a
a
a
a
a
a
a
a
a
a
a
a
a
a
a
a
a
a
a
a
a
a
a
a
a
a
a
a
a
a
a
a
a
a
"}
(32,1,1) = {"
a
a
a
a
a
a
a
a
a
a
a
a
a
a
a
a
a
a
a
a
a
a
a
a
a
a
a
a
a
a
a
a
a
a
a
a
a
a
a
a
"}
