//MAP CONVERTED BY dmm2tgm.py THIS HEADER COMMENT PREVENTS RECONVERSION, DO NOT REMOVE
"at" = (
/obj/machinery/light,
/obj/effect/turf_decal/tile/yellow,
/turf/open/floor/plasteel,
/area/engine/engineering)
"bY" = (
/obj/structure/sign/warning/vacuum/external{
	pixel_x = 32
	},
/obj/structure/fans/tiny,
/obj/machinery/atmospherics/pipe/smart/manifold4w/scrubbers/hidden/layer2,
/turf/open/floor/engine,
/area/engine/engineering)
"cn" = (
/obj/machinery/firealarm{
	dir = 4;
	pixel_x = 24
	},
/obj/effect/turf_decal/tile/yellow,
/turf/open/floor/plasteel,
/area/engine/engineering)
"cx" = (
/turf/closed/wall,
/area/engine/engineering)
"cC" = (
/obj/structure/cable/layer1,
/obj/machinery/atmospherics/pipe/smart/manifold4w/supply/hidden/layer4,
/obj/machinery/atmospherics/pipe/smart/manifold4w/scrubbers/hidden/layer2{
	dir = 8
	},
/obj/machinery/light{
	dir = 1;
	light_color = "#c1caff";
	pixel_y = 0
	},
/obj/effect/turf_decal/tile/yellow{
	dir = 1
	},
/turf/open/floor/plasteel,
/area/engine/engineering)
"dw" = (
/obj/structure/cable/layer1,
/obj/machinery/atmospherics/pipe/smart/manifold4w/supply/hidden/layer4,
/obj/machinery/atmospherics/pipe/smart/manifold4w/scrubbers/hidden/layer2{
	dir = 8
	},
/obj/effect/turf_decal/tile/yellow{
	dir = 4
	},
/turf/open/floor/plasteel,
/area/engine/engineering)
"dO" = (
/obj/machinery/door/firedoor,
/obj/machinery/door/airlock/engineering/glass{
	name = "Supermatter Engine Room";
	req_access_txt = "10"
	},
/turf/open/floor/plasteel,
/area/engine/engineering)
"em" = (
/obj/structure/closet/crate,
/obj/item/stack/sheet/mineral/plasma{
	amount = 50
	},
/obj/item/stack/sheet/mineral/plasma{
	amount = 10
	},
/obj/machinery/light{
	dir = 4
	},
/obj/effect/turf_decal/tile/yellow,
/turf/open/floor/plasteel,
/area/engine/engineering)
"gg" = (
/obj/effect/mapping_helpers/airlock/cyclelink_helper,
/obj/machinery/door/airlock/external{
	name = "Engineering External Access";
	req_access_txt = "10;13"
	},
/obj/machinery/atmospherics/pipe/smart/manifold4w/scrubbers/hidden/layer2,
/turf/open/floor/engine,
/area/engine/engineering)
"gG" = (
/obj/machinery/power/port_gen/pacman,
/obj/structure/cable/layer1,
/obj/machinery/atmospherics/pipe/smart/manifold4w/supply/hidden/layer4,
/obj/machinery/atmospherics/pipe/smart/manifold4w/scrubbers/hidden/layer2{
	dir = 8
	},
/obj/effect/turf_decal/bot,
/turf/open/floor/plasteel,
/area/engine/engineering)
"iA" = (
/obj/structure/closet/radiation,
/obj/effect/turf_decal/tile/yellow{
	dir = 8
	},
/turf/open/floor/plasteel,
/area/engine/engineering)
"ja" = (
/obj/structure/cable/multilayer,
/obj/machinery/atmospherics/pipe/smart/manifold4w/supply/hidden/layer4,
/obj/machinery/atmospherics/pipe/smart/manifold4w/scrubbers/hidden/layer2{
	dir = 8
	},
/turf/open/floor/plasteel,
/area/engine/engineering)
"jl" = (
/obj/structure/cable,
/obj/machinery/atmospherics/components/unary/vent_pump/on/layer4{
	dir = 1
	},
/turf/open/floor/plasteel,
/area/engine/engineering)
"kH" = (
/obj/machinery/light{
	dir = 8
	},
/obj/machinery/atmospherics/components/unary/vent_scrubber/on/layer2{
	dir = 4
	},
/obj/effect/turf_decal/tile/yellow{
	dir = 8
	},
/turf/open/floor/plasteel,
/area/engine/engineering)
"lO" = (
/obj/effect/turf_decal/tile/yellow{
	dir = 4
	},
/turf/open/floor/plasteel,
/area/engine/engineering)
"mt" = (
/obj/structure/table,
/obj/item/clothing/gloves/color/yellow,
/obj/item/storage/toolbox/electrical{
	pixel_y = 5
	},
/turf/open/floor/plasteel,
/area/engine/engineering)
"nb" = (
/obj/machinery/power/port_gen/pacman,
/obj/structure/cable/layer1,
/obj/effect/turf_decal/bot,
/turf/open/floor/plasteel,
/area/engine/engineering)
"nL" = (
/obj/structure/rack,
/obj/item/clothing/mask/gas{
	pixel_x = 3;
	pixel_y = 3
	},
/obj/item/clothing/mask/gas,
/obj/item/clothing/mask/gas{
	pixel_x = -3;
	pixel_y = -3
	},
/obj/effect/turf_decal/tile/yellow{
	dir = 8
	},
/turf/open/floor/plasteel,
/area/engine/engineering)
"pj" = (
/obj/machinery/door/firedoor,
/obj/machinery/door/airlock/engineering/glass{
	name = "Supermatter Engine Room";
	req_access_txt = "10"
	},
/obj/structure/cable/layer1,
/obj/machinery/atmospherics/pipe/smart/manifold4w/supply/hidden/layer4,
/obj/machinery/atmospherics/pipe/smart/manifold4w/scrubbers/hidden/layer2{
	dir = 8
	},
/turf/open/floor/plasteel,
/area/engine/engineering)
"pN" = (
/obj/structure/cable/layer1,
/obj/machinery/atmospherics/pipe/smart/manifold4w/supply/hidden/layer4,
/obj/machinery/atmospherics/pipe/smart/manifold4w/scrubbers/hidden/layer2{
	dir = 8
	},
/obj/effect/turf_decal/tile/yellow{
	dir = 8
	},
/turf/open/floor/plasteel,
/area/engine/engineering)
"rh" = (
/obj/machinery/atmospherics/pipe/smart/manifold4w/scrubbers/hidden/layer2{
	dir = 8
	},
/turf/open/floor/plasteel,
/area/engine/engineering)
"rw" = (
/obj/machinery/atmospherics/components/unary/vent_pump/on/layer4{
	dir = 4
	},
/obj/effect/turf_decal/tile/yellow{
	dir = 8
	},
/turf/open/floor/plasteel,
/area/engine/engineering)
"rD" = (
/obj/machinery/power/terminal{
	dir = 1
	},
/obj/structure/cable/layer1,
/obj/machinery/atmospherics/pipe/smart/manifold4w/supply/hidden/layer4,
/obj/machinery/atmospherics/pipe/smart/manifold4w/scrubbers/hidden/layer2{
	dir = 8
	},
/turf/open/floor/plasteel,
/area/engine/engineering)
"rS" = (
/obj/effect/mapping_helpers/airlock/cyclelink_helper{
	dir = 1
	},
/obj/machinery/door/airlock/external{
	name = "Engineering External Access";
	req_access_txt = "10;13"
	},
/obj/machinery/atmospherics/pipe/smart/manifold4w/scrubbers/hidden/layer2,
/turf/open/floor/engine,
/area/engine/engineering)
"sn" = (
/obj/machinery/atmospherics/components/unary/vent_pump/on/layer4{
	dir = 1
	},
/turf/open/floor/plasteel,
/area/engine/engineering)
"sA" = (
/turf/open/floor/plasteel,
/area/engine/engineering)
"tg" = (
/obj/machinery/atmospherics/components/unary/vent_pump/on/layer4{
	dir = 1
	},
/obj/effect/turf_decal/tile/yellow,
/turf/open/floor/plasteel,
/area/engine/engineering)
"to" = (
/turf/closed/wall/r_wall,
/area/engine/engineering)
"tw" = (
/obj/effect/spawner/structure/window/reinforced,
/turf/open/floor/plating,
/area/engine/engineering)
"tY" = (
/obj/structure/cable,
/obj/machinery/atmospherics/pipe/smart/manifold4w/supply/hidden/layer4{
	dir = 8
	},
/obj/machinery/atmospherics/pipe/smart/manifold4w/scrubbers/hidden/layer2{
	dir = 5
	},
/turf/open/floor/plasteel,
/area/engine/engineering)
"xD" = (
/obj/structure/cable,
/obj/machinery/atmospherics/pipe/smart/manifold4w/supply/hidden/layer4,
/obj/machinery/atmospherics/pipe/smart/manifold4w/scrubbers/hidden/layer2,
/turf/open/floor/plasteel,
/area/engine/engineering)
"yf" = (
/turf/open/floor/plating,
/area/engine/engineering)
"zL" = (
/obj/structure/cable,
/obj/machinery/atmospherics/pipe/smart/manifold4w/supply/hidden/layer4,
/obj/machinery/atmospherics/pipe/smart/manifold4w/scrubbers/hidden/layer2{
	dir = 8
	},
/obj/effect/turf_decal/tile/yellow{
	dir = 1
	},
/turf/open/floor/plasteel,
/area/engine/engineering)
"zS" = (
/obj/effect/spawner/structure/window/plasma/reinforced,
/obj/machinery/atmospherics/pipe/smart/manifold4w/supply/hidden/layer4,
/turf/open/floor/plating,
/area/engine/engineering)
"Be" = (
/obj/machinery/light/small{
	dir = 8
	},
/obj/structure/closet/emcloset/anchored,
/turf/open/floor/engine,
/area/engine/engineering)
"Bw" = (
/obj/structure/sign/warning/vacuum/external{
	pixel_x = -32
	},
/obj/structure/fans/tiny,
/turf/open/floor/engine,
/area/engine/engineering)
"Ck" = (
/obj/machinery/door/firedoor,
/obj/machinery/door/airlock/engineering/glass{
	name = "Supermatter Engine Room";
	req_access_txt = "10"
	},
/obj/structure/cable,
/turf/open/floor/plasteel,
/area/engine/engineering)
"Cz" = (
/obj/structure/cable,
/obj/machinery/atmospherics/pipe/smart/manifold4w/scrubbers/hidden/layer2{
	dir = 8
	},
/obj/machinery/atmospherics/pipe/smart/manifold4w/supply/hidden/layer4{
	dir = 4
	},
/turf/open/floor/plasteel,
/area/engine/engineering)
"CA" = (
/obj/machinery/atmospherics/pipe/smart/manifold4w/scrubbers/hidden/layer2{
	dir = 8
	},
/obj/structure/cable,
/obj/machinery/atmospherics/pipe/smart/manifold4w/supply/hidden/layer4{
	dir = 4
	},
/turf/open/floor/plasteel,
/area/engine/engineering)
"Da" = (
/obj/effect/turf_decal/stripes/line,
/obj/machinery/light{
	pixel_y = 0
	},
/obj/machinery/atmospherics/components/unary/vent_scrubber/on/layer2{
	dir = 1
	},
/turf/open/floor/plasteel,
/area/engine/engineering)
"Dy" = (
/obj/structure/cable/layer1,
/obj/machinery/atmospherics/pipe/smart/manifold4w/supply/hidden/layer4,
/obj/machinery/atmospherics/pipe/smart/manifold4w/scrubbers/hidden/layer2{
	dir = 8
	},
/obj/effect/turf_decal/tile/yellow{
	dir = 1
	},
/turf/open/floor/plasteel,
/area/engine/engineering)
"FQ" = (
/obj/machinery/airalarm{
	pixel_y = 23
	},
/obj/effect/turf_decal/tile/yellow{
	dir = 8
	},
/turf/open/floor/plasteel,
/area/engine/engineering)
"GS" = (
/obj/effect/mapping_helpers/airlock/cyclelink_helper,
/obj/machinery/door/airlock/external{
	name = "Engineering External Access";
	req_access_txt = "10;13"
	},
/turf/open/floor/engine,
/area/engine/engineering)
"Hu" = (
/obj/machinery/atmospherics/pipe/smart/manifold4w/orange/visible/layer1,
/obj/effect/turf_decal/tile/yellow{
	dir = 8
	},
/turf/open/floor/plasteel,
/area/engine/engineering)
"Ie" = (
/obj/structure/sign/poster/official/safety_eye_protection,
/turf/closed/wall/r_wall,
/area/engine/engineering)
"IK" = (
/obj/machinery/atmospherics/pipe/smart/manifold4w/supply/hidden/layer4,
/obj/machinery/atmospherics/pipe/smart/manifold4w/scrubbers/hidden/layer2{
	dir = 8
	},
/obj/machinery/light{
	dir = 1;
	light_color = "#c1caff";
	pixel_y = 0
	},
/obj/effect/turf_decal/tile/yellow{
	dir = 1
	},
/turf/open/floor/plasteel,
/area/engine/engineering)
"Jv" = (
/obj/machinery/door/airlock/engineering/glass{
	name = "Supermatter Engine Room";
	req_access_txt = "10"
	},
/obj/machinery/atmospherics/pipe/smart/manifold4w/scrubbers/hidden/layer2{
	dir = 8
	},
/turf/open/floor/plasteel,
/area/engine/engineering)
"Jz" = (
/obj/effect/mapping_helpers/airlock/cyclelink_helper{
	dir = 1
	},
/obj/machinery/door/airlock/external{
	name = "Engineering External Access";
	req_access_txt = "10;13"
	},
/turf/open/floor/engine,
/area/engine/engineering)
"JQ" = (
/obj/machinery/light{
	dir = 4
	},
/obj/effect/turf_decal/tile/yellow{
	dir = 4
	},
/turf/open/floor/plasteel,
/area/engine/engineering)
"Ka" = (
/obj/machinery/atmospherics/pipe/smart/manifold4w/supply/hidden/layer4,
/obj/machinery/atmospherics/pipe/smart/manifold4w/scrubbers/hidden/layer2{
	dir = 8
	},
/obj/effect/turf_decal/tile/yellow{
	dir = 1
	},
/turf/open/floor/plasteel,
/area/engine/engineering)
"Le" = (
/obj/structure/lattice/catwalk,
/turf/template_noop,
/area/space/nearstation)
"LC" = (
/obj/structure/closet/crate,
/obj/item/stack/sheet/mineral/plasma{
	amount = 50
	},
/obj/item/stack/sheet/mineral/plasma{
	amount = 10
	},
/obj/effect/turf_decal/tile/yellow,
/turf/open/floor/plasteel,
/area/engine/engineering)
"MY" = (
/obj/structure/cable/layer1,
/obj/machinery/atmospherics/pipe/smart/manifold4w/supply/hidden/layer4,
/obj/machinery/atmospherics/pipe/smart/manifold4w/scrubbers/hidden/layer2{
	dir = 8
	},
/turf/open/floor/plasteel,
/area/engine/engineering)
"Ow" = (
/obj/machinery/atmospherics/pipe/smart/manifold4w/supply/hidden/layer4,
/obj/machinery/atmospherics/pipe/smart/manifold4w/scrubbers/hidden/layer2{
	dir = 8
	},
/turf/open/floor/plasteel,
/area/engine/engineering)
"Qr" = (
/obj/structure/table,
/obj/item/storage/toolbox/mechanical{
	pixel_y = 5
	},
/obj/item/flashlight{
	pixel_x = 1;
	pixel_y = 5
	},
/obj/item/flashlight{
	pixel_x = 1;
	pixel_y = 5
	},
/obj/effect/turf_decal/stripes/line,
/turf/open/floor/plasteel,
/area/engine/engineering)
"QX" = (
/obj/structure/cable,
/obj/machinery/atmospherics/components/unary/vent_scrubber/on/layer2{
	dir = 1
	},
/turf/open/floor/plasteel,
/area/engine/engineering)
"Rh" = (
/obj/structure/lattice,
/turf/template_noop,
/area/space/nearstation)
"Rr" = (
/obj/machinery/atmospherics/components/unary/vent_scrubber/on/layer2,
/turf/open/floor/plasteel,
/area/engine/engineering)
"Ry" = (
/obj/machinery/power/terminal{
	dir = 1
	},
/obj/structure/cable/layer1,
/turf/open/floor/plasteel,
/area/engine/engineering)
"RQ" = (
/obj/structure/cable/layer1,
/turf/open/floor/plasteel,
/area/engine/engineering)
"RY" = (
/obj/effect/turf_decal/tile/yellow{
	dir = 8
	},
/turf/open/floor/plasteel,
/area/engine/engineering)
"Sn" = (
/obj/effect/spawner/structure/window/plasma/reinforced,
/turf/open/floor/plating,
/area/engine/engineering)
"Ss" = (
/obj/effect/turf_decal/tile/yellow,
/turf/open/floor/plasteel,
/area/engine/engineering)
"Tz" = (
/obj/structure/sign/warning/radiation/rad_area,
/turf/closed/wall/r_wall,
/area/engine/engineering)
"TL" = (
/obj/machinery/atmospherics/pipe/smart/manifold4w/orange/visible/layer1,
/turf/open/floor/plasteel,
/area/engine/engineering)
"Un" = (
/obj/machinery/atmospherics/pipe/smart/manifold4w/scrubbers/hidden/layer2,
/obj/effect/turf_decal/stripes/line,
/turf/open/floor/plasteel,
/area/engine/engineering)
"UM" = (
/obj/structure/closet/emcloset/anchored,
/obj/machinery/light/small{
	dir = 4
	},
/turf/open/floor/engine,
/area/engine/engineering)
"Vb" = (
/obj/machinery/power/smes{
	capacity = 9e+006;
	charge = 10000
	},
/obj/structure/cable,
/turf/open/floor/plasteel,
/area/engine/engineering)
"Vf" = (
/obj/structure/cable,
/turf/open/floor/plasteel,
/area/engine/engineering)
"Wk" = (
/obj/machinery/atmospherics/components/unary/vent_pump/on/layer4{
	dir = 8
	},
/turf/open/floor/plasteel,
/area/engine/engineering)
"Wu" = (
/obj/machinery/airalarm{
	pixel_y = 23
	},
/turf/open/floor/plasteel,
/area/engine/engineering)
"WU" = (
/obj/structure/cable,
/obj/structure/cable/layer1,
/turf/open/floor/plasteel,
/area/engine/engineering)
"WX" = (
/obj/structure/cable/layer1,
/obj/structure/cable,
/turf/open/floor/plasteel,
/area/engine/engineering)
"XX" = (
/obj/machinery/atmospherics/components/unary/portables_connector/visible{
	icon_state = "connector_map-1";
	piping_layer = 1
	},
/turf/open/floor/plasteel,
/area/engine/engineering)
"YZ" = (
/obj/structure/lattice,
/obj/structure/grille,
/turf/template_noop,
/area/space/nearstation)
"Zg" = (
/obj/machinery/atmospherics/components/unary/vent_scrubber/on/layer2{
	dir = 8
	},
/turf/open/floor/plasteel,
/area/engine/engineering)
"ZF" = (
/obj/machinery/atmospherics/pipe/smart/manifold4w/scrubbers/hidden/layer2{
	dir = 4
	},
/turf/open/floor/plasteel,
/area/engine/engineering)
"ZT" = (
/turf/template_noop,
/area/template_noop)

(1,1,1) = {"
ZT
ZT
ZT
ZT
ZT
ZT
ZT
ZT
ZT
ZT
ZT
ZT
ZT
ZT
ZT
ZT
ZT
ZT
ZT
ZT
ZT
ZT
ZT
ZT
ZT
ZT
"}
(2,1,1) = {"
ZT
ZT
ZT
ZT
ZT
ZT
ZT
yf
tw
ZT
ZT
Rh
ZT
ZT
Rh
ZT
ZT
ZT
YZ
YZ
YZ
ZT
ZT
ZT
ZT
ZT
"}
(3,1,1) = {"
ZT
ZT
ZT
ZT
ZT
ZT
ZT
tw
tw
Rh
Rh
Rh
Rh
Rh
Rh
Rh
Rh
Rh
YZ
ZT
YZ
ZT
ZT
ZT
ZT
ZT
"}
(4,1,1) = {"
ZT
ZT
ZT
ZT
ZT
ZT
ZT
Le
Rh
Le
Le
Rh
Le
Le
Rh
Le
Le
Le
YZ
ZT
YZ
ZT
ZT
ZT
ZT
ZT
"}
(5,1,1) = {"
ZT
ZT
ZT
ZT
ZT
ZT
ZT
Rh
Rh
Rh
Rh
Rh
Rh
Rh
Rh
Rh
Rh
Rh
YZ
ZT
YZ
ZT
ZT
ZT
ZT
ZT
"}
(6,1,1) = {"
ZT
ZT
ZT
ZT
ZT
ZT
ZT
Le
Rh
Le
Le
Rh
Le
Le
Rh
Le
Le
Le
YZ
ZT
YZ
ZT
ZT
ZT
ZT
ZT
"}
(7,1,1) = {"
ZT
ZT
ZT
ZT
cx
cx
to
Rh
Rh
Rh
Rh
Rh
Rh
Rh
Rh
Rh
Rh
Rh
YZ
ZT
YZ
ZT
ZT
ZT
ZT
ZT
"}
(8,1,1) = {"
ZT
ZT
mt
Qr
cx
Be
to
Le
Rh
Le
Le
Rh
Le
Le
Rh
Le
Le
Le
YZ
ZT
YZ
ZT
ZT
ZT
ZT
ZT
"}
(9,1,1) = {"
ZT
ZT
rh
Un
gg
bY
rS
Rh
Rh
Rh
Rh
Rh
Rh
Rh
Rh
Rh
Rh
Rh
YZ
YZ
YZ
Rh
ZT
ZT
ZT
ZT
"}
(10,1,1) = {"
ZT
sA
ZF
Da
Tz
to
to
to
to
to
Sn
Sn
Sn
ZT
Rh
ZT
Rh
ZT
ZT
Rh
ZT
ZT
ZT
ZT
ZT
ZT
"}
(11,1,1) = {"
Sn
Sn
Jv
to
to
FQ
RY
kH
rw
RY
RY
RY
to
to
Rh
Rh
Rh
Rh
YZ
YZ
YZ
ZT
ZT
ZT
ZT
ZT
"}
(12,1,1) = {"
Ie
Ka
Ka
Ka
Ka
Ow
Ow
Ow
Ow
Ow
Ow
Ow
Ss
to
Rh
ZT
Rh
ZT
YZ
ZT
YZ
ZT
ZT
ZT
ZT
ZT
"}
(13,1,1) = {"
Sn
Ka
Vb
Ry
Vb
Ry
Vb
Ry
Vb
Ry
Vb
rD
Ss
Sn
Rh
ZT
Rh
ZT
YZ
ZT
YZ
ZT
ZT
ZT
ZT
ZT
"}
(14,1,1) = {"
Sn
Ka
Vb
Ry
Vb
Ry
Vb
Ry
Vb
Ry
Vb
rD
Ss
Sn
Rh
Rh
Rh
Rh
YZ
ZT
YZ
Rh
ZT
ZT
ZT
ZT
"}
(15,1,1) = {"
to
IK
Vb
Ry
Vb
Ry
Vb
Ry
Vb
Ry
Vb
rD
Ss
Sn
Rh
ZT
Rh
ZT
YZ
ZT
YZ
ZT
ZT
ZT
ZT
ZT
"}
(16,1,1) = {"
to
Ka
Vf
nb
Vf
nb
Vf
nb
Vf
nb
Vf
gG
at
to
Rh
Rh
Rh
Rh
YZ
ZT
YZ
ZT
ZT
ZT
ZT
ZT
"}
(17,1,1) = {"
Ck
zL
jl
RQ
Vf
RQ
Vf
RQ
Vf
RQ
Vf
MY
Ss
Sn
Rh
ZT
Rh
ZT
YZ
ZT
YZ
ZT
ZT
ZT
ZT
ZT
"}
(18,1,1) = {"
Sn
Dy
WU
WX
WU
WX
WU
WX
WU
WX
WU
MY
tg
Sn
Rh
ZT
Rh
ZT
YZ
ZT
YZ
ZT
ZT
ZT
ZT
ZT
"}
(19,1,1) = {"
dO
Dy
QX
RQ
Vf
RQ
Vf
RQ
Vf
RQ
Vf
MY
Ss
Sn
Rh
Rh
Rh
Rh
YZ
ZT
YZ
ZT
ZT
ZT
ZT
ZT
"}
(20,1,1) = {"
to
Dy
Vf
nb
Vf
nb
Vf
nb
Vf
nb
Vf
gG
at
to
Rh
Rh
Rh
Rh
YZ
ZT
YZ
ZT
ZT
ZT
ZT
ZT
"}
(21,1,1) = {"
to
cC
Vb
Ry
Vb
Ry
Vb
Ry
Vb
Ry
Vb
rD
Ss
Sn
Rh
ZT
Rh
ZT
YZ
ZT
YZ
ZT
ZT
ZT
ZT
ZT
"}
(22,1,1) = {"
zS
Dy
Vb
Ry
Vb
Ry
Vb
Ry
Vb
Ry
Vb
rD
Ss
Sn
Rh
Rh
Rh
Rh
YZ
ZT
YZ
Rh
ZT
ZT
ZT
ZT
"}
(23,1,1) = {"
Sn
Dy
Vb
Ry
Vb
Ry
Vb
Ry
Vb
Ry
Vb
rD
Ss
Sn
Rh
Rh
Rh
Rh
YZ
ZT
YZ
ZT
ZT
ZT
ZT
ZT
"}
(24,1,1) = {"
Ie
Dy
MY
Ow
Ow
Ow
Ow
Ow
Ow
Ow
Ow
Ow
at
to
Rh
Rh
Rh
Rh
YZ
ZT
YZ
ZT
ZT
ZT
ZT
ZT
"}
(25,1,1) = {"
Sn
Sn
dw
lO
JQ
lO
sA
Wk
Zg
sA
sA
sA
Ss
Sn
Rh
ZT
Rh
ZT
YZ
YZ
YZ
ZT
ZT
ZT
ZT
ZT
"}
(26,1,1) = {"
iA
Sn
pj
Sn
to
to
Wu
sA
sA
sA
sA
sA
Ss
Sn
Rh
ZT
Rh
ZT
ZT
Rh
ZT
ZT
ZT
ZT
ZT
ZT
"}
(27,1,1) = {"
sA
RY
pN
RY
nL
Sn
sA
sA
sA
sA
sA
sA
Ss
Sn
Rh
ZT
Rh
Rh
Rh
Rh
Rh
Rh
ZT
ZT
ZT
ZT
"}
(28,1,1) = {"
sA
Rr
MY
sn
RY
dO
cn
Ss
em
LC
LC
LC
LC
to
Rh
ZT
Rh
ZT
Rh
ZT
YZ
ZT
ZT
ZT
ZT
ZT
"}
(29,1,1) = {"
sA
sA
ja
XX
Hu
to
to
to
to
to
Sn
Sn
Sn
to
Rh
Rh
Rh
Rh
Rh
ZT
YZ
ZT
ZT
ZT
ZT
ZT
"}
(30,1,1) = {"
ZT
xD
tY
sA
TL
RY
GS
Bw
Jz
Rh
Rh
Rh
ZT
ZT
ZT
ZT
ZT
ZT
ZT
ZT
ZT
ZT
ZT
ZT
ZT
ZT
"}
(31,1,1) = {"
ZT
sA
Cz
sA
TL
RY
to
UM
to
Rh
Rh
ZT
ZT
ZT
ZT
ZT
ZT
ZT
ZT
ZT
ZT
ZT
ZT
ZT
ZT
ZT
"}
(32,1,1) = {"
ZT
sA
CA
sA
Hu
cx
to
to
to
Rh
ZT
ZT
ZT
ZT
ZT
ZT
ZT
ZT
ZT
ZT
ZT
ZT
ZT
ZT
ZT
ZT
"}
