//MAP CONVERTED BY dmm2tgm.py THIS HEADER COMMENT PREVENTS RECONVERSION, DO NOT REMOVE
"ay" = (
/obj/machinery/portable_atmospherics/canister/carbon_dioxide,
/obj/effect/turf_decal/box/white,
/turf/open/floor/plasteel/dark,
/area/engine/engineering)
"bb" = (
/obj/machinery/atmospherics/components/unary/vent_scrubber/on/layer2{
	dir = 1
	},
/turf/open/floor/plasteel,
/area/engine/engineering)
"bM" = (
/obj/machinery/atmospherics/components/binary/pump{
	dir = 8
	},
/turf/open/floor/engine,
/area/engine/engineering)
"bX" = (
/obj/structure/table,
/obj/item/pipe_dispenser{
	pixel_y = 6
	},
/obj/item/pipe_dispenser,
/obj/item/pipe_dispenser{
	pixel_y = -6
	},
/turf/open/floor/plasteel/dark,
/area/engine/engineering)
"ch" = (
/obj/machinery/atmospherics/pipe/smart/manifold4w/yellow/visible{
	dir = 4
	},
/obj/effect/turf_decal/stripes/line{
	dir = 1
	},
/obj/structure/cable,
/turf/open/floor/plasteel/dark,
/area/engine/engineering)
"ct" = (
/obj/machinery/door/firedoor,
/obj/machinery/door/airlock/engineering/glass{
	name = "Supermatter Engine Room";
	req_access_txt = "10"
	},
/obj/machinery/atmospherics/pipe/smart/manifold4w/supply/hidden/layer4{
	dir = 4
	},
/obj/machinery/atmospherics/pipe/smart/manifold4w/scrubbers/hidden/layer2{
	dir = 4
	},
/obj/effect/turf_decal/stripes/end{
	dir = 4
	},
/obj/machinery/atmospherics/pipe/smart/manifold4w/orange/visible/layer1,
/turf/open/floor/plasteel/dark,
/area/engine/engineering)
"cJ" = (
/obj/machinery/atmospherics/components/unary/vent_pump/on/layer4{
	dir = 1
	},
/obj/machinery/atmospherics/pipe/smart/manifold4w/yellow/visible{
	dir = 4
	},
/turf/open/floor/plasteel/dark,
/area/engine/engineering)
"di" = (
/obj/machinery/atmospherics/components/binary/circulator/flipped{
	dir = 8
	},
/turf/open/floor/engine,
/area/engine/engineering)
"dL" = (
/obj/machinery/atmospherics/pipe/smart/manifold4w/supply/hidden/layer4{
	dir = 4
	},
/obj/machinery/atmospherics/pipe/smart/manifold4w/scrubbers/hidden/layer2{
	dir = 4
	},
/obj/effect/turf_decal/stripes/line,
/obj/effect/turf_decal/tile/yellow{
	dir = 4
	},
/obj/machinery/light{
	dir = 1;
	light_color = "#c1caff";
	pixel_y = 0
	},
/turf/open/floor/plasteel/dark,
/area/engine/engineering)
"dM" = (
/obj/machinery/atmospherics/pipe/smart/manifold4w/supply/hidden/layer4{
	dir = 4
	},
/obj/machinery/atmospherics/pipe/smart/manifold4w/scrubbers/hidden/layer2{
	dir = 4
	},
/obj/effect/turf_decal/stripes/corner{
	dir = 8
	},
/obj/effect/turf_decal/tile/yellow{
	dir = 4
	},
/turf/open/floor/plasteel/dark,
/area/engine/engineering)
"et" = (
/obj/effect/turf_decal/stripes/line{
	dir = 4
	},
/turf/open/floor/plasteel/dark,
/area/engine/engineering)
"fK" = (
/obj/machinery/atmospherics/pipe/smart/manifold4w/violet/visible,
/turf/open/floor/engine,
/area/engine/engineering)
"fM" = (
/turf/template_noop,
/area/template_noop)
"gO" = (
/obj/machinery/atmospherics/components/unary/thermomachine/freezer{
	dir = 4
	},
/obj/effect/turf_decal/bot,
/obj/effect/turf_decal/tile/yellow{
	dir = 8
	},
/obj/machinery/firealarm{
	dir = 4;
	pixel_x = -24
	},
/turf/open/floor/plasteel/dark,
/area/engine/engineering)
"gU" = (
/obj/machinery/atmospherics/pipe/smart/manifold4w/violet/visible,
/obj/effect/turf_decal/stripes/line{
	dir = 4
	},
/turf/open/floor/plasteel/dark,
/area/engine/engineering)
"hj" = (
/obj/machinery/atmospherics/pipe/smart/manifold4w/yellow/visible{
	dir = 4
	},
/obj/effect/turf_decal/stripes/corner{
	dir = 1
	},
/obj/effect/turf_decal/tile/yellow,
/turf/open/floor/plasteel/dark,
/area/engine/engineering)
"hq" = (
/obj/machinery/atmospherics/pipe/smart/manifold4w/violet/visible,
/obj/effect/turf_decal/tile/yellow{
	dir = 8
	},
/obj/machinery/light{
	pixel_y = 0
	},
/turf/open/floor/plasteel/dark,
/area/engine/engineering)
"ii" = (
/obj/effect/turf_decal/tile/yellow{
	dir = 1
	},
/turf/open/floor/plasteel/dark,
/area/engine/engineering)
"in" = (
/obj/machinery/atmospherics/pipe/smart/manifold4w/yellow/visible{
	dir = 4
	},
/turf/open/floor/engine,
/area/engine/engineering)
"iD" = (
/obj/machinery/atmospherics/pipe/layer_manifold/visible,
/turf/open/floor/plasteel/dark,
/area/engine/engineering)
"iK" = (
/obj/structure/table,
/obj/item/stack/sheet/metal/fifty{
	pixel_x = 2;
	pixel_y = 2
	},
/turf/open/floor/plasteel/dark,
/area/engine/engineering)
"jh" = (
/obj/machinery/atmospherics/pipe/smart/manifold4w/supply/hidden/layer4{
	dir = 4
	},
/obj/machinery/atmospherics/pipe/smart/manifold4w/scrubbers/hidden/layer2{
	dir = 4
	},
/obj/effect/turf_decal/tile/yellow{
	dir = 4
	},
/turf/open/floor/plasteel/dark,
/area/engine/engineering)
"jr" = (
/obj/machinery/atmospherics/pipe/smart/manifold4w/violet/visible,
/obj/effect/turf_decal/tile/yellow{
	dir = 8
	},
/turf/open/floor/plasteel/dark,
/area/engine/engineering)
"jV" = (
/obj/machinery/atmospherics/pipe/smart/manifold4w/violet/visible,
/obj/effect/turf_decal/stripes/line{
	dir = 1
	},
/obj/structure/cable,
/turf/open/floor/plasteel/dark,
/area/engine/engineering)
"kb" = (
/obj/machinery/atmospherics/pipe/smart/manifold4w/violet/visible,
/turf/open/floor/plasteel/dark,
/area/engine/engineering)
"kj" = (
/obj/machinery/atmospherics/pipe/smart/manifold4w/yellow/visible{
	dir = 4
	},
/obj/structure/cable,
/turf/open/floor/plasteel/dark,
/area/engine/engineering)
"kr" = (
/obj/effect/turf_decal/stripes/line{
	dir = 8
	},
/turf/open/floor/plasteel/dark,
/area/engine/engineering)
"lh" = (
/obj/structure/cable,
/obj/machinery/atmospherics/pipe/smart/manifold4w/supply/hidden/layer4,
/obj/machinery/atmospherics/pipe/smart/manifold4w/scrubbers/hidden/layer2,
/turf/open/floor/plasteel,
/area/engine/engineering)
"lt" = (
/obj/machinery/atmospherics/pipe/smart/manifold4w/scrubbers/hidden/layer2{
	dir = 4
	},
/obj/effect/turf_decal/tile/yellow{
	dir = 8
	},
/turf/open/floor/plasteel/dark,
/area/engine/engineering)
"lS" = (
/turf/closed/wall/r_wall,
/area/engine/engineering)
"my" = (
/obj/effect/turf_decal/stripes/line{
	dir = 8
	},
/obj/structure/cable,
/turf/open/floor/plasteel/dark,
/area/engine/engineering)
"no" = (
/obj/structure/table,
/obj/item/stack/sheet/plasteel/twenty,
/turf/open/floor/plasteel/dark,
/area/engine/engineering)
"nR" = (
/obj/structure/lattice,
/turf/template_noop,
/area/space/nearstation)
"oz" = (
/obj/machinery/atmospherics/components/binary/pump{
	dir = 4
	},
/obj/effect/turf_decal/stripes/line{
	dir = 1
	},
/obj/structure/cable,
/turf/open/floor/plasteel/dark,
/area/engine/engineering)
"pB" = (
/obj/machinery/atmospherics/pipe/smart/manifold4w/supply/hidden/layer4{
	dir = 4
	},
/obj/machinery/atmospherics/pipe/smart/manifold4w/scrubbers/hidden/layer2{
	dir = 4
	},
/obj/effect/turf_decal/stripes/line,
/obj/effect/turf_decal/tile/yellow{
	dir = 1
	},
/turf/open/floor/plasteel/dark,
/area/engine/engineering)
"pN" = (
/obj/structure/table,
/obj/item/storage/toolbox/mechanical{
	pixel_y = 5
	},
/obj/item/flashlight{
	pixel_x = 1;
	pixel_y = 5
	},
/obj/item/flashlight{
	pixel_x = 1;
	pixel_y = 5
	},
/turf/open/floor/plasteel,
/area/engine/engineering)
"rj" = (
/obj/machinery/atmospherics/components/binary/pump,
/turf/open/floor/plasteel/dark,
/area/engine/engineering)
"rB" = (
/obj/machinery/space_heater,
/obj/effect/turf_decal/tile/yellow,
/obj/effect/turf_decal/box/white,
/turf/open/floor/plasteel/dark,
/area/engine/engineering)
"sI" = (
/obj/machinery/atmospherics/pipe/smart/manifold4w/supply/hidden/layer4{
	dir = 4
	},
/obj/machinery/atmospherics/pipe/smart/manifold4w/scrubbers/hidden/layer2{
	dir = 4
	},
/obj/effect/turf_decal/stripes/line,
/obj/effect/turf_decal/tile/yellow{
	dir = 1
	},
/obj/effect/turf_decal/tile/yellow{
	dir = 4
	},
/obj/structure/cable,
/turf/open/floor/plasteel/dark,
/area/engine/engineering)
"tD" = (
/obj/structure/closet/secure_closet/engineering_electrical,
/obj/effect/turf_decal/box/white,
/turf/open/floor/plasteel/dark,
/area/engine/engineering)
"tX" = (
/obj/machinery/portable_atmospherics/pump,
/obj/effect/turf_decal/tile/yellow{
	dir = 8
	},
/obj/effect/turf_decal/box/white,
/turf/open/floor/plasteel/dark,
/area/engine/engineering)
"uT" = (
/obj/machinery/atmospherics/components/unary/thermomachine/freezer{
	dir = 4
	},
/obj/effect/turf_decal/bot,
/obj/effect/turf_decal/tile/yellow{
	dir = 8
	},
/turf/open/floor/plasteel/dark,
/area/engine/engineering)
"vh" = (
/obj/structure/rack,
/obj/item/clothing/mask/gas{
	pixel_x = 3;
	pixel_y = 3
	},
/obj/item/clothing/mask/gas,
/obj/item/clothing/mask/gas{
	pixel_x = -3;
	pixel_y = -3
	},
/turf/open/floor/plasteel,
/area/engine/engineering)
"xj" = (
/obj/machinery/airalarm{
	pixel_y = 23
	},
/turf/open/floor/plasteel/dark,
/area/engine/engineering)
"xr" = (
/obj/machinery/atmospherics/pipe/smart/manifold4w/violet/visible,
/obj/effect/turf_decal/stripes/line{
	dir = 1
	},
/obj/machinery/light{
	pixel_y = 0
	},
/obj/structure/cable,
/turf/open/floor/plasteel/dark,
/area/engine/engineering)
"xv" = (
/obj/machinery/light/small{
	dir = 8
	},
/obj/structure/sign/warning/vacuum/external{
	pixel_x = 32
	},
/turf/open/floor/plating,
/area/engine/engineering)
"xX" = (
/obj/machinery/atmospherics/pipe/smart/manifold4w/scrubbers/hidden/layer2{
	dir = 4
	},
/obj/machinery/atmospherics/pipe/smart/manifold4w/violet/visible,
/turf/open/floor/plasteel/dark,
/area/engine/engineering)
"yh" = (
/obj/structure/table,
/obj/item/storage/toolbox/mechanical{
	pixel_x = -1;
	pixel_y = 4
	},
/turf/open/floor/plasteel/dark,
/area/engine/engineering)
"yq" = (
/obj/machinery/atmospherics/components/unary/thermomachine/heater{
	dir = 8
	},
/obj/effect/turf_decal/bot,
/obj/effect/turf_decal/tile/yellow,
/turf/open/floor/plasteel/dark,
/area/engine/engineering)
"yQ" = (
/obj/structure/cable,
/turf/open/floor/engine,
/area/engine/engineering)
"zf" = (
/obj/machinery/door/firedoor,
/obj/machinery/door/airlock/engineering/glass{
	name = "Supermatter Engine Room";
	req_access_txt = "10"
	},
/obj/machinery/atmospherics/pipe/smart/manifold4w/scrubbers/hidden/layer2{
	dir = 4
	},
/obj/effect/turf_decal/stripes/end{
	dir = 8
	},
/turf/open/floor/plasteel/dark,
/area/engine/engineering)
"zP" = (
/obj/machinery/atmospherics/pipe/smart/manifold4w/scrubbers/hidden/layer2{
	dir = 4
	},
/obj/machinery/atmospherics/pipe/smart/manifold4w/supply/hidden/layer4{
	dir = 4
	},
/obj/machinery/atmospherics/pipe/smart/manifold4w/orange/visible/layer1,
/obj/effect/turf_decal/tile/yellow{
	dir = 4
	},
/obj/structure/cable,
/turf/open/floor/plasteel/dark,
/area/engine/engineering)
"Ab" = (
/obj/machinery/atmospherics/pipe/smart/manifold4w/orange/visible/layer1,
/turf/open/floor/plasteel,
/area/engine/engineering)
"AB" = (
/obj/machinery/door/firedoor,
/obj/machinery/door/airlock/engineering/glass{
	name = "Supermatter Engine Room";
	req_access_txt = "10"
	},
/obj/structure/cable,
/turf/open/floor/plasteel/dark,
/area/engine/engineering)
"AK" = (
/turf/open/floor/plasteel,
/area/engine/engineering)
"Bv" = (
/obj/structure/closet/radiation,
/turf/open/floor/plasteel,
/area/engine/engineering)
"Cl" = (
/obj/structure/table,
/obj/item/stack/sheet/metal/fifty{
	pixel_x = -5;
	pixel_y = 2
	},
/turf/open/floor/plasteel/dark,
/area/engine/engineering)
"CR" = (
/obj/machinery/atmospherics/pipe/smart/manifold4w/violet/visible,
/obj/machinery/atmospherics/pipe/smart/manifold4w/scrubbers/hidden/layer2{
	dir = 4
	},
/turf/open/floor/plasteel/dark,
/area/engine/engineering)
"Da" = (
/obj/structure/cable,
/turf/open/floor/plasteel/dark,
/area/engine/engineering)
"Dd" = (
/obj/effect/mapping_helpers/airlock/cyclelink_helper,
/obj/machinery/door/airlock/external{
	name = "Engineering External Access";
	req_access_txt = "10;13"
	},
/turf/open/floor/plating,
/area/engine/engineering)
"Dk" = (
/obj/structure/cable,
/obj/machinery/atmospherics/pipe/smart/manifold4w/supply/hidden/layer4{
	dir = 1
	},
/obj/machinery/atmospherics/pipe/smart/manifold4w/scrubbers/hidden/layer2{
	dir = 1
	},
/obj/machinery/atmospherics/pipe/smart/manifold4w/orange/visible/layer1,
/turf/open/floor/plasteel,
/area/engine/engineering)
"EH" = (
/obj/structure/cable,
/obj/machinery/atmospherics/pipe/smart/manifold4w/supply/hidden/layer4{
	dir = 4
	},
/obj/machinery/atmospherics/pipe/smart/manifold4w/scrubbers/hidden/layer2{
	dir = 8
	},
/turf/open/floor/plasteel,
/area/engine/engineering)
"EI" = (
/obj/machinery/atmospherics/pipe/smart/manifold4w/yellow/visible{
	dir = 4
	},
/obj/effect/turf_decal/stripes/line{
	dir = 8
	},
/turf/open/floor/plasteel/dark,
/area/engine/engineering)
"Fo" = (
/obj/effect/spawner/structure/window/plasma/reinforced,
/turf/open/floor/plating,
/area/engine/engineering)
"Gb" = (
/obj/machinery/atmospherics/components/binary/circulator/cold{
	dir = 4
	},
/turf/open/floor/engine,
/area/engine/engineering)
"Go" = (
/turf/open/floor/engine,
/area/engine/engineering)
"GD" = (
/obj/machinery/atmospherics/pipe/smart/manifold4w/yellow/visible{
	dir = 4
	},
/obj/effect/turf_decal/stripes/line{
	dir = 1
	},
/obj/machinery/light{
	pixel_y = 0
	},
/obj/structure/cable,
/turf/open/floor/plasteel/dark,
/area/engine/engineering)
"Ho" = (
/obj/effect/turf_decal/stripes/corner,
/obj/effect/turf_decal/tile/yellow{
	dir = 4
	},
/turf/open/floor/plasteel/dark,
/area/engine/engineering)
"HD" = (
/obj/machinery/atmospherics/components/unary/thermomachine/freezer{
	dir = 4
	},
/obj/effect/turf_decal/bot,
/obj/effect/turf_decal/tile/yellow{
	dir = 8
	},
/obj/machinery/light{
	dir = 8
	},
/turf/open/floor/plasteel/dark,
/area/engine/engineering)
"HX" = (
/obj/machinery/atmospherics/pipe/smart/manifold4w/orange/visible/layer1,
/obj/effect/turf_decal/tile/yellow{
	dir = 4
	},
/obj/structure/cable,
/turf/open/floor/plasteel/dark,
/area/engine/engineering)
"Ic" = (
/obj/machinery/atmospherics/pipe/smart/manifold4w/violet/visible,
/obj/effect/turf_decal/stripes/corner{
	dir = 4
	},
/obj/effect/turf_decal/tile/yellow{
	dir = 8
	},
/turf/open/floor/plasteel/dark,
/area/engine/engineering)
"Ix" = (
/obj/structure/lattice/catwalk,
/turf/template_noop,
/area/space/nearstation)
"Jg" = (
/turf/open/floor/plasteel/dark,
/area/engine/engineering)
"KX" = (
/obj/machinery/atmospherics/components/unary/portables_connector/visible{
	dir = 8
	},
/obj/effect/turf_decal/box,
/obj/machinery/portable_atmospherics/canister/tier_2,
/obj/effect/turf_decal/tile/yellow,
/turf/open/floor/plasteel/dark,
/area/engine/engineering)
"LM" = (
/obj/machinery/atmospherics/components/binary/pump{
	dir = 1
	},
/turf/open/floor/engine,
/area/engine/engineering)
"Mi" = (
/obj/machinery/atmospherics/pipe/smart/manifold4w/yellow/visible{
	dir = 4
	},
/obj/effect/turf_decal/tile/yellow,
/obj/machinery/light{
	pixel_y = 0
	},
/turf/open/floor/plasteel/dark,
/area/engine/engineering)
"My" = (
/obj/machinery/atmospherics/pipe/smart/manifold4w/yellow/visible{
	dir = 4
	},
/obj/machinery/atmospherics/pipe/smart/manifold4w/orange/visible/layer1,
/turf/open/floor/plasteel/dark,
/area/engine/engineering)
"Ns" = (
/obj/structure/table,
/obj/item/stack/sheet/glass/fifty,
/turf/open/floor/plasteel/dark,
/area/engine/engineering)
"ON" = (
/obj/machinery/portable_atmospherics/scrubber,
/obj/effect/turf_decal/box/white,
/turf/open/floor/plasteel/dark,
/area/engine/engineering)
"OY" = (
/turf/closed/wall/r_wall,
/area/space/nearstation)
"Px" = (
/obj/machinery/atmospherics/pipe/smart/manifold4w/orange/visible/layer1,
/obj/machinery/light,
/turf/open/floor/plasteel,
/area/engine/engineering)
"PF" = (
/obj/structure/table,
/obj/item/clothing/gloves/color/yellow,
/obj/item/storage/toolbox/electrical{
	pixel_y = 5
	},
/turf/open/floor/plasteel,
/area/engine/engineering)
"PG" = (
/obj/structure/cable,
/obj/machinery/atmospherics/components/binary/pump{
	dir = 4
	},
/turf/open/floor/engine,
/area/engine/engineering)
"PP" = (
/obj/machinery/power/generator,
/obj/structure/cable,
/turf/open/floor/engine,
/area/engine/engineering)
"Rv" = (
/obj/machinery/power/floodlight{
	anchored = 1
	},
/obj/structure/cable,
/turf/open/floor/engine,
/area/engine/engineering)
"Sc" = (
/obj/effect/turf_decal/stripes/line,
/obj/effect/turf_decal/tile/yellow{
	dir = 1
	},
/obj/effect/turf_decal/tile/yellow{
	dir = 4
	},
/obj/structure/cable,
/turf/open/floor/plasteel/dark,
/area/engine/engineering)
"Ty" = (
/obj/machinery/atmospherics/pipe/smart/manifold4w/orange/visible/layer1,
/obj/structure/cable,
/turf/open/floor/plasteel/dark,
/area/engine/engineering)
"TE" = (
/obj/structure/cable,
/obj/machinery/power/generator,
/turf/open/floor/engine,
/area/engine/engineering)
"TN" = (
/obj/machinery/atmospherics/components/unary/portables_connector/visible{
	dir = 4
	},
/obj/effect/turf_decal/box,
/turf/open/floor/plasteel/dark,
/area/engine/engineering)
"Uu" = (
/obj/machinery/atmospherics/components/unary/vent_scrubber/on/layer2{
	dir = 1
	},
/turf/open/floor/plasteel/dark,
/area/engine/engineering)
"UK" = (
/obj/machinery/atmospherics/components/unary/portables_connector/visible{
	dir = 4
	},
/obj/effect/turf_decal/box,
/obj/machinery/portable_atmospherics/canister/tier_2,
/obj/effect/turf_decal/tile/yellow{
	dir = 8
	},
/turf/open/floor/plasteel/dark,
/area/engine/engineering)
"Vo" = (
/obj/machinery/atmospherics/pipe/smart/manifold4w/scrubbers/hidden/layer2{
	dir = 4
	},
/obj/machinery/atmospherics/pipe/smart/manifold4w/supply/hidden/layer4{
	dir = 4
	},
/obj/machinery/atmospherics/pipe/smart/manifold4w/yellow/visible{
	dir = 4
	},
/turf/open/floor/plasteel/dark,
/area/engine/engineering)
"VD" = (
/turf/closed/wall,
/area/engine/engineering)
"Wb" = (
/obj/machinery/door/firedoor,
/obj/machinery/door/airlock/engineering/glass{
	name = "Supermatter Engine Room";
	req_access_txt = "10"
	},
/obj/machinery/atmospherics/pipe/smart/manifold4w/scrubbers/hidden/layer2,
/obj/machinery/atmospherics/pipe/smart/manifold4w/supply/hidden/layer4,
/turf/open/floor/plasteel/dark,
/area/engine/engineering)
"Wk" = (
/obj/structure/cable,
/obj/machinery/atmospherics/pipe/smart/manifold4w/supply/hidden/layer4,
/obj/machinery/atmospherics/pipe/smart/manifold4w/scrubbers/hidden/layer2,
/obj/machinery/atmospherics/pipe/smart/manifold4w/orange/visible/layer1,
/turf/open/floor/plasteel,
/area/engine/engineering)
"Wp" = (
/obj/structure/lattice,
/obj/structure/grille,
/turf/template_noop,
/area/space/nearstation)
"WN" = (
/obj/machinery/atmospherics/pipe/smart/manifold4w/yellow/visible{
	dir = 4
	},
/turf/open/floor/plasteel/dark,
/area/engine/engineering)
"Xs" = (
/obj/machinery/atmospherics/pipe/smart/manifold4w/scrubbers/hidden/layer2{
	dir = 5
	},
/turf/open/floor/plasteel,
/area/engine/engineering)
"XD" = (
/obj/structure/table,
/obj/item/storage/toolbox/mechanical{
	pixel_x = -2;
	pixel_y = 11
	},
/obj/item/storage/toolbox/mechanical{
	pixel_x = -2;
	pixel_y = -1
	},
/turf/open/floor/plasteel/dark,
/area/engine/engineering)
"Yx" = (
/obj/structure/table,
/obj/item/holosign_creator/atmos{
	pixel_x = -1;
	pixel_y = -14
	},
/obj/item/stack/sheet/glass/fifty{
	pixel_x = 3;
	pixel_y = 3
	},
/turf/open/floor/plasteel/dark,
/area/engine/engineering)
"YE" = (
/obj/machinery/atmospherics/pipe/smart/manifold4w/orange/visible/layer1,
/turf/open/floor/plasteel/dark,
/area/engine/engineering)
"YG" = (
/obj/machinery/atmospherics/pipe/smart/manifold4w/yellow/visible{
	dir = 4
	},
/obj/effect/turf_decal/tile/yellow,
/turf/open/floor/plasteel/dark,
/area/engine/engineering)
"YO" = (
/obj/machinery/atmospherics/pipe/smart/manifold4w/orange/visible/layer1,
/obj/effect/turf_decal/tile/yellow{
	dir = 4
	},
/obj/machinery/light{
	dir = 4
	},
/obj/structure/cable,
/turf/open/floor/plasteel/dark,
/area/engine/engineering)
"YU" = (
/obj/effect/mapping_helpers/airlock/cyclelink_helper{
	dir = 1
	},
/obj/machinery/door/airlock/external{
	name = "Engineering External Access";
	req_access_txt = "10;13"
	},
/obj/structure/fans/tiny,
/turf/open/floor/plating,
/area/engine/engineering)
"YZ" = (
/obj/effect/turf_decal/tile/yellow{
	dir = 1
	},
/obj/machinery/light{
	dir = 1;
	light_color = "#c1caff";
	pixel_y = 0
	},
/turf/open/floor/plasteel/dark,
/area/engine/engineering)

(1,1,1) = {"
fM
fM
fM
fM
fM
fM
fM
fM
fM
fM
fM
fM
fM
fM
fM
fM
fM
fM
fM
fM
fM
fM
Wp
OY
Wp
fM
"}
(2,1,1) = {"
fM
fM
fM
fM
fM
fM
fM
lS
lS
fM
fM
fM
fM
fM
fM
fM
fM
fM
fM
fM
fM
fM
Wp
Wp
Wp
fM
"}
(3,1,1) = {"
fM
fM
fM
fM
fM
fM
fM
lS
fM
fM
fM
fM
fM
fM
fM
fM
fM
fM
fM
fM
fM
nR
Wp
OY
Wp
fM
"}
(4,1,1) = {"
fM
fM
fM
fM
fM
fM
fM
Ix
nR
nR
nR
nR
nR
nR
nR
nR
nR
nR
nR
nR
nR
nR
nR
OY
Wp
fM
"}
(5,1,1) = {"
fM
fM
fM
fM
fM
fM
fM
Ix
nR
nR
fM
fM
fM
fM
fM
nR
fM
fM
fM
fM
fM
nR
Wp
OY
Wp
fM
"}
(6,1,1) = {"
fM
fM
fM
fM
fM
fM
fM
Ix
fM
nR
nR
fM
fM
fM
fM
nR
fM
fM
fM
fM
fM
nR
Wp
Wp
Wp
fM
"}
(7,1,1) = {"
fM
fM
fM
fM
fM
fM
fM
Ix
fM
fM
nR
nR
fM
fM
fM
nR
fM
fM
fM
fM
fM
nR
Wp
OY
Wp
fM
"}
(8,1,1) = {"
fM
fM
fM
fM
fM
fM
fM
Ix
fM
fM
fM
nR
nR
fM
fM
nR
fM
fM
fM
fM
fM
nR
Wp
OY
Wp
fM
"}
(9,1,1) = {"
fM
fM
fM
fM
fM
fM
fM
Ix
fM
fM
fM
fM
nR
nR
fM
nR
fM
fM
fM
fM
fM
nR
Wp
OY
Wp
fM
"}
(10,1,1) = {"
fM
fM
fM
fM
VD
VD
lS
Ix
fM
fM
fM
fM
fM
nR
nR
nR
fM
fM
fM
fM
fM
nR
nR
Wp
nR
fM
"}
(11,1,1) = {"
fM
fM
PF
pN
VD
VD
lS
Ix
fM
fM
fM
fM
fM
fM
nR
nR
fM
fM
fM
fM
fM
nR
Wp
OY
Wp
fM
"}
(12,1,1) = {"
fM
fM
Xs
AK
Dd
xv
YU
Ix
Ix
Ix
Ix
Ix
Ix
Ix
Ix
nR
nR
nR
nR
nR
nR
nR
Wp
Wp
nR
fM
"}
(13,1,1) = {"
fM
Fo
zf
Fo
lS
lS
lS
Fo
Fo
Fo
Fo
Fo
Fo
lS
Ix
fM
fM
fM
fM
fM
fM
nR
nR
OY
Wp
fM
"}
(14,1,1) = {"
Fo
Fo
lt
UK
gO
HD
UK
uT
UK
uT
uT
tX
tX
lS
Ix
fM
fM
fM
fM
fM
fM
nR
nR
Wp
nR
fM
"}
(15,1,1) = {"
lS
ii
xX
kb
kb
kb
kb
kb
kb
kb
kb
kb
hq
lS
Ix
fM
fM
fM
fM
fM
fM
nR
Wp
OY
Wp
fM
"}
(16,1,1) = {"
Fo
ii
CR
Uu
Jg
Jg
Jg
Jg
Jg
Jg
Jg
Jg
jr
lS
Ix
nR
nR
nR
nR
nR
nR
nR
Wp
OY
Wp
fM
"}
(17,1,1) = {"
Fo
ii
kb
Jg
ay
Ns
bX
yh
tD
tD
ON
Jg
jr
Fo
Ix
fM
fM
fM
fM
nR
fM
fM
nR
OY
Wp
fM
"}
(18,1,1) = {"
lS
YZ
kb
Jg
ay
Yx
no
Cl
XD
iK
ON
Jg
jr
Fo
Ix
fM
fM
fM
fM
nR
fM
fM
Wp
Wp
Wp
fM
"}
(19,1,1) = {"
Fo
Ho
gU
et
et
et
et
et
et
et
et
et
Ic
lS
Ix
fM
fM
fM
fM
nR
fM
fM
nR
OY
Wp
fM
"}
(20,1,1) = {"
AB
Sc
fK
Go
Go
Go
Rv
yQ
yQ
yQ
yQ
yQ
xr
lS
Ix
fM
fM
fM
fM
nR
fM
fM
Wp
OY
Wp
fM
"}
(21,1,1) = {"
Fo
Sc
fK
LM
Gb
LM
Gb
LM
Gb
LM
Gb
fK
jV
Fo
Ix
fM
fM
fM
fM
nR
fM
fM
Wp
OY
Wp
fM
"}
(22,1,1) = {"
Wb
sI
PG
yQ
TE
yQ
TE
yQ
TE
yQ
PP
bM
oz
Fo
Ix
nR
nR
nR
nR
nR
nR
nR
Wp
Wp
Wp
fM
"}
(23,1,1) = {"
lS
pB
in
LM
di
LM
di
LM
di
LM
di
in
ch
Fo
Ix
fM
nR
fM
fM
fM
fM
nR
Wp
OY
Wp
fM
"}
(24,1,1) = {"
lS
dL
in
Go
Go
Go
Rv
yQ
yQ
yQ
yQ
yQ
GD
lS
Ix
fM
nR
fM
fM
fM
fM
nR
Wp
OY
nR
fM
"}
(25,1,1) = {"
Fo
dM
EI
kr
kr
kr
my
kr
kr
kr
kr
kr
hj
lS
Ix
fM
nR
fM
fM
fM
fM
nR
nR
OY
Wp
fM
"}
(26,1,1) = {"
Fo
jh
WN
Jg
Jg
Jg
Da
Jg
Jg
Jg
Jg
Jg
YG
Fo
Ix
fM
nR
fM
fM
fM
fM
nR
Wp
Wp
Wp
fM
"}
(27,1,1) = {"
lS
jh
Vo
cJ
WN
WN
kj
WN
Jg
Jg
Jg
Jg
YG
Fo
Ix
fM
nR
fM
fM
fM
fM
nR
Wp
OY
Wp
fM
"}
(28,1,1) = {"
Fo
Fo
zP
HX
HX
YO
Ty
My
YE
iD
rj
WN
YG
lS
Ix
nR
nR
nR
nR
nR
nR
nR
Wp
OY
Wp
fM
"}
(29,1,1) = {"
Bv
Fo
ct
Fo
lS
lS
xj
WN
TN
TN
TN
TN
Mi
lS
Ix
fM
fM
fM
fM
fM
nR
fM
Wp
OY
Wp
fM
"}
(30,1,1) = {"
fM
lh
Wk
bb
vh
Fo
Jg
WN
WN
WN
WN
WN
YG
Fo
Ix
fM
fM
fM
fM
fM
nR
fM
Wp
nR
nR
fM
"}
(31,1,1) = {"
fM
AK
Dk
Ab
Ab
Fo
rB
yq
yq
yq
yq
yq
KX
lS
Ix
nR
nR
nR
nR
nR
nR
fM
nR
OY
Wp
fM
"}
(32,1,1) = {"
fM
AK
EH
AK
Px
lS
lS
Fo
Fo
Fo
Fo
Fo
Fo
lS
Ix
fM
fM
fM
fM
fM
fM
fM
Wp
OY
Wp
fM
"}
