//MAP CONVERTED BY dmm2tgm.py THIS HEADER COMMENT PREVENTS RECONVERSION, DO NOT REMOVE
"ab" = (
/turf/template_noop,
/area/template_noop)
"ac" = (
/obj/machinery/light/small{
	dir = 8
	},
/turf/open/floor/plating,
/area/engine/engineering)
"ad" = (
/turf/closed/wall/r_wall,
/area/engine/engineering)
"ag" = (
/obj/structure/table,
/obj/item/clothing/gloves/color/yellow,
/obj/item/storage/toolbox/electrical{
	pixel_y = 5
	},
/turf/open/floor/plasteel,
/area/engine/engineering)
"ao" = (
/obj/structure/cable,
/obj/machinery/atmospherics/pipe/smart/manifold4w/supply/hidden/layer4,
/obj/machinery/atmospherics/pipe/smart/manifold4w/scrubbers/hidden/layer2,
/turf/open/floor/plasteel,
/area/engine/engineering)
"aq" = (
/obj/machinery/atmospherics/pipe/smart/manifold4w/supply/hidden/layer4,
/turf/open/floor/engine,
/area/engine/engineering)
"as" = (
/obj/structure/cable,
/obj/machinery/atmospherics/pipe/smart/manifold4w/supply/hidden/layer4{
	dir = 4
	},
/obj/machinery/atmospherics/pipe/smart/manifold4w/scrubbers/hidden/layer2{
	dir = 1
	},
/turf/open/floor/plasteel,
/area/engine/engineering)
"at" = (
/obj/machinery/atmospherics/pipe/smart/manifold4w/scrubbers/hidden/layer2{
	dir = 1
	},
/turf/open/floor/plasteel,
/area/engine/engineering)
"au" = (
/turf/open/floor/plasteel,
/area/engine/engineering)
"av" = (
/obj/machinery/door/firedoor,
/obj/machinery/door/airlock/engineering/glass{
	name = "Supermatter Engine Room";
	req_access_txt = "10"
	},
/obj/structure/cable,
/turf/open/floor/engine,
/area/engine/engineering)
"aw" = (
/obj/machinery/door/firedoor,
/obj/machinery/door/airlock/engineering/glass{
	name = "Supermatter Engine Room";
	req_access_txt = "10"
	},
/obj/machinery/atmospherics/pipe/smart/manifold4w/supply/hidden/layer4,
/turf/open/floor/engine,
/area/engine/engineering)
"ax" = (
/obj/structure/closet/radiation,
/turf/open/floor/plasteel,
/area/engine/engineering)
"aF" = (
/obj/structure/railing,
/obj/effect/turf_decal/stripes/line,
/obj/effect/turf_decal/stripes/corner{
	dir = 1
	},
/obj/structure/railing/corner{
	dir = 1
	},
/obj/machinery/atmospherics/pipe/smart/manifold4w/scrubbers/hidden/layer2{
	dir = 1
	},
/turf/open/floor/engine,
/area/engine/engineering)
"aH" = (
/obj/machinery/door/firedoor,
/obj/machinery/door/airlock/engineering/glass{
	name = "Supermatter Engine Room";
	req_access_txt = "10"
	},
/obj/effect/turf_decal/stripes/end{
	dir = 8
	},
/obj/machinery/atmospherics/pipe/smart/manifold4w/scrubbers/hidden/layer2{
	dir = 1
	},
/turf/open/floor/engine,
/area/engine/engineering)
"aI" = (
/obj/structure/cable,
/obj/machinery/atmospherics/pipe/smart/manifold4w/supply/hidden/layer4{
	dir = 1
	},
/obj/machinery/atmospherics/pipe/smart/manifold4w/scrubbers/hidden/layer2{
	dir = 1
	},
/turf/open/floor/plasteel,
/area/engine/engineering)
"aL" = (
/obj/effect/turf_decal/stripes/box,
/obj/structure/cable/multilayer/multiz,
/turf/open/floor/plating,
/area/engine/engineering)
"aQ" = (
/obj/machinery/light{
	dir = 1;
	pixel_y = 0
	},
/obj/effect/turf_decal/stripes/line{
	dir = 8
	},
/turf/open/floor/engine,
/area/engine/engineering)
"aR" = (
/obj/effect/turf_decal/stripes/line,
/turf/open/floor/engine,
/area/engine/engineering)
"aV" = (
/obj/structure/cable,
/turf/open/floor/engine,
/area/engine/engineering)
"aX" = (
/obj/effect/spawner/structure/window/plasma/reinforced,
/obj/machinery/atmospherics/pipe/smart/manifold4w/orange/visible{
	dir = 4
	},
/turf/open/floor/plating,
/area/engine/engineering)
"aY" = (
/obj/machinery/atmospherics/pipe/smart/manifold4w/orange/visible{
	dir = 4
	},
/turf/open/floor/plasteel,
/area/engine/engineering)
"aZ" = (
/obj/machinery/meter,
/obj/machinery/atmospherics/pipe/smart/manifold4w/orange/visible{
	dir = 4
	},
/obj/machinery/atmospherics/pipe/smart/manifold4w/supply/hidden/layer4,
/obj/machinery/atmospherics/pipe/smart/manifold4w/scrubbers/hidden/layer2{
	dir = 1
	},
/turf/open/floor/plasteel,
/area/engine/engineering)
"ba" = (
/obj/machinery/light{
	dir = 1;
	pixel_y = 0
	},
/obj/effect/turf_decal/stripes/line{
	dir = 4
	},
/turf/open/floor/engine,
/area/engine/engineering)
"bb" = (
/turf/closed/wall,
/area/engine/engineering)
"bd" = (
/obj/machinery/atmospherics/pipe/smart/manifold4w/supply/hidden/layer4{
	dir = 9
	},
/obj/machinery/atmospherics/pipe/smart/manifold4w/scrubbers/hidden/layer2{
	dir = 1
	},
/turf/open/floor/plasteel/dark,
/area/engine/engineering)
"bk" = (
/obj/effect/turf_decal/stripes/line{
	dir = 9
	},
/obj/structure/railing{
	dir = 8
	},
/turf/open/floor/plasteel/dark,
/area/engine/engineering)
"bl" = (
/obj/structure/cable,
/obj/machinery/atmospherics/pipe/smart/manifold4w/supply/hidden/layer4,
/obj/machinery/atmospherics/pipe/smart/manifold4w/scrubbers/hidden/layer2{
	dir = 1
	},
/turf/open/floor/plasteel,
/area/engine/engineering)
"bq" = (
/obj/structure/rack,
/obj/item/clothing/mask/gas{
	pixel_x = 3;
	pixel_y = 3
	},
/obj/item/clothing/mask/gas,
/obj/item/clothing/mask/gas{
	pixel_x = -3;
	pixel_y = -3
	},
/turf/open/floor/plasteel,
/area/engine/engineering)
"bA" = (
/obj/structure/railing/corner,
/obj/effect/turf_decal/stripes/line,
/obj/effect/turf_decal/stripes/line{
	dir = 1
	},
/obj/machinery/atmospherics/pipe/smart/manifold4w/scrubbers/hidden/layer2{
	dir = 1
	},
/turf/open/floor/engine,
/area/engine/engineering)
"bB" = (
/obj/effect/mapping_helpers/airlock/cyclelink_helper{
	dir = 1
	},
/obj/machinery/door/airlock/external{
	name = "Engineering External Access";
	req_access_txt = "10;13"
	},
/obj/structure/fans/tiny,
/turf/open/floor/plating,
/area/engine/engineering)
"bC" = (
/obj/structure/railing/corner{
	dir = 4
	},
/obj/structure/railing,
/obj/effect/turf_decal/stripes/line,
/obj/effect/turf_decal/stripes/line{
	dir = 1
	},
/obj/machinery/atmospherics/pipe/smart/manifold4w/scrubbers/hidden/layer2{
	dir = 1
	},
/turf/open/floor/engine,
/area/engine/engineering)
"bD" = (
/obj/structure/railing{
	dir = 1
	},
/obj/structure/railing,
/obj/effect/turf_decal/stripes/line,
/obj/effect/turf_decal/stripes/line{
	dir = 1
	},
/obj/machinery/atmospherics/pipe/smart/manifold4w/scrubbers/hidden/layer2{
	dir = 1
	},
/turf/open/floor/engine,
/area/engine/engineering)
"bF" = (
/obj/effect/turf_decal/stripes/line{
	dir = 9
	},
/obj/structure/marker_beacon{
	icon_state = "markerburgundy-on"
	},
/obj/structure/railing{
	dir = 8
	},
/obj/effect/turf_decal/stripes/corner,
/turf/open/floor/engine,
/area/engine/engineering)
"bI" = (
/obj/effect/turf_decal/stripes/line{
	dir = 1
	},
/obj/effect/turf_decal/stripes/line,
/turf/open/floor/engine,
/area/engine/engineering)
"bJ" = (
/obj/effect/turf_decal/stripes/line{
	dir = 5
	},
/obj/structure/marker_beacon{
	icon_state = "markerburgundy-on"
	},
/obj/structure/railing{
	dir = 4
	},
/obj/effect/turf_decal/stripes/corner{
	dir = 8
	},
/turf/open/floor/engine,
/area/engine/engineering)
"bN" = (
/obj/machinery/atmospherics/pipe/multiz/supply/visible/layer4{
	color = "#0000ff";
	dir = 4;
	name = "Supply multi deck pipe adapter"
	},
/obj/effect/turf_decal/stripes/box,
/turf/open/floor/plating,
/area/engine/engineering)
"bP" = (
/obj/machinery/atmospherics/pipe/smart/manifold4w/supply/hidden/layer4{
	dir = 4
	},
/obj/structure/railing/corner{
	dir = 1
	},
/obj/structure/railing,
/obj/effect/turf_decal/stripes/line,
/obj/effect/turf_decal/stripes/line{
	dir = 1
	},
/obj/machinery/atmospherics/pipe/smart/manifold4w/scrubbers/hidden/layer2{
	dir = 1
	},
/turf/open/floor/engine,
/area/engine/engineering)
"bQ" = (
/obj/machinery/atmospherics/pipe/smart/manifold4w/supply/hidden/layer4{
	dir = 4
	},
/obj/structure/cable,
/obj/structure/railing/corner{
	dir = 8
	},
/obj/effect/turf_decal/stripes/line,
/obj/effect/turf_decal/stripes/line{
	dir = 1
	},
/obj/machinery/atmospherics/pipe/smart/manifold4w/scrubbers/hidden/layer2{
	dir = 1
	},
/turf/open/floor/engine,
/area/engine/engineering)
"bS" = (
/obj/effect/turf_decal/stripes/corner{
	dir = 8
	},
/obj/structure/railing/corner{
	dir = 8
	},
/obj/machinery/atmospherics/pipe/smart/manifold4w/scrubbers/hidden/layer2{
	dir = 1
	},
/turf/open/floor/engine,
/area/engine/engineering)
"cf" = (
/obj/effect/turf_decal/stripes/line,
/obj/machinery/atmospherics/components/unary/vent_scrubber/on/layer2{
	dir = 1
	},
/turf/open/floor/engine,
/area/engine/engineering)
"cj" = (
/obj/machinery/atmospherics/pipe/multiz/scrubbers/visible/layer2{
	color = "#ff0000";
	dir = 4;
	name = "Scrubbers multi deck pipe adapter"
	},
/obj/effect/turf_decal/stripes/box,
/turf/open/floor/plating,
/area/engine/engineering)
"ck" = (
/obj/machinery/atmospherics/pipe/smart/manifold4w/scrubbers/hidden/layer2{
	dir = 1
	},
/obj/machinery/atmospherics/pipe/smart/manifold4w/supply/hidden/layer4{
	dir = 4
	},
/turf/open/floor/plasteel/dark,
/area/engine/engineering)
"cm" = (
/obj/structure/lattice/catwalk,
/obj/machinery/atmospherics/pipe/smart/manifold4w/orange/visible{
	dir = 6
	},
/obj/structure/cable,
/obj/structure/railing{
	dir = 8
	},
/turf/open/openspace,
/area/engine/engineering)
"cn" = (
/obj/machinery/atmospherics/pipe/smart/manifold4w/orange/visible{
	dir = 10
	},
/turf/open/floor/plasteel,
/area/engine/engineering)
"cu" = (
/obj/effect/mapping_helpers/airlock/cyclelink_helper,
/obj/machinery/door/airlock/external{
	name = "Engineering External Access";
	req_access_txt = "10;13"
	},
/turf/open/floor/plating,
/area/engine/engineering)
"cw" = (
/obj/effect/turf_decal/stripes/line{
	dir = 1
	},
/turf/open/floor/plasteel/dark,
/area/engine/engineering)
"cy" = (
/obj/machinery/light{
	dir = 4;
	icon_state = "tube"
	},
/obj/machinery/atmospherics/components/unary/vent_scrubber/on/layer2{
	dir = 1
	},
/obj/machinery/atmospherics/pipe/smart/manifold4w/supply/hidden/layer4{
	dir = 4
	},
/turf/open/floor/plasteel/dark,
/area/engine/engineering)
"cD" = (
/obj/effect/turf_decal/stripes/box,
/obj/machinery/atmospherics/pipe/multiz{
	dir = 1
	},
/obj/structure/cable,
/obj/machinery/light{
	dir = 4;
	icon_state = "tube"
	},
/obj/structure/railing{
	dir = 8
	},
/turf/open/floor/plating,
/area/engine/engineering)
"cE" = (
/obj/machinery/atmospherics/pipe/smart/manifold4w/orange/visible{
	dir = 5
	},
/turf/open/floor/plasteel,
/area/engine/engineering)
"cL" = (
/obj/effect/turf_decal/stripes/line,
/turf/open/floor/plasteel/dark,
/area/engine/engineering)
"cO" = (
/obj/machinery/door/firedoor,
/obj/machinery/door/airlock/engineering/glass{
	name = "Supermatter Engine Room";
	req_access_txt = "10"
	},
/obj/machinery/atmospherics/pipe/smart/manifold4w/supply/hidden/layer4,
/obj/machinery/atmospherics/pipe/smart/manifold4w/scrubbers/hidden/layer2{
	dir = 1
	},
/turf/open/floor/plasteel/dark,
/area/engine/engineering)
"cQ" = (
/obj/effect/turf_decal/stripes/line,
/obj/structure/railing,
/obj/effect/turf_decal/stripes/line{
	dir = 1
	},
/turf/open/floor/engine,
/area/engine/engineering)
"cV" = (
/obj/structure/lattice/catwalk,
/obj/structure/railing{
	dir = 8
	},
/turf/open/openspace,
/area/engine/engineering)
"dk" = (
/obj/structure/railing/corner{
	dir = 4
	},
/obj/effect/turf_decal/stripes/corner{
	dir = 4
	},
/turf/open/floor/plasteel/dark,
/area/engine/engineering)
"dx" = (
/obj/machinery/atmospherics/pipe/smart/manifold4w/scrubbers/hidden/layer2{
	dir = 1
	},
/turf/open/floor/engine,
/area/engine/engineering)
"dA" = (
/obj/machinery/atmospherics/pipe/smart/manifold4w/supply/hidden/layer4{
	dir = 4
	},
/turf/open/floor/plasteel/dark,
/area/engine/engineering)
"dG" = (
/obj/effect/turf_decal/stripes/line{
	dir = 9
	},
/obj/effect/turf_decal/stripes/corner,
/obj/machinery/light/floor,
/turf/open/floor/engine,
/area/engine/engineering)
"dJ" = (
/obj/machinery/atmospherics/pipe/smart/manifold4w/supply/hidden/layer4{
	dir = 5
	},
/obj/machinery/atmospherics/pipe/smart/manifold4w/scrubbers/hidden/layer2{
	dir = 1
	},
/turf/open/floor/engine,
/area/engine/engineering)
"dL" = (
/obj/structure/lattice/catwalk,
/obj/structure/railing{
	dir = 4
	},
/turf/open/openspace,
/area/engine/engineering)
"dN" = (
/obj/machinery/atmospherics/pipe/smart/manifold4w/supply/hidden/layer4{
	dir = 4
	},
/obj/effect/turf_decal/stripes/corner,
/obj/structure/railing/corner,
/obj/machinery/atmospherics/pipe/smart/manifold4w/scrubbers/hidden/layer2{
	dir = 1
	},
/turf/open/floor/engine,
/area/engine/engineering)
"dQ" = (
/obj/machinery/atmospherics/pipe/smart/manifold4w/supply/hidden/layer4{
	dir = 4
	},
/obj/structure/railing,
/obj/effect/turf_decal/stripes/line,
/obj/effect/turf_decal/stripes/corner{
	dir = 4
	},
/obj/structure/railing/corner{
	dir = 4
	},
/obj/machinery/atmospherics/pipe/smart/manifold4w/scrubbers/hidden/layer2{
	dir = 1
	},
/turf/open/floor/engine,
/area/engine/engineering)
"dR" = (
/obj/machinery/atmospherics/pipe/smart/manifold4w/supply/hidden/layer4{
	dir = 4
	},
/obj/structure/railing{
	dir = 1
	},
/obj/structure/railing,
/obj/effect/turf_decal/stripes/line,
/obj/effect/turf_decal/stripes/line{
	dir = 1
	},
/obj/machinery/atmospherics/pipe/smart/manifold4w/scrubbers/hidden/layer2{
	dir = 1
	},
/turf/open/floor/engine,
/area/engine/engineering)
"dS" = (
/obj/effect/turf_decal/stripes/line{
	dir = 8
	},
/obj/structure/railing{
	dir = 8
	},
/obj/effect/turf_decal/stripes/line{
	dir = 4
	},
/turf/open/floor/engine,
/area/engine/engineering)
"dU" = (
/obj/effect/turf_decal/stripes/line{
	dir = 4
	},
/obj/structure/railing{
	dir = 4
	},
/obj/effect/turf_decal/stripes/line{
	dir = 8
	},
/turf/open/floor/engine,
/area/engine/engineering)
"dX" = (
/obj/machinery/light,
/turf/open/floor/plating,
/area/engine/engineering)
"eb" = (
/obj/machinery/door/firedoor,
/obj/machinery/door/airlock/engineering/glass{
	name = "Supermatter Engine Room";
	req_access_txt = "10"
	},
/obj/machinery/atmospherics/pipe/smart/manifold4w/supply/hidden/layer4{
	dir = 4
	},
/obj/structure/cable,
/obj/effect/turf_decal/stripes/end{
	dir = 4
	},
/obj/machinery/atmospherics/pipe/smart/manifold4w/scrubbers/hidden/layer2{
	dir = 1
	},
/turf/open/floor/engine,
/area/engine/engineering)
"ec" = (
/obj/effect/turf_decal/stripes/line{
	dir = 5
	},
/obj/structure/railing{
	dir = 4
	},
/turf/open/floor/plasteel/dark,
/area/engine/engineering)
"ed" = (
/obj/machinery/light{
	dir = 8
	},
/obj/structure/railing{
	dir = 4
	},
/obj/effect/turf_decal/stripes/line{
	dir = 4
	},
/turf/open/floor/plasteel/dark,
/area/engine/engineering)
"el" = (
/obj/effect/turf_decal/stripes/line{
	dir = 10
	},
/obj/structure/railing{
	dir = 8
	},
/turf/open/floor/plasteel/dark,
/area/engine/engineering)
"ev" = (
/obj/structure/chair/plastic{
	dir = 8
	},
/turf/open/floor/engine/airless,
/area/space/nearstation)
"eA" = (
/obj/effect/turf_decal/stripes/box,
/obj/structure/cable/multilayer/multiz,
/obj/structure/railing{
	dir = 8
	},
/turf/open/floor/plating,
/area/engine/engineering)
"eB" = (
/obj/structure/table,
/obj/item/storage/toolbox/mechanical{
	pixel_y = 5
	},
/obj/item/flashlight{
	pixel_x = 1;
	pixel_y = 5
	},
/obj/item/flashlight{
	pixel_x = 1;
	pixel_y = 5
	},
/turf/open/floor/plasteel,
/area/engine/engineering)
"eD" = (
/obj/effect/turf_decal/stripes/line{
	dir = 6
	},
/obj/structure/railing{
	dir = 4
	},
/turf/open/floor/plasteel/dark,
/area/engine/engineering)
"eF" = (
/obj/structure/railing{
	dir = 1
	},
/obj/effect/turf_decal/stripes/line{
	dir = 1
	},
/turf/open/floor/plasteel/dark,
/area/engine/engineering)
"eG" = (
/obj/machinery/light,
/obj/structure/railing{
	dir = 1
	},
/obj/effect/turf_decal/stripes/line{
	dir = 1
	},
/obj/effect/turf_decal/stripes/corner,
/turf/open/floor/plasteel/dark,
/area/engine/engineering)
"eO" = (
/obj/structure/railing{
	dir = 1
	},
/obj/effect/turf_decal/stripes/line{
	dir = 1
	},
/obj/effect/turf_decal/stripes/line,
/turf/open/floor/plasteel/dark,
/area/engine/engineering)
"eP" = (
/obj/structure/railing/corner{
	dir = 1
	},
/obj/effect/turf_decal/stripes/corner{
	dir = 1
	},
/obj/effect/turf_decal/stripes/corner{
	dir = 8
	},
/obj/machinery/light,
/obj/machinery/atmospherics/pipe/smart/manifold4w/supply/hidden/layer4{
	dir = 4
	},
/turf/open/floor/plasteel/dark,
/area/engine/engineering)
"eS" = (
/obj/effect/turf_decal/stripes/line{
	dir = 10
	},
/obj/structure/marker_beacon{
	icon_state = "markerburgundy-on"
	},
/obj/structure/railing{
	dir = 10
	},
/obj/effect/turf_decal/stripes/corner{
	dir = 4
	},
/turf/open/floor/engine,
/area/engine/engineering)
"eT" = (
/obj/effect/turf_decal/stripes/line{
	dir = 6
	},
/obj/structure/marker_beacon{
	icon_state = "markerburgundy-on"
	},
/obj/structure/railing{
	dir = 6
	},
/obj/effect/turf_decal/stripes/corner{
	dir = 1
	},
/turf/open/floor/engine,
/area/engine/engineering)
"eU" = (
/obj/effect/turf_decal/stripes/line{
	dir = 8
	},
/obj/structure/marker_beacon{
	icon_state = "markerburgundy-on"
	},
/turf/open/floor/engine/airless,
/area/space/nearstation)
"fb" = (
/obj/effect/turf_decal/stripes/line{
	dir = 8
	},
/turf/open/floor/engine/airless,
/area/space/nearstation)
"fl" = (
/turf/open/openspace,
/area/engine/engineering)
"fm" = (
/obj/effect/turf_decal/stripes/line{
	dir = 4
	},
/turf/open/floor/engine/airless,
/area/space/nearstation)
"fn" = (
/obj/machinery/grill,
/turf/open/floor/engine/airless,
/area/space/nearstation)
"fO" = (
/obj/structure/lattice,
/turf/open/openspace,
/area/engine/engineering)
"gP" = (
/turf/open/floor/engine/airless,
/area/space/nearstation)
"lP" = (
/obj/machinery/airalarm{
	pixel_y = 23
	},
/turf/open/floor/engine,
/area/engine/engineering)
"mm" = (
/obj/effect/turf_decal/stripes/line{
	dir = 10
	},
/obj/effect/turf_decal/stripes/corner{
	dir = 4
	},
/obj/machinery/light/floor,
/turf/open/floor/engine,
/area/engine/engineering)
"oi" = (
/obj/machinery/atmospherics/pipe/smart/manifold4w/supply/hidden/layer4,
/obj/machinery/atmospherics/pipe/smart/manifold4w/scrubbers/hidden/layer2{
	dir = 1
	},
/turf/open/floor/plasteel,
/area/engine/engineering)
"rX" = (
/obj/effect/turf_decal/stripes/line{
	dir = 10
	},
/obj/structure/marker_beacon{
	icon_state = "markerburgundy-on"
	},
/turf/open/floor/engine/airless,
/area/space/nearstation)
"tw" = (
/obj/effect/turf_decal/stripes/line,
/turf/open/floor/engine/airless,
/area/space/nearstation)
"tB" = (
/obj/effect/spawner/structure/window/plasma/reinforced,
/turf/open/floor/plating,
/area/engine/engineering)
"uD" = (
/obj/effect/turf_decal/stripes/line{
	dir = 6
	},
/obj/structure/railing{
	dir = 4
	},
/turf/open/floor/engine,
/area/engine/engineering)
"vb" = (
/turf/open/floor/plating,
/area/engine/engineering)
"wC" = (
/obj/effect/turf_decal/stripes/box,
/obj/structure/ladder,
/turf/open/floor/plating,
/area/space/nearstation)
"wZ" = (
/turf/open/floor/plasteel/dark,
/area/engine/engineering)
"xx" = (
/obj/effect/turf_decal/stripes/line{
	dir = 4
	},
/obj/effect/turf_decal/stripes/line{
	dir = 8
	},
/turf/open/floor/engine,
/area/engine/engineering)
"yP" = (
/obj/effect/turf_decal/stripes/box,
/obj/structure/marker_beacon{
	icon_state = "markerburgundy-on"
	},
/turf/open/floor/engine,
/area/engine/engineering)
"Az" = (
/obj/structure/railing{
	dir = 1
	},
/obj/effect/turf_decal/stripes/line{
	dir = 1
	},
/obj/effect/turf_decal/stripes/line,
/obj/machinery/atmospherics/pipe/smart/manifold4w/supply/hidden/layer4{
	dir = 4
	},
/turf/open/floor/plasteel/dark,
/area/engine/engineering)
"AC" = (
/obj/effect/turf_decal/stripes/line,
/obj/structure/marker_beacon{
	icon_state = "markerburgundy-on"
	},
/turf/open/floor/engine/airless,
/area/space/nearstation)
"AD" = (
/obj/effect/turf_decal/stripes/line{
	dir = 6
	},
/obj/structure/marker_beacon{
	icon_state = "markerburgundy-on"
	},
/turf/open/floor/engine/airless,
/area/space/nearstation)
"Cn" = (
/obj/machinery/camera/autoname{
	dir = 1
	},
/turf/open/floor/plating,
/area/engine/engineering)
"CG" = (
/obj/effect/turf_decal/stripes/line{
	dir = 8
	},
/obj/effect/turf_decal/stripes/line{
	dir = 4
	},
/turf/open/floor/engine,
/area/engine/engineering)
"Ds" = (
/obj/structure/railing{
	dir = 1
	},
/obj/effect/turf_decal/stripes/line{
	dir = 1
	},
/obj/effect/turf_decal/stripes/line,
/obj/machinery/atmospherics/components/unary/vent_pump/on/layer4{
	dir = 4
	},
/turf/open/floor/plasteel/dark,
/area/engine/engineering)
"DB" = (
/obj/machinery/firealarm{
	pixel_y = 24
	},
/obj/machinery/atmospherics/components/unary/vent_pump/on/layer4,
/turf/open/floor/engine,
/area/engine/engineering)
"Fq" = (
/obj/effect/turf_decal/stripes/line{
	dir = 5
	},
/obj/effect/turf_decal/stripes/corner{
	dir = 8
	},
/obj/machinery/light/floor,
/turf/open/floor/engine,
/area/engine/engineering)
"HE" = (
/obj/effect/turf_decal/stripes/line,
/obj/effect/turf_decal/stripes/line{
	dir = 1
	},
/turf/open/floor/engine,
/area/engine/engineering)
"Ik" = (
/obj/structure/railing{
	dir = 8
	},
/obj/effect/turf_decal/stripes/line{
	dir = 8
	},
/turf/open/floor/plasteel/dark,
/area/engine/engineering)
"LF" = (
/obj/structure/lattice/catwalk,
/turf/template_noop,
/area/space/nearstation)
"OF" = (
/obj/structure/railing{
	dir = 4
	},
/obj/effect/turf_decal/stripes/line{
	dir = 4
	},
/turf/open/floor/plasteel/dark,
/area/engine/engineering)
"Pl" = (
/obj/effect/turf_decal/stripes/line{
	dir = 6
	},
/obj/effect/turf_decal/stripes/corner{
	dir = 1
	},
/obj/machinery/light/floor,
/turf/open/floor/engine,
/area/engine/engineering)
"TX" = (
/obj/effect/turf_decal/stripes/line{
	dir = 10
	},
/obj/structure/railing{
	dir = 8
	},
/turf/open/floor/engine,
/area/engine/engineering)

(1,1,1) = {"
ab
ab
ab
ab
ab
ab
ab
ab
ab
ab
ab
ab
ab
ab
ab
ab
ab
ab
ab
ab
ab
ab
ab
ab
ab
ab
"}
(2,1,1) = {"
ab
ab
ab
ab
ab
ab
ab
ad
ad
ab
ab
ab
ab
ab
ab
ab
ab
ab
ab
ab
ab
ab
ab
ab
ab
ab
"}
(3,1,1) = {"
ab
ab
ab
ab
ab
ab
ab
ad
ab
ab
ab
ab
ab
ab
ab
ab
ab
ab
ab
ab
ab
ab
ab
ab
ab
ab
"}
(4,1,1) = {"
ab
ab
ab
ab
ab
ab
ab
LF
ab
ab
ab
ab
ab
ab
ab
ab
ab
ab
ab
ab
ab
ab
ab
ab
ab
ab
"}
(5,1,1) = {"
ab
ab
ab
ab
ab
ab
ab
LF
ab
ab
ab
ab
ab
ab
ab
ab
ab
ab
ab
ab
ab
ab
ab
ab
ab
ab
"}
(6,1,1) = {"
ab
ab
ab
ab
ab
ab
ab
LF
ab
ab
ab
ab
ab
ab
ab
ab
ab
ab
ab
ab
ab
ab
ab
ab
ab
ab
"}
(7,1,1) = {"
ab
ab
ab
ab
ab
ab
ab
LF
ab
ab
ab
ab
ab
ab
ab
ab
ab
ab
ab
ab
ab
ab
ab
ab
ab
ab
"}
(8,1,1) = {"
ab
ab
ab
ab
ab
ab
ab
LF
ab
ab
ab
ab
ab
ab
ab
ab
ab
ab
ab
ab
ab
ab
ab
ab
ab
ab
"}
(9,1,1) = {"
ab
ab
ab
ab
ab
ab
ab
LF
ab
ab
ab
ab
ab
ab
ab
ab
ab
ab
ab
ab
ab
ab
ab
ab
ab
ab
"}
(10,1,1) = {"
ab
ab
ab
ab
bb
bb
ad
LF
ab
ab
ab
ab
ab
ab
ab
ab
ab
ab
ab
ab
ab
ab
ab
ab
ab
ab
"}
(11,1,1) = {"
ab
ab
ag
eB
bb
bb
ad
LF
ab
ab
ab
ab
ab
ab
ab
ab
ab
ab
ab
ab
ab
ab
ab
ab
ab
ab
"}
(12,1,1) = {"
ab
ab
at
au
cu
ac
bB
LF
wC
LF
LF
LF
LF
LF
LF
ab
ab
ab
ab
ab
ab
ab
ab
ab
ab
ab
"}
(13,1,1) = {"
ab
tB
aH
tB
ad
ad
ad
tB
tB
tB
tB
tB
tB
ad
eU
fb
fb
eU
fb
fb
rX
ab
ab
ab
ab
ab
"}
(14,1,1) = {"
tB
tB
bA
OF
OF
ed
OF
OF
OF
OF
OF
OF
dk
tB
gP
gP
gP
gP
gP
fn
tw
ab
ab
ab
ab
ab
"}
(15,1,1) = {"
ad
dL
bC
fl
fl
fl
fO
fl
fl
fl
fO
fl
eF
tB
gP
gP
gP
gP
gP
ev
tw
ab
ab
ab
ab
ab
"}
(16,1,1) = {"
tB
fl
bD
fl
fl
fl
fO
fl
fl
fl
fO
fl
eF
tB
gP
gP
gP
gP
gP
gP
tw
ab
ab
ab
ab
ab
"}
(17,1,1) = {"
tB
fl
bD
fl
fl
fl
fO
fl
fl
fl
fO
fl
eG
ad
ad
ad
ad
gP
gP
gP
tw
ab
ab
ab
ab
ab
"}
(18,1,1) = {"
ad
aQ
aF
fl
fl
fl
fO
fl
fl
fl
fO
fl
eO
vb
vb
vb
ad
gP
gP
gP
AC
ab
ab
ab
ab
ab
"}
(19,1,1) = {"
ad
lP
bS
TX
bk
el
bF
dS
dS
dS
eS
fO
eO
vb
vb
Cn
ad
gP
gP
gP
tw
ab
ab
ab
ab
ab
"}
(20,1,1) = {"
av
aV
dx
aR
cw
cL
bI
dG
CG
mm
cQ
fl
eO
vb
vb
dX
ad
gP
gP
gP
tw
ab
ab
ab
ab
ab
"}
(21,1,1) = {"
tB
aL
dx
cf
cw
cL
bI
bI
yP
HE
cQ
fl
Ds
vb
vb
vb
tB
gP
gP
gP
tw
ab
ab
ab
ab
ab
"}
(22,1,1) = {"
aw
aq
dJ
aR
cw
cL
bI
Fq
xx
Pl
cQ
fl
Az
vb
vb
vb
tB
gP
gP
gP
tw
ab
ab
ab
ab
ab
"}
(23,1,1) = {"
ad
DB
dN
uD
ec
eD
bJ
dU
dU
dU
eT
fO
Az
vb
vb
vb
tB
gP
gP
gP
AC
ab
ab
ab
ab
ab
"}
(24,1,1) = {"
ad
ba
dQ
fl
fl
fl
fO
fl
fl
fl
fO
fl
Az
vb
vb
vb
tB
gP
gP
gP
tw
ab
ab
ab
ab
ab
"}
(25,1,1) = {"
tB
fl
dR
fl
fl
fl
fO
fl
fl
fl
fO
fl
Az
vb
vb
dX
ad
gP
gP
gP
tw
ab
ab
ab
ab
ab
"}
(26,1,1) = {"
tB
fl
dR
fl
fl
fl
fO
fl
fl
fl
fO
fl
Az
vb
vb
vb
ad
gP
gP
gP
tw
ab
ab
ab
ab
ab
"}
(27,1,1) = {"
ad
cV
bP
fl
fl
fl
fO
fl
fl
fl
fO
fl
Az
vb
vb
vb
ad
gP
gP
gP
tw
ab
ab
ab
ab
ab
"}
(28,1,1) = {"
tB
tB
bQ
cm
cD
eA
Ik
Ik
Ik
Ik
Ik
Ik
eP
ad
ad
ad
ad
fm
fm
fm
AD
ab
ab
ab
ab
ab
"}
(29,1,1) = {"
ax
tB
eb
aX
ad
ad
ad
ad
wZ
wZ
wZ
wZ
dA
tB
ab
ab
ab
ab
ab
ab
ab
ab
ab
ab
ab
ab
"}
(30,1,1) = {"
ab
bl
ao
aY
bq
tB
bN
cj
wZ
wZ
wZ
wZ
dA
ad
ab
ab
ab
ab
ab
ab
ab
ab
ab
ab
ab
ab
"}
(31,1,1) = {"
ab
au
aI
aZ
oi
cO
bd
ck
cy
dA
dA
dA
dA
ad
ab
ab
ab
ab
ab
ab
ab
ab
ab
ab
ab
ab
"}
(32,1,1) = {"
ab
au
as
cn
cE
ad
ad
ad
ad
ad
tB
tB
tB
ad
ab
ab
ab
ab
ab
ab
ab
ab
ab
ab
ab
ab
"}
