//MAP CONVERTED BY dmm2tgm.py THIS HEADER COMMENT PREVENTS RECONVERSION, DO NOT REMOVE
"ab" = (
/turf/template_noop,
/area/template_noop)
"ad" = (
/turf/closed/wall/r_wall,
/area/maintenance/bottom_station_maints)
"bd" = (
/obj/structure/particle_accelerator/power_box,
/turf/open/floor/plating/airless,
/area/engine/engineering)
"cd" = (
/obj/machinery/door/airlock/external{
	name = "External Access";
	req_access_txt = "13"
	},
/obj/structure/fans/tiny,
/turf/open/floor/plating,
/area/engine/engineering)
"cv" = (
/obj/structure/ladder,
/obj/machinery/light/small{
	dir = 4
	},
/turf/open/floor/plating,
/area/engine/engineering)
"cA" = (
/turf/closed/wall/r_wall,
/area/engine/engineering)
"ev" = (
/obj/effect/turf_decal/stripes/line{
	dir = 8
	},
/turf/open/floor/plating/airless,
/area/engine/engineering)
"fq" = (
/obj/structure/cable,
/turf/open/floor/plating/airless,
/area/engine/engineering)
"fC" = (
/obj/effect/turf_decal/stripes/line{
	dir = 4
	},
/turf/open/floor/plating/airless,
/area/engine/engineering)
"ix" = (
/obj/structure/cable/multilayer/multiz,
/obj/effect/turf_decal/stripes/box,
/turf/open/floor/plating,
/area/engine/engineering)
"kn" = (
/obj/effect/turf_decal/stripes/box,
/obj/structure/cable,
/turf/open/floor/plating/airless,
/area/space/nearstation)
"lj" = (
/obj/effect/turf_decal/stripes/line{
	dir = 4
	},
/obj/structure/cable,
/turf/open/floor/plating/airless,
/area/engine/engineering)
"lS" = (
/obj/effect/turf_decal/stripes/line{
	dir = 6
	},
/turf/open/floor/plating/airless,
/area/engine/engineering)
"qa" = (
/obj/machinery/particle_accelerator/control_box,
/obj/structure/cable,
/turf/open/floor/plating/airless,
/area/engine/engineering)
"sT" = (
/obj/structure/particle_accelerator/particle_emitter/right,
/turf/open/floor/plating/airless,
/area/engine/engineering)
"tB" = (
/obj/structure/lattice,
/turf/template_noop,
/area/space/nearstation)
"ud" = (
/obj/structure/particle_accelerator/fuel_chamber,
/turf/open/floor/plating/airless,
/area/engine/engineering)
"uN" = (
/obj/structure/lattice/catwalk,
/turf/template_noop,
/area/space/nearstation)
"vK" = (
/obj/structure/particle_accelerator/particle_emitter/left,
/turf/open/floor/plating/airless,
/area/engine/engineering)
"yB" = (
/obj/structure/lattice/catwalk,
/obj/structure/cable,
/turf/template_noop,
/area/space/nearstation)
"CS" = (
/turf/open/floor/plating/airless,
/area/engine/engineering)
"FH" = (
/turf/template_noop,
/area/space/nearstation)
"Ia" = (
/obj/effect/turf_decal/stripes/box,
/obj/effect/turf_decal/trimline/yellow,
/obj/machinery/field/generator,
/turf/open/floor/plating/airless,
/area/space/nearstation)
"Iu" = (
/obj/structure/particle_accelerator/particle_emitter/center,
/turf/open/floor/plating/airless,
/area/engine/engineering)
"IR" = (
/obj/effect/turf_decal/stripes/line{
	dir = 10
	},
/turf/open/floor/plating/airless,
/area/engine/engineering)
"Mu" = (
/obj/effect/turf_decal/stripes/line{
	dir = 8
	},
/obj/structure/cable,
/turf/open/floor/plating/airless,
/area/engine/engineering)
"Oi" = (
/obj/structure/particle_accelerator/end_cap,
/turf/open/floor/plating/airless,
/area/engine/engineering)
"OA" = (
/obj/effect/turf_decal/stripes/line{
	dir = 5
	},
/obj/structure/cable,
/turf/open/floor/plating/airless,
/area/engine/engineering)
"PB" = (
/obj/effect/turf_decal/stripes/line{
	dir = 1
	},
/obj/structure/cable,
/turf/open/floor/plating/airless,
/area/engine/engineering)
"SY" = (
/obj/effect/turf_decal/stripes/line,
/turf/open/floor/plating/airless,
/area/engine/engineering)
"TX" = (
/obj/effect/turf_decal/stripes/line{
	dir = 1
	},
/obj/structure/cable,
/obj/machinery/light{
	dir = 1;
	light_color = "#c1caff";
	pixel_y = 0
	},
/turf/open/floor/plating/airless,
/area/engine/engineering)
"Vf" = (
/obj/effect/turf_decal/stripes/box,
/obj/machinery/power/emitter/welded{
	dir = 8
	},
/obj/structure/cable,
/turf/open/floor/plating/airless,
/area/space/nearstation)
"Yf" = (
/obj/effect/turf_decal/stripes/box,
/obj/machinery/power/emitter/welded{
	dir = 4
	},
/obj/structure/cable,
/turf/open/floor/plating/airless,
/area/space/nearstation)
"Zq" = (
/obj/effect/turf_decal/stripes/line{
	dir = 9
	},
/obj/structure/cable,
/turf/open/floor/plating/airless,
/area/engine/engineering)

(1,1,1) = {"
ab
ab
ab
ab
ab
ab
FH
ab
ab
ab
ab
ab
FH
ab
ab
ab
ab
ab
ab
ab
FH
ab
ab
ab
ab
ab
"}
(2,1,1) = {"
ab
ab
ab
ab
ab
ab
tB
ab
ab
ab
ab
ab
tB
ab
ab
ab
ab
ab
ab
ab
tB
ab
ab
ab
ab
ab
"}
(3,1,1) = {"
ab
ab
ab
ab
ab
ab
tB
ab
ab
ab
ab
ab
tB
ab
ab
ab
ab
ab
ab
ab
tB
ab
ab
ab
ab
ab
"}
(4,1,1) = {"
ab
ab
ab
ab
ab
ab
tB
ab
ab
ab
ab
ab
tB
ab
ab
ab
ab
ab
ab
ab
tB
ab
ab
ab
ab
ab
"}
(5,1,1) = {"
tB
tB
tB
tB
tB
tB
tB
tB
tB
tB
tB
tB
tB
tB
tB
tB
tB
tB
tB
tB
tB
tB
FH
FH
FH
FH
"}
(6,1,1) = {"
ab
ab
ab
ab
ab
ab
tB
ab
ab
ab
ab
ab
tB
ab
ab
ab
ab
ab
ab
ab
tB
ab
ab
ab
FH
ab
"}
(7,1,1) = {"
ab
ab
ab
ab
ab
ab
tB
ab
ab
ab
ab
ab
tB
ab
ab
ab
ab
ab
ab
ab
tB
ab
ab
ab
FH
ab
"}
(8,1,1) = {"
ab
ab
ab
ab
ab
ab
tB
ab
ab
ab
ab
ab
tB
ab
ab
ab
ab
ab
ab
ab
tB
ab
ab
ab
FH
ab
"}
(9,1,1) = {"
ab
ab
ab
ab
ab
ab
tB
ab
ab
ab
ab
ab
tB
ab
ab
ab
ab
ab
ab
ab
tB
ab
ab
ab
FH
ab
"}
(10,1,1) = {"
tB
tB
tB
tB
tB
tB
tB
tB
tB
tB
tB
tB
tB
tB
tB
tB
tB
tB
tB
tB
tB
tB
FH
FH
FH
FH
"}
(11,1,1) = {"
ab
ab
ab
ab
ab
ab
tB
ab
ab
tB
ab
ab
tB
ab
ab
ab
ab
tB
ab
ab
tB
ab
ab
ab
FH
ab
"}
(12,1,1) = {"
ab
ab
yB
yB
yB
yB
yB
yB
yB
Yf
yB
yB
yB
yB
yB
yB
yB
kn
ab
ab
tB
ab
ab
ab
FH
ab
"}
(13,1,1) = {"
ab
ab
yB
ab
ab
ab
tB
ab
ab
tB
ab
ab
tB
ab
ab
ab
ab
tB
ab
ab
tB
ab
ab
ab
FH
ab
"}
(14,1,1) = {"
ad
ab
yB
ab
ab
ab
tB
ab
ab
tB
ab
ab
tB
ab
ab
ab
ab
tB
ab
ab
tB
ab
ab
ab
FH
ab
"}
(15,1,1) = {"
ad
ab
yB
cA
cA
cA
tB
ab
ab
tB
ab
ab
tB
ab
ab
ab
ab
tB
ab
ab
tB
ab
ab
ab
FH
ab
"}
(16,1,1) = {"
ad
tB
yB
cd
cv
cA
tB
ab
ab
tB
ab
ab
tB
ab
ab
ab
ab
tB
ab
ab
tB
tB
FH
FH
FH
FH
"}
(17,1,1) = {"
ad
ab
yB
cA
cA
cA
tB
tB
tB
Ia
uN
uN
uN
uN
uN
uN
uN
Ia
tB
tB
tB
ab
ab
ab
FH
ab
"}
(18,1,1) = {"
ad
ab
yB
ab
ab
ab
tB
ab
ab
uN
ab
ab
ab
ab
tB
ab
ab
uN
ab
ab
tB
ab
ab
ab
FH
ab
"}
(19,1,1) = {"
ad
Zq
Mu
ev
ix
ev
IR
ab
ab
uN
ab
ab
ab
ab
tB
ab
ab
uN
ab
ab
tB
tB
FH
FH
FH
FH
"}
(20,1,1) = {"
ad
PB
CS
qa
fq
vK
SY
ab
ab
uN
tB
tB
tB
tB
tB
ab
ab
uN
ab
ab
tB
ab
ab
ab
FH
ab
"}
(21,1,1) = {"
ad
TX
Oi
ud
bd
Iu
SY
ab
ab
uN
ab
ab
tB
ab
tB
ab
ab
uN
ab
ab
tB
ab
ab
ab
FH
ab
"}
(22,1,1) = {"
ad
PB
CS
CS
CS
sT
SY
ab
ab
uN
ab
ab
tB
tB
tB
tB
tB
uN
ab
ab
tB
ab
ab
ab
FH
ab
"}
(23,1,1) = {"
ad
OA
lj
fC
fC
fC
lS
ab
ab
uN
ab
ab
tB
ab
ab
ab
ab
uN
ab
ab
tB
FH
FH
FH
FH
FH
"}
(24,1,1) = {"
ad
ab
yB
ab
ab
ab
tB
ab
ab
uN
ab
ab
tB
ab
ab
ab
ab
uN
ab
ab
tB
ab
ab
ab
FH
ab
"}
(25,1,1) = {"
ad
ab
yB
ab
ab
ab
tB
tB
tB
Ia
uN
uN
uN
uN
uN
uN
uN
Ia
tB
tB
tB
ab
ab
ab
FH
ab
"}
(26,1,1) = {"
ad
tB
yB
tB
tB
tB
tB
ab
ab
tB
ab
ab
tB
ab
ab
ab
ab
tB
ab
ab
tB
FH
FH
FH
FH
FH
"}
(27,1,1) = {"
ad
ab
yB
ab
ab
ab
tB
ab
ab
tB
ab
ab
tB
ab
ab
ab
ab
tB
ab
ab
tB
ab
ab
ab
FH
ab
"}
(28,1,1) = {"
ad
ab
yB
ab
ab
ab
tB
ab
ab
tB
ab
ab
tB
ab
ab
ab
ab
tB
ab
ab
tB
ab
ab
ab
FH
ab
"}
(29,1,1) = {"
ab
ab
yB
ab
ab
ab
tB
ab
ab
tB
ab
ab
tB
ab
ab
ab
ab
tB
ab
ab
tB
ab
ab
ab
FH
ab
"}
(30,1,1) = {"
ab
ab
yB
ab
ab
ab
tB
ab
ab
tB
ab
ab
tB
ab
ab
ab
ab
tB
ab
ab
tB
ab
ab
ab
FH
ab
"}
(31,1,1) = {"
ab
tB
yB
yB
yB
yB
yB
yB
yB
kn
yB
yB
yB
yB
yB
yB
yB
Vf
tB
tB
tB
FH
FH
FH
FH
FH
"}
(32,1,1) = {"
ab
ab
ab
ab
ab
ab
tB
ab
ab
ab
ab
ab
tB
ab
ab
ab
ab
ab
ab
ab
tB
ab
ab
ab
FH
ab
"}
