//MAP CONVERTED BY dmm2tgm.py THIS HEADER COMMENT PREVENTS RECONVERSION, DO NOT REMOVE
"ab" = (
/turf/template_noop,
/area/template_noop)
"ac" = (
/obj/machinery/advanced_airlock_controller/directional/east,
/obj/machinery/atmospherics/components/binary/dp_vent_pump/layer4,
/obj/machinery/atmospherics/pipe/simple/scrubbers/hidden/layer2,
/turf/open/floor/plating,
/area/engine/engineering)
"ad" = (
/turf/closed/wall/r_wall,
/area/engine/engineering)
"ag" = (
/obj/structure/table,
/obj/item/clothing/gloves/color/yellow,
/obj/item/storage/toolbox/electrical{
	pixel_y = 5
	},
/turf/open/floor/plasteel,
/area/engine/engineering)
"ao" = (
/obj/structure/cable,
/obj/machinery/atmospherics/pipe/manifold/supply/hidden/layer4,
/obj/machinery/atmospherics/pipe/manifold/scrubbers/hidden/layer2,
/turf/open/floor/plasteel,
/area/engine/engineering)
"aq" = (
/obj/machinery/atmospherics/pipe/simple/supply/hidden/layer4,
/turf/open/floor/engine/airless,
/area/engine/engineering)
"as" = (
/obj/structure/cable,
/obj/machinery/atmospherics/pipe/simple/supply/hidden/layer4{
	dir = 4
	},
/obj/machinery/atmospherics/pipe/simple/scrubbers/hidden/layer2{
	dir = 8
	},
/turf/open/floor/plasteel,
/area/engine/engineering)
"at" = (
/obj/machinery/atmospherics/pipe/simple/supply/hidden/layer4,
/obj/machinery/atmospherics/pipe/manifold/scrubbers/hidden/layer2{
	dir = 8
	},
/turf/open/floor/plasteel,
/area/engine/engineering)
"au" = (
/turf/open/floor/plasteel,
/area/engine/engineering)
"av" = (
/obj/machinery/door/firedoor,
/obj/machinery/door/airlock/engineering/glass{
	name = "Supermatter Engine Room";
	req_access_txt = "10"
	},
/obj/structure/cable,
/turf/open/floor/engine,
/area/engine/engineering)
"aw" = (
/obj/machinery/door/firedoor,
/obj/machinery/door/airlock/engineering/glass{
	name = "Supermatter Engine Room";
	req_access_txt = "10"
	},
/obj/machinery/atmospherics/pipe/simple/scrubbers/hidden/layer2,
/obj/machinery/atmospherics/pipe/simple/supply/hidden/layer4,
/turf/open/floor/engine,
/area/engine/engineering)
"ax" = (
/obj/structure/closet/radiation,
/turf/open/floor/plasteel,
/area/engine/engineering)
"aF" = (
/obj/machinery/atmospherics/pipe/simple/scrubbers/hidden/layer2{
	dir = 4
	},
/obj/structure/railing,
/obj/effect/turf_decal/stripes/line,
/obj/effect/turf_decal/stripes/corner{
	dir = 1
	},
/turf/open/floor/engine/airless,
/area/engine/engineering)
"aH" = (
/obj/machinery/door/firedoor,
/obj/machinery/door/airlock/engineering/glass{
	name = "Supermatter Engine Room";
	req_access_txt = "10"
	},
/obj/machinery/atmospherics/pipe/simple/scrubbers/hidden/layer2{
	dir = 4
	},
/obj/effect/turf_decal/stripes/end{
	dir = 8
	},
/turf/open/floor/engine,
/area/engine/engineering)
"aI" = (
/obj/structure/cable,
/obj/machinery/atmospherics/pipe/manifold/supply/hidden/layer4{
	dir = 1
	},
/obj/machinery/atmospherics/pipe/manifold/scrubbers/hidden/layer2{
	dir = 1
	},
/turf/open/floor/plasteel,
/area/engine/engineering)
"aL" = (
/obj/effect/turf_decal/stripes/box,
/obj/structure/cable/multilayer/multiz,
/turf/open/floor/plating,
/area/engine/engineering)
"aP" = (
/obj/structure/railing{
	dir = 8
	},
/obj/effect/turf_decal/stripes/line{
	dir = 8
	},
/turf/open/floor/engine/airless,
/area/engine/engineering)
"aQ" = (
/obj/machinery/light{
	dir = 1;
	pixel_y = 0
	},
/obj/effect/turf_decal/stripes/line{
	dir = 8
	},
/turf/open/floor/engine/airless,
/area/engine/engineering)
"aR" = (
/obj/structure/railing{
	dir = 4
	},
/obj/effect/turf_decal/stripes/line{
	dir = 4
	},
/turf/open/floor/engine/airless,
/area/engine/engineering)
"aV" = (
/obj/structure/cable,
/turf/open/floor/engine/airless,
/area/engine/engineering)
"aX" = (
/obj/effect/spawner/structure/window/plasma/reinforced,
/obj/machinery/atmospherics/pipe/simple/orange/visible{
	dir = 4
	},
/turf/open/floor/plating,
/area/engine/engineering)
"aY" = (
/obj/machinery/atmospherics/pipe/simple/orange/visible{
	dir = 4
	},
/turf/open/floor/plasteel,
/area/engine/engineering)
"aZ" = (
/obj/machinery/meter,
/obj/machinery/atmospherics/pipe/simple/orange/visible{
	dir = 4
	},
/obj/machinery/atmospherics/pipe/simple/supply/hidden/layer4,
/obj/machinery/atmospherics/pipe/simple/scrubbers/hidden/layer2,
/turf/open/floor/plasteel,
/area/engine/engineering)
"ba" = (
/obj/machinery/light{
	dir = 1;
	pixel_y = 0
	},
/obj/effect/turf_decal/stripes/line{
	dir = 4
	},
/turf/open/floor/engine/airless,
/area/engine/engineering)
"bb" = (
/turf/closed/wall,
/area/engine/engineering)
"bd" = (
/obj/structure/lattice/catwalk,
/obj/machinery/atmospherics/pipe/simple/scrubbers/hidden/layer2,
/obj/machinery/atmospherics/pipe/simple/supply/hidden/layer4{
	dir = 9
	},
/turf/open/openspace,
/area/engine/engineering)
"bh" = (
/obj/effect/turf_decal/stripes/line{
	dir = 1
	},
/obj/structure/railing/corner{
	dir = 1
	},
/turf/open/floor/plasteel,
/area/engine/engineering)
"bj" = (
/obj/effect/turf_decal/stripes/line{
	dir = 1
	},
/obj/structure/railing/corner{
	dir = 4
	},
/turf/open/floor/plasteel,
/area/engine/engineering)
"bk" = (
/obj/effect/turf_decal/stripes/line{
	dir = 9
	},
/obj/machinery/light/floor,
/obj/structure/railing{
	dir = 9
	},
/turf/open/floor/plasteel,
/area/engine/engineering)
"bl" = (
/obj/structure/cable,
/obj/machinery/atmospherics/pipe/simple/supply/hidden/layer4,
/obj/machinery/atmospherics/pipe/simple/scrubbers/hidden/layer2,
/turf/open/floor/plasteel,
/area/engine/engineering)
"bq" = (
/obj/structure/rack,
/obj/item/clothing/mask/gas{
	pixel_x = 3;
	pixel_y = 3
	},
/obj/item/clothing/mask/gas,
/obj/item/clothing/mask/gas{
	pixel_x = -3;
	pixel_y = -3
	},
/turf/open/floor/plasteel,
/area/engine/engineering)
"br" = (
/obj/machinery/light/small{
	dir = 8
	},
/obj/structure/closet/emcloset/anchored,
/turf/open/floor/plating,
/area/engine/engineering)
"bv" = (
/obj/structure/ladder,
/obj/effect/turf_decal/stripes/box,
/turf/open/floor/plasteel,
/area/engine/engineering)
"bA" = (
/obj/machinery/atmospherics/pipe/simple/scrubbers/hidden/layer2{
	dir = 4
	},
/obj/structure/railing/corner,
/obj/effect/turf_decal/stripes/line,
/obj/effect/turf_decal/stripes/line{
	dir = 1
	},
/turf/open/floor/engine/airless,
/area/engine/engineering)
"bB" = (
/obj/effect/mapping_helpers/airlock/cyclelink_helper{
	dir = 1
	},
/obj/machinery/door/airlock/external{
	name = "Engineering External Access";
	req_access_txt = "10;13"
	},
/obj/machinery/atmospherics/pipe/layer_manifold,
/turf/open/floor/plating,
/area/engine/engineering)
"bC" = (
/obj/machinery/atmospherics/pipe/simple/scrubbers/hidden/layer2{
	dir = 4
	},
/obj/structure/railing/corner{
	dir = 4
	},
/obj/structure/railing,
/obj/effect/turf_decal/stripes/line,
/obj/effect/turf_decal/stripes/line{
	dir = 1
	},
/turf/open/floor/engine/airless,
/area/engine/engineering)
"bD" = (
/obj/machinery/atmospherics/pipe/simple/scrubbers/hidden/layer2{
	dir = 4
	},
/obj/structure/railing{
	dir = 1
	},
/obj/structure/railing,
/obj/effect/turf_decal/stripes/line,
/obj/effect/turf_decal/stripes/line{
	dir = 1
	},
/turf/open/floor/engine/airless,
/area/engine/engineering)
"bF" = (
/obj/effect/turf_decal/stripes/line{
	dir = 9
	},
/obj/structure/marker_beacon{
	icon_state = "markerburgundy-on"
	},
/obj/structure/railing{
	dir = 8
	},
/turf/open/floor/engine/airless,
/area/engine/engineering)
"bI" = (
/obj/effect/turf_decal/stripes/line{
	dir = 1
	},
/turf/open/floor/engine/airless,
/area/engine/engineering)
"bJ" = (
/obj/effect/turf_decal/stripes/line{
	dir = 5
	},
/obj/structure/marker_beacon{
	icon_state = "markerburgundy-on"
	},
/obj/structure/railing{
	dir = 4
	},
/turf/open/floor/engine/airless,
/area/engine/engineering)
"bN" = (
/obj/machinery/atmospherics/pipe/multiz/layer4{
	color = "#0000ff";
	dir = 4;
	name = "Supply multi deck pipe adapter"
	},
/obj/effect/turf_decal/stripes/box,
/obj/structure/railing/corner{
	dir = 8
	},
/turf/open/floor/plating,
/area/engine/engineering)
"bP" = (
/obj/machinery/atmospherics/pipe/simple/supply/hidden/layer4{
	dir = 4
	},
/obj/machinery/atmospherics/pipe/simple/scrubbers/hidden/layer2{
	dir = 4
	},
/obj/structure/railing/corner{
	dir = 1
	},
/obj/structure/railing,
/obj/effect/turf_decal/stripes/line,
/obj/effect/turf_decal/stripes/line{
	dir = 1
	},
/turf/open/floor/engine/airless,
/area/engine/engineering)
"bQ" = (
/obj/machinery/atmospherics/pipe/simple/supply/hidden/layer4{
	dir = 4
	},
/obj/machinery/atmospherics/pipe/simple/scrubbers/hidden/layer2{
	dir = 4
	},
/obj/structure/cable,
/obj/structure/railing/corner{
	dir = 8
	},
/obj/effect/turf_decal/stripes/line,
/obj/effect/turf_decal/stripes/line{
	dir = 1
	},
/turf/open/floor/engine/airless,
/area/engine/engineering)
"bS" = (
/obj/machinery/atmospherics/pipe/simple/scrubbers/hidden/layer2{
	dir = 4
	},
/obj/structure/railing,
/obj/effect/turf_decal/stripes/line,
/turf/open/floor/engine/airless,
/area/engine/engineering)
"cf" = (
/turf/open/floor/engine/airless,
/area/engine/engineering)
"cj" = (
/obj/machinery/atmospherics/pipe/multiz/layer2{
	color = "#ff0000";
	dir = 4;
	name = "Scrubbers multi deck pipe adapter"
	},
/obj/effect/turf_decal/stripes/box,
/obj/structure/railing{
	dir = 8
	},
/turf/open/floor/plating,
/area/engine/engineering)
"ck" = (
/obj/structure/lattice/catwalk,
/obj/machinery/atmospherics/pipe/simple/scrubbers/hidden/layer2{
	dir = 9
	},
/turf/open/openspace,
/area/engine/engineering)
"cm" = (
/obj/structure/lattice/catwalk,
/obj/machinery/atmospherics/pipe/simple/orange/visible{
	dir = 6
	},
/obj/structure/cable,
/obj/structure/railing{
	dir = 8
	},
/turf/open/openspace,
/area/engine/engineering)
"cn" = (
/obj/machinery/atmospherics/pipe/simple/orange/visible{
	dir = 10
	},
/turf/open/floor/plasteel,
/area/engine/engineering)
"cu" = (
/obj/effect/mapping_helpers/airlock/cyclelink_helper,
/obj/machinery/door/airlock/external{
	name = "Engineering External Access";
	req_access_txt = "10;13"
	},
/obj/machinery/atmospherics/pipe/simple/supply/hidden/layer4,
/obj/machinery/atmospherics/pipe/simple/scrubbers/hidden/layer2,
/turf/open/floor/plating,
/area/engine/engineering)
"cw" = (
/obj/effect/turf_decal/stripes/line{
	dir = 1
	},
/turf/open/floor/plasteel,
/area/engine/engineering)
"cy" = (
/obj/structure/lattice/catwalk,
/obj/machinery/light{
	dir = 4;
	icon_state = "tube"
	},
/turf/open/openspace,
/area/engine/engineering)
"cD" = (
/obj/effect/turf_decal/stripes/box,
/obj/machinery/atmospherics/pipe/multiz{
	dir = 1
	},
/obj/structure/cable,
/obj/machinery/light{
	dir = 4;
	icon_state = "tube"
	},
/obj/structure/railing{
	dir = 8
	},
/turf/open/floor/plating,
/area/engine/engineering)
"cE" = (
/obj/machinery/atmospherics/pipe/simple/orange/visible{
	dir = 5
	},
/turf/open/floor/plasteel,
/area/engine/engineering)
"cL" = (
/obj/effect/turf_decal/stripes/line,
/turf/open/floor/plasteel,
/area/engine/engineering)
"cO" = (
/obj/machinery/door/firedoor,
/obj/machinery/door/airlock/engineering/glass{
	name = "Supermatter Engine Room";
	req_access_txt = "10"
	},
/obj/machinery/atmospherics/pipe/simple/supply/hidden/layer4,
/obj/machinery/atmospherics/pipe/simple/scrubbers/hidden/layer2,
/turf/open/floor/plasteel/dark,
/area/engine/engineering)
"cQ" = (
/obj/effect/turf_decal/stripes/line,
/obj/structure/railing,
/turf/open/floor/engine/airless,
/area/engine/engineering)
"cV" = (
/obj/structure/lattice/catwalk,
/obj/structure/railing{
	dir = 8
	},
/turf/open/openspace,
/area/engine/engineering)
"di" = (
/obj/machinery/atmospherics/pipe/simple/scrubbers/hidden/layer2{
	dir = 4
	},
/obj/structure/railing/corner{
	dir = 8
	},
/obj/effect/turf_decal/stripes/corner{
	dir = 8
	},
/turf/open/floor/engine/airless,
/area/engine/engineering)
"dk" = (
/obj/structure/lattice/catwalk,
/obj/structure/railing/corner{
	dir = 4
	},
/turf/open/openspace,
/area/engine/engineering)
"dx" = (
/obj/machinery/atmospherics/pipe/simple/scrubbers/hidden/layer2{
	dir = 4
	},
/turf/open/floor/engine/airless,
/area/engine/engineering)
"dz" = (
/obj/structure/lattice/catwalk,
/obj/structure/railing/corner{
	dir = 1
	},
/turf/open/openspace,
/area/engine/engineering)
"dA" = (
/obj/structure/lattice/catwalk,
/turf/open/openspace,
/area/engine/engineering)
"dG" = (
/turf/open/floor/glass/reinforced,
/area/engine/engineering)
"dJ" = (
/obj/machinery/atmospherics/pipe/simple/supply/hidden/layer4{
	dir = 5
	},
/obj/machinery/atmospherics/pipe/simple/scrubbers/hidden/layer2{
	dir = 4
	},
/obj/structure/railing/corner,
/obj/effect/turf_decal/stripes/corner,
/turf/open/floor/engine/airless,
/area/engine/engineering)
"dL" = (
/obj/structure/lattice/catwalk,
/obj/structure/railing{
	dir = 4
	},
/turf/open/openspace,
/area/engine/engineering)
"dN" = (
/obj/machinery/atmospherics/pipe/simple/supply/hidden/layer4{
	dir = 4
	},
/obj/machinery/atmospherics/pipe/simple/scrubbers/hidden/layer2{
	dir = 4
	},
/obj/structure/railing,
/obj/effect/turf_decal/stripes/line,
/turf/open/floor/engine/airless,
/area/engine/engineering)
"dQ" = (
/obj/machinery/atmospherics/pipe/simple/supply/hidden/layer4{
	dir = 4
	},
/obj/machinery/atmospherics/pipe/simple/scrubbers/hidden/layer2{
	dir = 4
	},
/obj/structure/railing,
/obj/effect/turf_decal/stripes/line,
/obj/effect/turf_decal/stripes/corner{
	dir = 4
	},
/turf/open/floor/engine/airless,
/area/engine/engineering)
"dR" = (
/obj/machinery/atmospherics/pipe/simple/supply/hidden/layer4{
	dir = 4
	},
/obj/machinery/atmospherics/pipe/simple/scrubbers/hidden/layer2{
	dir = 4
	},
/obj/structure/railing{
	dir = 1
	},
/obj/structure/railing,
/obj/effect/turf_decal/stripes/line,
/obj/effect/turf_decal/stripes/line{
	dir = 1
	},
/turf/open/floor/engine/airless,
/area/engine/engineering)
"dS" = (
/obj/effect/turf_decal/stripes/line{
	dir = 8
	},
/obj/structure/railing{
	dir = 8
	},
/turf/open/floor/engine/airless,
/area/engine/engineering)
"dU" = (
/obj/effect/turf_decal/stripes/line{
	dir = 4
	},
/obj/structure/railing{
	dir = 4
	},
/turf/open/floor/engine/airless,
/area/engine/engineering)
"dX" = (
/obj/machinery/light,
/turf/open/openspace,
/area/engine/engineering)
"eb" = (
/obj/machinery/door/firedoor,
/obj/machinery/door/airlock/engineering/glass{
	name = "Supermatter Engine Room";
	req_access_txt = "10"
	},
/obj/machinery/atmospherics/pipe/simple/supply/hidden/layer4{
	dir = 4
	},
/obj/machinery/atmospherics/pipe/simple/scrubbers/hidden/layer2{
	dir = 4
	},
/obj/structure/cable,
/obj/effect/turf_decal/stripes/end{
	dir = 4
	},
/turf/open/floor/engine,
/area/engine/engineering)
"ec" = (
/obj/effect/turf_decal/stripes/line{
	dir = 5
	},
/obj/machinery/light/floor,
/obj/structure/railing{
	dir = 5
	},
/turf/open/floor/plasteel,
/area/engine/engineering)
"ed" = (
/obj/structure/lattice/catwalk,
/obj/machinery/light{
	dir = 8
	},
/obj/structure/railing{
	dir = 4
	},
/turf/open/openspace,
/area/engine/engineering)
"el" = (
/obj/effect/turf_decal/stripes/line{
	dir = 10
	},
/obj/structure/railing{
	dir = 8
	},
/turf/open/floor/plasteel,
/area/engine/engineering)
"ev" = (
/obj/structure/chair/plastic{
	dir = 8
	},
/turf/open/floor/engine/airless,
/area/space/nearstation)
"eA" = (
/obj/effect/turf_decal/stripes/box,
/obj/structure/cable/multilayer/multiz,
/obj/structure/railing{
	dir = 10
	},
/turf/open/floor/plating,
/area/engine/engineering)
"eB" = (
/obj/structure/table,
/obj/item/storage/toolbox/mechanical{
	pixel_y = 5
	},
/obj/item/flashlight{
	pixel_x = 1;
	pixel_y = 5
	},
/obj/item/flashlight{
	pixel_x = 1;
	pixel_y = 5
	},
/turf/open/floor/plasteel,
/area/engine/engineering)
"eD" = (
/obj/effect/turf_decal/stripes/line{
	dir = 6
	},
/obj/structure/railing{
	dir = 4
	},
/turf/open/floor/plasteel,
/area/engine/engineering)
"eF" = (
/obj/structure/lattice/catwalk,
/obj/structure/railing{
	dir = 1
	},
/turf/open/openspace,
/area/engine/engineering)
"eG" = (
/obj/structure/lattice/catwalk,
/obj/machinery/light,
/obj/structure/railing{
	dir = 1
	},
/obj/structure/railing/corner,
/turf/open/openspace,
/area/engine/engineering)
"eO" = (
/obj/structure/lattice/catwalk,
/obj/structure/railing{
	dir = 1
	},
/obj/structure/railing,
/turf/open/openspace,
/area/engine/engineering)
"eP" = (
/obj/structure/lattice/catwalk,
/obj/machinery/light,
/obj/structure/railing{
	dir = 1
	},
/obj/structure/railing/corner{
	dir = 8
	},
/turf/open/openspace,
/area/engine/engineering)
"eS" = (
/obj/effect/turf_decal/stripes/line{
	dir = 10
	},
/obj/structure/marker_beacon{
	icon_state = "markerburgundy-on"
	},
/obj/structure/railing{
	dir = 10
	},
/turf/open/floor/engine/airless,
/area/engine/engineering)
"eT" = (
/obj/effect/turf_decal/stripes/line{
	dir = 6
	},
/obj/structure/marker_beacon{
	icon_state = "markerburgundy-on"
	},
/obj/structure/railing{
	dir = 6
	},
/turf/open/floor/engine/airless,
/area/engine/engineering)
"eU" = (
/obj/effect/turf_decal/stripes/line{
	dir = 8
	},
/obj/structure/marker_beacon{
	icon_state = "markerburgundy-on"
	},
/turf/open/floor/engine/airless,
/area/space/nearstation)
"fb" = (
/obj/effect/turf_decal/stripes/line{
	dir = 8
	},
/turf/open/floor/engine/airless,
/area/space/nearstation)
"fl" = (
/turf/open/openspace,
/area/engine/engineering)
"fm" = (
/obj/effect/turf_decal/stripes/line{
	dir = 4
	},
/turf/open/floor/engine/airless,
/area/space/nearstation)
"fn" = (
/obj/machinery/grill,
/turf/open/floor/engine/airless,
/area/space/nearstation)
"gP" = (
/turf/open/floor/engine/airless,
/area/space/nearstation)
"oi" = (
/obj/machinery/atmospherics/pipe/simple/supply/hidden/layer4,
/obj/machinery/atmospherics/pipe/simple/scrubbers/hidden/layer2,
/turf/open/floor/plasteel,
/area/engine/engineering)
"rX" = (
/obj/effect/turf_decal/stripes/line{
	dir = 10
	},
/obj/structure/marker_beacon{
	icon_state = "markerburgundy-on"
	},
/turf/open/floor/engine/airless,
/area/space/nearstation)
"tw" = (
/obj/effect/turf_decal/stripes/line,
/turf/open/floor/engine/airless,
/area/space/nearstation)
"tB" = (
/obj/effect/spawner/structure/window/plasma/reinforced,
/turf/open/floor/plating,
/area/engine/engineering)
"wC" = (
/obj/effect/turf_decal/stripes/box,
/obj/structure/ladder,
/turf/open/floor/plating,
/area/space/nearstation)
"AC" = (
/obj/effect/turf_decal/stripes/line,
/obj/structure/marker_beacon{
	icon_state = "markerburgundy-on"
	},
/turf/open/floor/engine/airless,
/area/space/nearstation)
"AD" = (
/obj/effect/turf_decal/stripes/line{
	dir = 6
	},
/obj/structure/marker_beacon{
	icon_state = "markerburgundy-on"
	},
/turf/open/floor/engine/airless,
/area/space/nearstation)
"LF" = (
/obj/structure/lattice/catwalk,
/turf/template_noop,
/area/space/nearstation)

(1,1,1) = {"
ab
ab
ab
ab
ab
ab
ab
ab
ab
ab
ab
ab
ab
ab
ab
ab
ab
ab
ab
ab
ab
ab
ab
ab
ab
ab
"}
(2,1,1) = {"
ab
ab
ab
ab
ab
ab
ab
ad
ad
ab
ab
ab
ab
ab
ab
ab
ab
ab
ab
ab
ab
ab
ab
ab
ab
ab
"}
(3,1,1) = {"
ab
ab
ab
ab
ab
ab
ab
ad
ab
ab
ab
ab
ab
ab
ab
ab
ab
ab
ab
ab
ab
ab
ab
ab
ab
ab
"}
(4,1,1) = {"
ab
ab
ab
ab
ab
ab
ab
LF
ab
ab
ab
ab
ab
ab
ab
ab
ab
ab
ab
ab
ab
ab
ab
ab
ab
ab
"}
(5,1,1) = {"
ab
ab
ab
ab
ab
ab
ab
LF
ab
ab
ab
ab
ab
ab
ab
ab
ab
ab
ab
ab
ab
ab
ab
ab
ab
ab
"}
(6,1,1) = {"
ab
ab
ab
ab
ab
ab
ab
LF
ab
ab
ab
ab
ab
ab
ab
ab
ab
ab
ab
ab
ab
ab
ab
ab
ab
ab
"}
(7,1,1) = {"
ab
ab
ab
ab
ab
ab
ab
LF
ab
ab
ab
ab
ab
ab
ab
ab
ab
ab
ab
ab
ab
ab
ab
ab
ab
ab
"}
(8,1,1) = {"
ab
ab
ab
ab
ab
ab
ab
LF
ab
ab
ab
ab
ab
ab
ab
ab
ab
ab
ab
ab
ab
ab
ab
ab
ab
ab
"}
(9,1,1) = {"
ab
ab
ab
ab
ab
ab
ab
LF
ab
ab
ab
ab
ab
ab
ab
ab
ab
ab
ab
ab
ab
ab
ab
ab
ab
ab
"}
(10,1,1) = {"
ab
ab
ab
ab
bb
bb
ad
LF
ab
ab
ab
ab
ab
ab
ab
ab
ab
ab
ab
ab
ab
ab
ab
ab
ab
ab
"}
(11,1,1) = {"
ab
ab
ag
eB
bb
br
ad
LF
ab
ab
ab
ab
ab
ab
ab
ab
ab
ab
ab
ab
ab
ab
ab
ab
ab
ab
"}
(12,1,1) = {"
ab
ab
at
oi
cu
ac
bB
LF
wC
LF
LF
LF
LF
LF
LF
ab
ab
ab
ab
ab
ab
ab
ab
ab
ab
ab
"}
(13,1,1) = {"
ab
tB
aH
tB
ad
ad
ad
tB
tB
tB
tB
tB
tB
ad
eU
fb
fb
eU
fb
fb
rX
ab
ab
ab
ab
ab
"}
(14,1,1) = {"
tB
tB
bA
dL
dL
ed
dL
dL
dL
dL
dL
dL
dk
tB
gP
gP
gP
gP
gP
fn
tw
ab
ab
ab
ab
ab
"}
(15,1,1) = {"
ad
dL
bC
fl
fl
fl
fl
fl
fl
fl
fl
fl
eF
tB
gP
gP
gP
gP
gP
ev
tw
ab
ab
ab
ab
ab
"}
(16,1,1) = {"
tB
fl
bD
fl
fl
fl
fl
fl
fl
fl
fl
fl
eF
tB
gP
gP
gP
gP
gP
gP
tw
ab
ab
ab
ab
ab
"}
(17,1,1) = {"
tB
fl
bD
fl
fl
fl
fl
fl
fl
fl
fl
fl
eG
ad
ad
ad
ad
gP
gP
gP
tw
ab
ab
ab
ab
ab
"}
(18,1,1) = {"
ad
aQ
aF
fl
fl
fl
fl
fl
fl
fl
fl
fl
eO
fl
fl
fl
ad
gP
gP
gP
AC
ab
ab
ab
ab
ab
"}
(19,1,1) = {"
ad
cf
bS
fl
bk
el
bF
dS
dS
dS
eS
fl
eO
fl
fl
fl
ad
gP
gP
gP
tw
ab
ab
ab
ab
ab
"}
(20,1,1) = {"
av
aV
di
aP
bh
cL
bI
dG
dG
dG
cQ
fl
eO
fl
fl
dX
ad
gP
gP
gP
tw
ab
ab
ab
ab
ab
"}
(21,1,1) = {"
tB
aL
dx
cf
cw
bv
bI
dG
dG
dG
cQ
fl
eO
fl
fl
fl
tB
gP
gP
gP
tw
ab
ab
ab
ab
ab
"}
(22,1,1) = {"
aw
aq
dJ
aR
bj
cL
bI
dG
dG
dG
cQ
fl
eO
fl
fl
fl
tB
gP
gP
gP
tw
ab
ab
ab
ab
ab
"}
(23,1,1) = {"
ad
cf
dN
fl
ec
eD
bJ
dU
dU
dU
eT
fl
eO
fl
fl
fl
tB
gP
gP
gP
AC
ab
ab
ab
ab
ab
"}
(24,1,1) = {"
ad
ba
dQ
fl
fl
fl
fl
fl
fl
fl
fl
fl
eO
fl
fl
fl
tB
gP
gP
gP
tw
ab
ab
ab
ab
ab
"}
(25,1,1) = {"
tB
fl
dR
fl
fl
fl
fl
fl
fl
fl
fl
fl
eO
fl
fl
dX
ad
gP
gP
gP
tw
ab
ab
ab
ab
ab
"}
(26,1,1) = {"
tB
fl
dR
fl
fl
fl
fl
fl
fl
fl
fl
fl
eO
fl
fl
fl
ad
gP
gP
gP
tw
ab
ab
ab
ab
ab
"}
(27,1,1) = {"
ad
cV
bP
fl
fl
fl
fl
fl
fl
fl
fl
fl
eO
fl
fl
fl
ad
gP
gP
gP
tw
ab
ab
ab
ab
ab
"}
(28,1,1) = {"
tB
tB
bQ
cm
cD
eA
fl
fl
fl
fl
fl
fl
eP
ad
ad
ad
ad
fm
fm
fm
AD
ab
ab
ab
ab
ab
"}
(29,1,1) = {"
ax
tB
eb
aX
ad
ad
ad
fl
fl
fl
fl
fl
eF
tB
ab
ab
ab
ab
ab
ab
ab
ab
ab
ab
ab
ab
"}
(30,1,1) = {"
ab
bl
ao
aY
bq
tB
bN
cj
cV
cV
cV
cV
dz
ad
ab
ab
ab
ab
ab
ab
ab
ab
ab
ab
ab
ab
"}
(31,1,1) = {"
ab
au
aI
aZ
oi
cO
bd
ck
cy
dA
dA
dA
dA
ad
ab
ab
ab
ab
ab
ab
ab
ab
ab
ab
ab
ab
"}
(32,1,1) = {"
ab
au
as
cn
cE
ad
ad
ad
ad
ad
tB
tB
tB
ad
ab
ab
ab
ab
ab
ab
ab
ab
ab
ab
ab
ab
"}
