//MAP CONVERTED BY dmm2tgm.py THIS HEADER COMMENT PREVENTS RECONVERSION, DO NOT REMOVE
"ab" = (
/turf/template_noop,
/area/template_noop)
"ad" = (
/turf/closed/wall/r_wall,
/area/engine/engineering)
"ag" = (
/obj/structure/sign/warning/fire,
/turf/closed/wall/r_wall,
/area/engine/engineering)
"ao" = (
/obj/machinery/door/airlock/maintenance{
	name = "Engineering Maintenance";
	req_access_txt = "10"
	},
/obj/machinery/door/firedoor/border_only,
/obj/machinery/door/firedoor/border_only{
	dir = 1
	},
/obj/structure/cable,
/turf/open/floor/plating,
/area/engine/engineering)
"ar" = (
/obj/structure/sign/warning/hottemp,
/turf/closed/wall/r_wall,
/area/engine/engineering)
"as" = (
/obj/machinery/airalarm{
	dir = 4;
	pixel_x = -23
	},
/obj/machinery/camera{
	c_tag = "Engineering Supermatter Port";
	dir = 4;
	network = list("ss13","engine")
	},
/obj/effect/turf_decal/tile/yellow{
	dir = 1
	},
/obj/machinery/light{
	dir = 1;
	pixel_y = 0
	},
/obj/machinery/door/firedoor/border_only,
/obj/machinery/door/firedoor/border_only{
	dir = 4
	},
/obj/machinery/firealarm{
	pixel_y = 24
	},
/turf/open/floor/plasteel/dark,
/area/engine/engineering)
"aH" = (
/obj/structure/stairs/east,
/obj/effect/turf_decal/tile/yellow{
	dir = 1
	},
/turf/open/floor/plasteel/dark,
/area/engine/engineering)
"aK" = (
/obj/structure/table/reinforced,
/obj/item/storage/toolbox/mechanical,
/obj/item/flashlight,
/obj/item/pipe_dispenser,
/obj/effect/turf_decal/tile/yellow{
	dir = 1
	},
/obj/structure/window/reinforced{
	dir = 8
	},
/turf/open/floor/plasteel/dark,
/area/engine/engineering)
"aL" = (
/obj/structure/table/reinforced,
/obj/item/tank/internals/emergency_oxygen/engi{
	pixel_x = 5
	},
/obj/item/clothing/gloves/color/black,
/obj/item/clothing/glasses/meson/engine,
/obj/effect/turf_decal/tile/yellow{
	dir = 1
	},
/obj/machinery/light{
	dir = 1;
	pixel_y = 0
	},
/turf/open/floor/plasteel/dark,
/area/engine/engineering)
"aM" = (
/obj/effect/turf_decal/stripes/line{
	dir = 1
	},
/obj/effect/turf_decal/tile/yellow{
	dir = 4
	},
/obj/effect/turf_decal/tile/yellow{
	dir = 1
	},
/turf/open/floor/plasteel/dark,
/area/engine/engineering)
"aO" = (
/obj/effect/turf_decal/stripes/box,
/obj/structure/cable/multilayer/multiz,
/obj/effect/turf_decal/tile/yellow{
	dir = 4
	},
/obj/effect/turf_decal/tile/yellow{
	dir = 1
	},
/turf/open/floor/plating,
/area/engine/engineering)
"aP" = (
/obj/machinery/camera{
	c_tag = "Engineering Supermatter Aft";
	network = list("ss13","engine");
	pixel_x = 23
	},
/obj/effect/turf_decal/tile/yellow{
	dir = 4
	},
/obj/effect/turf_decal/tile/yellow{
	dir = 1
	},
/obj/machinery/light{
	dir = 1;
	pixel_y = 0
	},
/obj/machinery/airalarm{
	pixel_y = 23
	},
/turf/open/floor/plasteel/dark,
/area/engine/engineering)
"aQ" = (
/obj/effect/turf_decal/tile/yellow{
	dir = 4
	},
/obj/structure/closet/secure_closet/atmospherics,
/obj/effect/turf_decal/box/white,
/turf/open/floor/plasteel/dark,
/area/engine/engineering)
"aU" = (
/obj/effect/turf_decal/tile/yellow{
	dir = 4
	},
/obj/structure/window/reinforced{
	dir = 4
	},
/obj/structure/closet/secure_closet/atmospherics,
/obj/effect/turf_decal/box/white,
/turf/open/floor/plasteel/dark,
/area/engine/engineering)
"aW" = (
/obj/structure/stairs/west,
/obj/effect/turf_decal/tile/yellow{
	dir = 4
	},
/turf/open/floor/plasteel/dark,
/area/engine/engineering)
"ba" = (
/obj/effect/turf_decal/tile/yellow{
	dir = 4
	},
/obj/machinery/light{
	dir = 1;
	pixel_y = 0
	},
/obj/machinery/door/firedoor/border_only,
/obj/machinery/door/firedoor/border_only{
	dir = 8
	},
/obj/machinery/firealarm{
	pixel_y = 24
	},
/obj/machinery/airalarm{
	dir = 8;
	pixel_x = 24
	},
/turf/open/floor/plasteel/dark,
/area/engine/engineering)
"bb" = (
/obj/structure/lattice,
/turf/template_noop,
/area/space/nearstation)
"bc" = (
/obj/machinery/atmospherics/pipe/heat_exchanging/simple{
	dir = 4
	},
/obj/structure/lattice,
/obj/machinery/atmospherics/pipe/heat_exchanging/simple,
/turf/template_noop,
/area/space/nearstation)
"be" = (
/obj/structure/lattice/catwalk,
/obj/machinery/atmospherics/pipe/heat_exchanging/simple{
	dir = 5
	},
/turf/template_noop,
/area/space/nearstation)
"bt" = (
/obj/structure/lattice/catwalk,
/obj/machinery/atmospherics/pipe/heat_exchanging/simple{
	dir = 9
	},
/turf/template_noop,
/area/space/nearstation)
"bv" = (
/obj/effect/spawner/structure/window/reinforced,
/turf/open/floor/plating,
/area/engine/engineering)
"by" = (
/obj/effect/turf_decal/loading_area/red{
	dir = 1
	},
/obj/machinery/atmospherics/pipe/smart/manifold4w/orange/visible,
/obj/machinery/meter,
/turf/open/floor/engine,
/area/engine/engineering)
"bA" = (
/obj/effect/turf_decal/tile/yellow{
	dir = 4
	},
/obj/machinery/light{
	dir = 4
	},
/turf/open/floor/plasteel/dark,
/area/engine/engineering)
"bE" = (
/obj/effect/turf_decal/tile/yellow{
	dir = 8
	},
/obj/machinery/light{
	dir = 8
	},
/turf/open/floor/plasteel/dark,
/area/engine/engineering)
"bI" = (
/obj/machinery/atmospherics/pipe/smart/manifold4w/orange/visible,
/turf/open/floor/plasteel/dark,
/area/engine/engineering)
"bJ" = (
/obj/effect/turf_decal/tile/yellow{
	dir = 4
	},
/turf/open/floor/plasteel/dark,
/area/engine/engineering)
"bN" = (
/turf/open/floor/plasteel/dark,
/area/engine/engineering)
"ch" = (
/obj/machinery/atmospherics/pipe/smart/manifold4w/cyan/visible,
/obj/effect/turf_decal/stripes/line{
	dir = 4
	},
/turf/open/floor/plasteel/dark,
/area/engine/engineering)
"ci" = (
/obj/machinery/atmospherics/pipe/heat_exchanging/simple{
	dir = 5
	},
/obj/structure/lattice/catwalk,
/turf/template_noop,
/area/space/nearstation)
"cw" = (
/obj/machinery/atmospherics/components/binary/circulator/cold{
	dir = 4
	},
/turf/open/floor/engine,
/area/engine/engineering)
"cy" = (
/obj/effect/turf_decal/loading_area/white{
	dir = 1
	},
/obj/machinery/atmospherics/pipe/smart/manifold4w/cyan/visible,
/obj/machinery/meter,
/turf/open/floor/engine,
/area/engine/engineering)
"cB" = (
/obj/machinery/atmospherics/components/binary/circulator/flipped{
	dir = 8
	},
/turf/open/floor/engine,
/area/engine/engineering)
"cC" = (
/obj/machinery/atmospherics/pipe/smart/manifold4w/orange/visible,
/obj/effect/turf_decal/stripes/line{
	dir = 8
	},
/turf/open/floor/plasteel/dark,
/area/engine/engineering)
"cD" = (
/obj/effect/turf_decal/loading_area/white{
	dir = 1
	},
/obj/machinery/atmospherics/pipe/smart/manifold4w/cyan/visible,
/turf/open/floor/engine,
/area/engine/engineering)
"cH" = (
/obj/machinery/light{
	pixel_y = 0
	},
/turf/open/floor/engine,
/area/engine/engineering)
"cL" = (
/obj/effect/turf_decal/stripes/line,
/obj/machinery/light{
	dir = 4
	},
/turf/open/floor/plasteel/dark,
/area/engine/engineering)
"cM" = (
/obj/effect/turf_decal/tile/yellow{
	dir = 8
	},
/obj/machinery/camera{
	c_tag = "Engineering Supermatter Port";
	dir = 4;
	network = list("ss13","engine")
	},
/obj/machinery/portable_atmospherics/scrubber,
/obj/effect/turf_decal/stripes/line{
	dir = 6
	},
/turf/open/floor/plasteel/dark,
/area/engine/engineering)
"cX" = (
/obj/effect/turf_decal/stripes/line,
/obj/machinery/light{
	dir = 8
	},
/turf/open/floor/plasteel/dark,
/area/engine/engineering)
"cY" = (
/obj/machinery/atmospherics/pipe/smart/manifold4w/cyan/visible,
/turf/open/floor/plasteel/dark,
/area/engine/engineering)
"cZ" = (
/obj/effect/turf_decal/loading_area/red{
	dir = 1
	},
/obj/machinery/atmospherics/pipe/smart/manifold4w/orange/visible,
/turf/open/floor/engine,
/area/engine/engineering)
"dd" = (
/obj/effect/turf_decal/stripes/line{
	dir = 8
	},
/turf/open/floor/plasteel/dark,
/area/engine/engineering)
"do" = (
/obj/machinery/camera{
	c_tag = "Engineering Supermatter Starboard";
	network = list("ss13","engine")
	},
/turf/open/floor/engine,
/area/engine/engineering)
"dp" = (
/obj/effect/turf_decal/tile/yellow{
	dir = 4
	},
/obj/machinery/atmospherics/pipe/smart/manifold4w/orange/visible,
/turf/open/floor/plasteel/dark,
/area/engine/engineering)
"dt" = (
/obj/effect/turf_decal/tile/yellow{
	dir = 8
	},
/obj/machinery/light{
	dir = 8
	},
/obj/machinery/firealarm{
	dir = 4;
	pixel_x = -24
	},
/turf/open/floor/plasteel/dark,
/area/engine/engineering)
"dx" = (
/obj/effect/turf_decal/stripes/line{
	dir = 8
	},
/obj/machinery/atmospherics/pipe/smart/manifold4w/orange/visible{
	dir = 8
	},
/turf/open/floor/plasteel/dark,
/area/engine/engineering)
"dZ" = (
/obj/structure/cable,
/obj/machinery/power/generator{
	dir = 1
	},
/turf/open/floor/engine,
/area/engine/engineering)
"ec" = (
/obj/machinery/atmospherics/pipe/heat_exchanging/simple{
	dir = 4
	},
/obj/machinery/atmospherics/pipe/heat_exchanging/simple,
/obj/structure/lattice,
/turf/template_noop,
/area/space/nearstation)
"eg" = (
/obj/effect/turf_decal/tile/yellow{
	dir = 8
	},
/turf/open/floor/plasteel/dark,
/area/engine/engineering)
"er" = (
/obj/effect/turf_decal/tile/yellow{
	dir = 4
	},
/obj/machinery/camera{
	c_tag = "Engineering Supermatter Starboard";
	dir = 8;
	network = list("ss13","engine")
	},
/turf/open/floor/plasteel/dark,
/area/engine/engineering)
"et" = (
/obj/effect/turf_decal/tile/yellow,
/obj/machinery/atmospherics/components/binary/pump/off/cyan{
	dir = 4
	},
/turf/open/floor/plasteel/dark,
/area/engine/engineering)
"eH" = (
/obj/effect/turf_decal/stripes/line{
	dir = 4
	},
/turf/open/floor/plasteel/dark,
/area/engine/engineering)
"eV" = (
/obj/effect/turf_decal/stripes/box,
/obj/machinery/atmospherics/pipe/multiz/general{
	dir = 1
	},
/turf/open/floor/plating,
/area/engine/engineering)
"fd" = (
/obj/effect/turf_decal/tile/yellow{
	dir = 8
	},
/obj/machinery/space_heater,
/obj/effect/turf_decal/stripes/line{
	dir = 5
	},
/turf/open/floor/plasteel/dark,
/area/engine/engineering)
"ff" = (
/obj/structure/lattice/catwalk,
/obj/machinery/atmospherics/pipe/heat_exchanging/simple{
	dir = 9
	},
/obj/machinery/atmospherics/pipe/heat_exchanging/simple{
	dir = 6
	},
/turf/template_noop,
/area/space/nearstation)
"fi" = (
/obj/structure/window/reinforced{
	dir = 1;
	layer = 2.9
	},
/turf/open/floor/plasteel/dark,
/area/engine/engineering)
"fm" = (
/obj/machinery/atmospherics/pipe/heat_exchanging/simple{
	dir = 6
	},
/obj/structure/lattice/catwalk,
/turf/template_noop,
/area/space/nearstation)
"fH" = (
/obj/machinery/camera{
	c_tag = "Engineering Supermatter Starboard";
	dir = 1;
	network = list("ss13","engine")
	},
/turf/open/floor/engine,
/area/engine/engineering)
"hm" = (
/obj/effect/turf_decal/tile/yellow{
	dir = 8
	},
/obj/machinery/space_heater,
/obj/effect/turf_decal/stripes/line{
	dir = 6
	},
/turf/open/floor/plasteel/dark,
/area/engine/engineering)
"hH" = (
/obj/machinery/atmospherics/pipe/heat_exchanging/simple{
	dir = 9
	},
/obj/structure/lattice/catwalk,
/turf/template_noop,
/area/space/nearstation)
"hV" = (
/obj/machinery/atmospherics/components/binary/pump{
	dir = 1
	},
/turf/closed/wall/r_wall,
/area/engine/engineering)
"ja" = (
/obj/machinery/portable_atmospherics/scrubber,
/obj/effect/turf_decal/box/white,
/turf/open/floor/plasteel/dark,
/area/engine/engineering)
"jN" = (
/obj/structure/closet/secure_closet/engineering_electrical,
/obj/effect/turf_decal/box/white,
/turf/open/floor/plasteel/dark,
/area/engine/engineering)
"jO" = (
/obj/structure/lattice/catwalk,
/obj/machinery/atmospherics/pipe/layer_manifold/general/visible,
/turf/template_noop,
/area/space/nearstation)
"lW" = (
/obj/machinery/atmospherics/pipe/heat_exchanging/simple{
	dir = 10
	},
/obj/structure/lattice,
/turf/template_noop,
/area/space/nearstation)
"ml" = (
/obj/machinery/atmospherics/pipe/smart/manifold4w/orange/visible,
/obj/machinery/meter,
/turf/open/floor/plasteel/dark,
/area/engine/engineering)
"mR" = (
/obj/machinery/portable_atmospherics/canister/carbon_dioxide,
/obj/effect/turf_decal/box/white,
/turf/open/floor/plasteel/dark,
/area/engine/engineering)
"pN" = (
/obj/effect/turf_decal/tile/yellow{
	dir = 8
	},
/obj/machinery/portable_atmospherics/scrubber,
/obj/effect/turf_decal/stripes/line{
	dir = 5
	},
/turf/open/floor/plasteel/dark,
/area/engine/engineering)
"qc" = (
/obj/effect/turf_decal/tile/yellow{
	dir = 8
	},
/obj/machinery/portable_atmospherics/pump,
/obj/effect/turf_decal/stripes/line{
	dir = 6
	},
/turf/open/floor/plasteel/dark,
/area/engine/engineering)
"qs" = (
/obj/machinery/light{
	dir = 8
	},
/obj/effect/turf_decal/stripes/line{
	dir = 1
	},
/obj/machinery/atmospherics/pipe/smart/manifold4w/cyan/visible{
	dir = 8
	},
/turf/open/floor/plasteel/dark,
/area/engine/engineering)
"qu" = (
/obj/effect/turf_decal/box/white,
/obj/machinery/space_heater,
/turf/open/floor/plasteel/dark,
/area/engine/engineering)
"qB" = (
/obj/effect/turf_decal/tile/yellow{
	dir = 4
	},
/obj/machinery/atmospherics/pipe/smart/manifold4w/orange/visible,
/obj/machinery/light{
	dir = 1;
	pixel_y = 0
	},
/turf/open/floor/plasteel/dark,
/area/engine/engineering)
"sm" = (
/obj/effect/turf_decal/stripes/corner{
	dir = 1
	},
/obj/effect/turf_decal/stripes/corner{
	dir = 8
	},
/turf/open/floor/plasteel/dark,
/area/engine/engineering)
"sz" = (
/obj/effect/turf_decal/stripes/corner{
	dir = 4
	},
/obj/effect/turf_decal/stripes/corner,
/turf/open/floor/plasteel/dark,
/area/engine/engineering)
"td" = (
/obj/effect/turf_decal/stripes/corner{
	dir = 4
	},
/turf/open/floor/plasteel/dark,
/area/engine/engineering)
"tB" = (
/obj/effect/spawner/structure/window/plasma/reinforced,
/turf/open/floor/plating,
/area/engine/engineering)
"tI" = (
/obj/effect/turf_decal/stripes/end{
	dir = 4
	},
/obj/machinery/atmospherics/components/binary/pump/off/cyan{
	dir = 1
	},
/turf/open/floor/plasteel/dark,
/area/engine/engineering)
"ur" = (
/obj/effect/turf_decal/stripes/corner{
	dir = 1
	},
/obj/machinery/atmospherics/pipe/smart/manifold4w/cyan/visible{
	dir = 8
	},
/turf/open/floor/plasteel/dark,
/area/engine/engineering)
"uH" = (
/obj/structure/lattice/catwalk,
/obj/machinery/atmospherics/pipe/heat_exchanging/junction,
/turf/template_noop,
/area/space/nearstation)
"vh" = (
/obj/effect/turf_decal/tile/yellow,
/obj/machinery/meter,
/obj/machinery/atmospherics/pipe/smart/manifold4w/cyan/visible,
/turf/open/floor/plasteel/dark,
/area/engine/engineering)
"xj" = (
/obj/effect/turf_decal/tile/yellow{
	dir = 8
	},
/obj/machinery/portable_atmospherics/pump,
/obj/effect/turf_decal/stripes/line{
	dir = 5
	},
/turf/open/floor/plasteel/dark,
/area/engine/engineering)
"xT" = (
/obj/effect/turf_decal/bot_white,
/obj/machinery/atmospherics/components/unary/thermomachine/freezer{
	dir = 1
	},
/turf/open/floor/plasteel/dark,
/area/engine/engineering)
"zr" = (
/obj/effect/turf_decal/loading_area/red{
	dir = 1
	},
/obj/machinery/atmospherics/pipe/smart/manifold4w/orange/visible{
	dir = 1
	},
/obj/machinery/meter,
/turf/open/floor/engine,
/area/engine/engineering)
"zJ" = (
/obj/machinery/atmospherics/pipe/heat_exchanging/simple{
	dir = 4
	},
/obj/structure/lattice,
/turf/template_noop,
/area/space/nearstation)
"BR" = (
/obj/machinery/atmospherics/pipe/heat_exchanging/simple{
	dir = 5
	},
/obj/structure/lattice,
/turf/template_noop,
/area/space/nearstation)
"BU" = (
/obj/effect/turf_decal/stripes/corner,
/turf/open/floor/plasteel/dark,
/area/engine/engineering)
"Cw" = (
/obj/effect/turf_decal/tile/yellow{
	dir = 4
	},
/obj/machinery/atmospherics/pipe/smart/manifold4w/cyan/visible,
/turf/open/floor/plasteel/dark,
/area/engine/engineering)
"Dl" = (
/obj/machinery/atmospherics/components/binary/pump,
/turf/closed/wall/r_wall,
/area/engine/engineering)
"Ep" = (
/obj/effect/turf_decal/tile/yellow,
/obj/machinery/atmospherics/pipe/smart/manifold4w/cyan/visible,
/turf/open/floor/plasteel/dark,
/area/engine/engineering)
"ET" = (
/obj/structure/table,
/obj/item/storage/toolbox/mechanical{
	pixel_x = -2;
	pixel_y = 11
	},
/obj/item/storage/toolbox/mechanical{
	pixel_x = -1;
	pixel_y = 4
	},
/obj/item/storage/toolbox/mechanical{
	pixel_x = -2;
	pixel_y = -1
	},
/turf/open/floor/plasteel/dark,
/area/engine/engineering)
"Fp" = (
/obj/machinery/light{
	dir = 1;
	pixel_y = 0
	},
/turf/open/floor/engine,
/area/engine/engineering)
"Gx" = (
/obj/effect/turf_decal/stripes/line{
	dir = 8
	},
/obj/machinery/atmospherics/pipe/smart/manifold4w/orange/visible,
/turf/open/floor/plasteel/dark,
/area/engine/engineering)
"GD" = (
/obj/machinery/atmospherics/components/unary/thermomachine/heater{
	dir = 1
	},
/obj/effect/turf_decal/bot_white,
/turf/open/floor/plasteel/dark,
/area/engine/engineering)
"GN" = (
/obj/machinery/atmospherics/pipe/heat_exchanging/simple,
/obj/machinery/atmospherics/pipe/heat_exchanging/simple{
	dir = 4
	},
/obj/structure/lattice,
/turf/template_noop,
/area/space/nearstation)
"GS" = (
/obj/effect/turf_decal/stripes/box,
/obj/machinery/atmospherics/pipe/multiz/general,
/turf/open/floor/plating,
/area/engine/engineering)
"Ha" = (
/obj/effect/turf_decal/tile/yellow{
	dir = 4
	},
/obj/machinery/atmospherics/components/binary/pump/off/cyan{
	dir = 1
	},
/turf/open/floor/plasteel/dark,
/area/engine/engineering)
"JF" = (
/obj/machinery/camera{
	c_tag = "Engineering Supermatter Fore";
	dir = 1;
	network = list("ss13","engine");
	pixel_x = 23
	},
/obj/effect/turf_decal/tile/yellow{
	dir = 8
	},
/obj/machinery/atmospherics/pipe/smart/manifold4w/cyan/visible,
/turf/open/floor/plasteel/dark,
/area/engine/engineering)
"Ln" = (
/obj/machinery/camera{
	c_tag = "Engineering Supermatter Fore";
	dir = 1;
	network = list("ss13","engine");
	pixel_x = 23
	},
/obj/effect/turf_decal/tile/yellow,
/obj/machinery/atmospherics/pipe/smart/manifold4w/cyan/visible,
/turf/open/floor/plasteel/dark,
/area/engine/engineering)
"Lq" = (
/obj/machinery/atmospherics/components/binary/pump/off/orange{
	dir = 8
	},
/turf/open/floor/plasteel/dark,
/area/engine/engineering)
"LD" = (
/obj/structure/lattice/catwalk,
/obj/machinery/atmospherics/pipe/heat_exchanging/simple{
	dir = 10
	},
/turf/template_noop,
/area/space/nearstation)
"LF" = (
/obj/structure/lattice/catwalk,
/turf/template_noop,
/area/space/nearstation)
"Mc" = (
/obj/machinery/atmospherics/components/binary/pump/off/orange,
/turf/open/floor/plasteel/dark,
/area/engine/engineering)
"MU" = (
/obj/effect/spawner/structure/window/reinforced,
/obj/machinery/atmospherics/pipe/smart/manifold4w/cyan/visible{
	dir = 8
	},
/turf/open/floor/plating,
/area/engine/engineering)
"Qp" = (
/obj/structure/table,
/obj/item/stack/sheet/plasteel/twenty,
/turf/open/floor/plasteel/dark,
/area/engine/engineering)
"Rg" = (
/obj/structure/table,
/obj/item/holosign_creator/atmos{
	pixel_x = -1;
	pixel_y = -14
	},
/obj/item/stack/sheet/glass/fifty{
	pixel_x = 3;
	pixel_y = 3
	},
/obj/item/stack/sheet/glass/fifty,
/turf/open/floor/plasteel/dark,
/area/engine/engineering)
"Tf" = (
/obj/machinery/portable_atmospherics/pump,
/obj/effect/turf_decal/box/white,
/turf/open/floor/plasteel/dark,
/area/engine/engineering)
"TQ" = (
/obj/structure/lattice/catwalk,
/obj/machinery/atmospherics/pipe/heat_exchanging/simple{
	dir = 6
	},
/turf/template_noop,
/area/space/nearstation)
"Um" = (
/obj/machinery/light{
	pixel_y = 0
	},
/obj/machinery/atmospherics/pipe/smart/manifold4w/cyan/visible,
/turf/open/floor/plasteel/dark,
/area/engine/engineering)
"Us" = (
/obj/machinery/light{
	dir = 4
	},
/obj/effect/turf_decal/stripes/line{
	dir = 1
	},
/obj/machinery/atmospherics/pipe/smart/manifold4w/cyan/visible,
/turf/open/floor/plasteel/dark,
/area/engine/engineering)
"Uv" = (
/obj/effect/turf_decal/box/red,
/obj/machinery/light{
	pixel_y = 0
	},
/obj/machinery/atmospherics/components/binary/pump{
	dir = 4;
	name = "Cooling Loop Bypass"
	},
/turf/open/floor/plasteel,
/area/engine/engineering)
"Wm" = (
/obj/effect/turf_decal/stripes/corner{
	dir = 8
	},
/turf/open/floor/plasteel/dark,
/area/engine/engineering)
"Xm" = (
/obj/structure/table,
/obj/item/pipe_dispenser{
	pixel_y = 6
	},
/obj/item/pipe_dispenser,
/obj/item/pipe_dispenser{
	pixel_y = -6
	},
/turf/open/floor/plasteel/dark,
/area/engine/engineering)
"Yl" = (
/obj/structure/lattice/catwalk,
/obj/machinery/atmospherics/pipe/heat_exchanging/simple{
	dir = 4
	},
/turf/template_noop,
/area/space/nearstation)
"YR" = (
/obj/structure/table,
/obj/item/stack/sheet/metal/fifty{
	pixel_x = 2;
	pixel_y = 2
	},
/obj/item/stack/sheet/metal/fifty{
	pixel_x = -5;
	pixel_y = 2
	},
/turf/open/floor/plasteel/dark,
/area/engine/engineering)
"ZI" = (
/obj/effect/turf_decal/stripes/end{
	dir = 8
	},
/obj/machinery/atmospherics/components/binary/pump/off/orange{
	dir = 1
	},
/turf/open/floor/plasteel/dark,
/area/engine/engineering)

(1,1,1) = {"
ab
bb
bb
bb
bb
bb
bb
bb
bb
bb
bb
bb
bb
bb
bb
bb
bb
bb
bb
bb
bb
bb
ab
ab
ab
ab
"}
(2,1,1) = {"
ab
fm
be
fm
ci
fm
ci
fm
ci
fm
ci
fm
ci
fm
ci
fm
ci
fm
ci
fm
ci
LF
ab
ab
ab
ab
"}
(3,1,1) = {"
ab
LD
ec
GN
GN
GN
GN
GN
GN
GN
GN
GN
GN
GN
GN
GN
GN
GN
GN
GN
GN
ci
ab
ab
ab
ab
"}
(4,1,1) = {"
ab
TQ
ec
GN
GN
GN
GN
GN
GN
GN
GN
GN
GN
GN
GN
GN
GN
GN
GN
GN
GN
hH
ab
ab
ab
ab
"}
(5,1,1) = {"
ab
LD
ec
GN
GN
GN
GN
GN
GN
GN
GN
GN
GN
GN
GN
GN
GN
GN
GN
GN
GN
ci
ab
ab
ab
ab
"}
(6,1,1) = {"
ab
TQ
ec
GN
GN
GN
GN
GN
GN
GN
GN
GN
GN
GN
GN
GN
GN
GN
GN
GN
GN
hH
ab
ab
ab
ab
"}
(7,1,1) = {"
ab
LD
ec
GN
GN
GN
GN
GN
GN
GN
GN
GN
GN
GN
GN
GN
GN
GN
GN
GN
GN
ci
ab
ab
ab
ab
"}
(8,1,1) = {"
ab
TQ
ec
GN
GN
GN
GN
GN
GN
GN
GN
GN
GN
GN
GN
GN
GN
GN
GN
GN
GN
hH
ab
ab
ab
ab
"}
(9,1,1) = {"
ab
LD
ec
GN
GN
GN
GN
GN
GN
GN
GN
GN
GN
GN
GN
GN
GN
GN
GN
GN
GN
ci
ab
ab
ab
ab
"}
(10,1,1) = {"
ab
TQ
ec
GN
GN
GN
GN
GN
GN
GN
GN
GN
GN
GN
GN
GN
GN
GN
GN
GN
GN
hH
ab
ab
ab
ab
"}
(11,1,1) = {"
bb
LD
bc
GN
GN
GN
GN
GN
GN
GN
GN
GN
GN
GN
GN
GN
GN
GN
GN
GN
GN
ci
ab
ab
ab
ab
"}
(12,1,1) = {"
ab
LF
LD
bt
LD
bt
LD
bt
LD
bt
LD
bt
LD
bt
LD
ff
GN
GN
GN
GN
GN
hH
ab
ab
ab
ab
"}
(13,1,1) = {"
ab
ad
ad
tB
ad
ad
ad
tB
tB
tB
ad
ad
ad
ad
bb
LD
GN
GN
GN
GN
GN
ci
ab
ab
ab
ab
"}
(14,1,1) = {"
ad
ad
eg
xj
qc
dt
fd
hm
eg
pN
cM
bE
eg
ad
bb
TQ
GN
GN
GN
GN
GN
hH
ab
ab
ab
ab
"}
(15,1,1) = {"
ad
as
bN
bN
bN
bN
bN
bN
bN
bN
bN
bN
eg
ad
bb
LD
GN
GN
GN
GN
GN
ci
ab
ab
ab
ab
"}
(16,1,1) = {"
ad
aH
fi
bN
bN
Tf
qu
bN
ja
jN
bN
bN
eg
tB
bb
TQ
GN
GN
GN
GN
GN
hH
ab
ab
ab
ab
"}
(17,1,1) = {"
ad
aH
fi
bN
bN
Tf
qu
bN
ja
ET
bN
bN
eg
tB
bb
LD
GN
GN
GN
GN
GN
ci
ab
ab
ab
ab
"}
(18,1,1) = {"
ad
aK
bN
cY
cY
cY
cY
cY
cY
cY
cY
cY
JF
ad
bb
TQ
GN
GN
GN
GN
GN
hH
ab
ab
ab
ab
"}
(19,1,1) = {"
ag
aL
BU
ch
eH
eH
sz
eH
eH
eH
td
bN
Um
ad
bb
LD
GN
GN
GN
GN
GN
ci
ab
ab
ab
ab
"}
(20,1,1) = {"
ao
aM
cL
cy
cw
cD
tI
cD
cw
cy
Us
bN
cY
tB
bb
TQ
GN
GN
GN
GN
GN
hH
ab
ab
ab
ab
"}
(21,1,1) = {"
ar
aO
bv
do
dZ
cH
bv
Fp
dZ
fH
MU
bN
cY
tB
bb
LD
GN
GN
GN
GN
GN
ci
ab
ab
ab
ab
"}
(22,1,1) = {"
ad
aP
cX
by
cB
cZ
ZI
cZ
cB
zr
qs
bN
cY
tB
bb
TQ
GN
GN
GN
GN
GN
hH
ab
ab
ab
ab
"}
(23,1,1) = {"
ad
aQ
Wm
cC
dd
dd
sm
dd
Gx
dx
ur
bN
Um
ad
bb
LD
GN
GN
GN
GN
GN
ci
ab
ab
ab
ab
"}
(24,1,1) = {"
ad
aU
bN
bI
bN
bN
bN
bN
bI
GD
cY
xT
Ln
ad
bb
TQ
GN
GN
GN
GN
GN
hH
ab
ab
ab
ab
"}
(25,1,1) = {"
ad
aW
fi
bI
jN
Xm
bN
bN
bI
bN
cY
bN
Ep
tB
bb
LD
GN
GN
GN
GN
GN
ci
ab
ab
ab
ab
"}
(26,1,1) = {"
ad
aW
fi
bI
YR
Rg
bN
bN
ml
GD
cY
xT
vh
tB
bb
TQ
GN
GN
GN
GN
GN
hH
ab
ab
ab
ab
"}
(27,1,1) = {"
ad
ba
er
dp
Qp
mR
bN
bN
Lq
bN
cY
bN
et
ad
bb
LD
GN
GN
GN
GN
GN
ci
ab
ab
ab
ab
"}
(28,1,1) = {"
ad
ad
ad
qB
mR
mR
bN
bN
ml
eV
cY
GS
vh
Dl
jO
uH
GN
GN
GN
GN
GN
hH
ab
ab
ab
ab
"}
(29,1,1) = {"
ad
bb
ad
dp
bN
bN
bN
bN
bN
bN
cY
bN
Uv
ad
bb
LF
zJ
zJ
zJ
zJ
lW
be
ab
ab
ab
ab
"}
(30,1,1) = {"
bv
bb
ad
dp
bI
bI
ml
Mc
ml
eV
cY
GS
vh
hV
jO
uH
GN
GN
GN
GN
BR
Yl
ab
ab
ab
ab
"}
(31,1,1) = {"
ad
bb
ad
bJ
bA
bJ
bJ
er
bJ
bA
Cw
Ha
cY
ad
bb
LF
LD
bt
LD
bt
LD
bt
ab
ab
ab
ab
"}
(32,1,1) = {"
ad
bb
ad
ad
ad
ad
ad
ad
ad
ad
ad
ad
ad
ad
bb
bb
bb
bb
bb
bb
bb
bb
ab
ab
ab
ab
"}
