//MAP CONVERTED BY dmm2tgm.py THIS HEADER COMMENT PREVENTS RECONVERSION, DO NOT REMOVE
"ab" = (
/turf/template_noop,
/area/template_noop)
"cA" = (
/turf/closed/wall/r_wall,
/area/engine/engineering)
"tB" = (
/obj/structure/lattice,
/turf/template_noop,
/area/space/nearstation)
"FH" = (
/turf/template_noop,
/area/space/nearstation)

(1,1,1) = {"
ab
ab
ab
ab
ab
ab
FH
ab
ab
ab
ab
ab
FH
ab
ab
ab
ab
ab
ab
ab
FH
ab
ab
ab
ab
ab
"}
(2,1,1) = {"
ab
ab
ab
ab
ab
ab
tB
ab
ab
ab
ab
ab
tB
ab
ab
ab
ab
ab
ab
ab
tB
ab
ab
ab
ab
ab
"}
(3,1,1) = {"
ab
ab
ab
ab
ab
ab
tB
ab
ab
ab
ab
ab
tB
ab
ab
ab
ab
ab
ab
ab
tB
ab
ab
ab
ab
ab
"}
(4,1,1) = {"
ab
ab
ab
ab
ab
ab
tB
ab
ab
ab
ab
ab
tB
ab
ab
ab
ab
ab
ab
ab
tB
ab
ab
ab
ab
ab
"}
(5,1,1) = {"
tB
tB
tB
tB
tB
tB
tB
tB
tB
tB
tB
tB
tB
tB
tB
tB
tB
tB
tB
tB
tB
tB
FH
FH
FH
FH
"}
(6,1,1) = {"
ab
ab
ab
ab
ab
ab
tB
ab
ab
ab
ab
ab
tB
ab
ab
ab
ab
ab
ab
ab
tB
ab
ab
ab
FH
ab
"}
(7,1,1) = {"
ab
ab
ab
ab
ab
ab
tB
ab
ab
ab
ab
ab
tB
ab
ab
ab
ab
ab
ab
ab
tB
ab
ab
ab
FH
ab
"}
(8,1,1) = {"
ab
ab
ab
ab
ab
ab
tB
ab
ab
ab
ab
ab
tB
ab
ab
ab
ab
ab
ab
ab
tB
ab
ab
ab
FH
ab
"}
(9,1,1) = {"
ab
ab
ab
ab
ab
ab
tB
ab
ab
ab
ab
ab
tB
ab
ab
ab
ab
ab
ab
ab
tB
ab
ab
ab
FH
ab
"}
(10,1,1) = {"
tB
tB
tB
tB
tB
tB
tB
tB
tB
tB
tB
tB
tB
tB
tB
tB
tB
tB
tB
tB
tB
tB
FH
FH
FH
FH
"}
(11,1,1) = {"
cA
ab
ab
ab
ab
ab
tB
ab
ab
tB
ab
ab
tB
ab
ab
ab
ab
tB
ab
ab
tB
ab
ab
ab
FH
ab
"}
(12,1,1) = {"
cA
ab
ab
ab
ab
ab
tB
ab
ab
tB
ab
ab
tB
ab
ab
ab
ab
tB
ab
ab
tB
ab
ab
ab
FH
ab
"}
(13,1,1) = {"
cA
ab
ab
ab
ab
ab
tB
ab
ab
tB
ab
ab
tB
ab
ab
ab
ab
tB
ab
ab
tB
ab
ab
ab
FH
ab
"}
(14,1,1) = {"
cA
ab
ab
ab
ab
ab
tB
ab
ab
tB
ab
ab
tB
ab
ab
ab
ab
tB
ab
ab
tB
ab
ab
ab
FH
ab
"}
(15,1,1) = {"
cA
ab
ab
ab
ab
ab
tB
ab
ab
tB
ab
ab
tB
ab
ab
ab
ab
tB
ab
ab
tB
ab
ab
ab
FH
ab
"}
(16,1,1) = {"
cA
ab
ab
ab
ab
ab
tB
ab
ab
tB
ab
ab
tB
ab
ab
ab
ab
tB
ab
ab
tB
tB
FH
FH
FH
FH
"}
(17,1,1) = {"
cA
tB
tB
tB
tB
tB
tB
tB
tB
tB
tB
tB
tB
tB
tB
tB
tB
tB
tB
tB
tB
ab
ab
ab
FH
ab
"}
(18,1,1) = {"
cA
ab
ab
ab
ab
ab
tB
ab
ab
tB
ab
ab
ab
ab
tB
ab
ab
tB
ab
ab
tB
ab
ab
ab
FH
ab
"}
(19,1,1) = {"
cA
ab
ab
ab
ab
ab
tB
ab
ab
tB
ab
ab
ab
ab
tB
ab
ab
tB
ab
ab
tB
tB
FH
FH
FH
FH
"}
(20,1,1) = {"
cA
ab
ab
ab
ab
ab
tB
ab
ab
tB
tB
tB
tB
tB
tB
ab
ab
tB
ab
ab
tB
ab
ab
ab
FH
ab
"}
(21,1,1) = {"
cA
ab
ab
ab
ab
ab
tB
ab
ab
tB
ab
ab
tB
ab
tB
ab
ab
tB
ab
ab
tB
ab
ab
ab
FH
ab
"}
(22,1,1) = {"
cA
ab
ab
ab
ab
ab
tB
ab
ab
tB
ab
ab
tB
tB
tB
tB
tB
tB
ab
ab
tB
ab
ab
ab
FH
ab
"}
(23,1,1) = {"
cA
ab
ab
ab
ab
ab
tB
ab
ab
tB
ab
ab
tB
ab
ab
ab
ab
tB
ab
ab
tB
FH
FH
FH
FH
FH
"}
(24,1,1) = {"
cA
ab
ab
ab
ab
ab
tB
ab
ab
tB
ab
ab
tB
ab
ab
ab
ab
tB
ab
ab
tB
ab
ab
ab
FH
ab
"}
(25,1,1) = {"
cA
tB
tB
tB
tB
tB
tB
tB
tB
tB
tB
tB
tB
tB
tB
tB
tB
tB
tB
tB
tB
ab
ab
ab
FH
ab
"}
(26,1,1) = {"
cA
ab
ab
ab
ab
ab
tB
ab
ab
tB
ab
ab
tB
ab
ab
ab
ab
tB
ab
ab
tB
FH
FH
FH
FH
FH
"}
(27,1,1) = {"
cA
ab
ab
ab
ab
ab
tB
ab
ab
tB
ab
ab
tB
ab
ab
ab
ab
tB
ab
ab
tB
ab
ab
ab
FH
ab
"}
(28,1,1) = {"
cA
ab
ab
ab
ab
ab
tB
ab
ab
tB
ab
ab
tB
ab
ab
ab
ab
tB
ab
ab
tB
ab
ab
ab
FH
ab
"}
(29,1,1) = {"
cA
ab
ab
ab
ab
ab
tB
ab
ab
tB
ab
ab
tB
ab
ab
ab
ab
tB
ab
ab
tB
ab
ab
ab
FH
ab
"}
(30,1,1) = {"
cA
ab
ab
ab
ab
ab
tB
ab
ab
tB
ab
ab
tB
ab
ab
ab
ab
tB
ab
ab
tB
ab
ab
ab
FH
ab
"}
(31,1,1) = {"
ab
tB
tB
tB
tB
tB
tB
tB
tB
tB
tB
tB
tB
tB
tB
tB
tB
tB
tB
tB
tB
FH
FH
FH
FH
FH
"}
(32,1,1) = {"
ab
ab
ab
ab
ab
ab
tB
ab
ab
ab
ab
ab
tB
ab
ab
ab
ab
ab
ab
ab
tB
ab
ab
ab
FH
ab
"}
