//MAP CONVERTED BY dmm2tgm.py THIS HEADER COMMENT PREVENTS RECONVERSION, DO NOT REMOVE
"a" = (
/turf/template_noop,
/area/template_noop)
"b" = (
/obj/structure/closet/radiation,
/turf/open/floor/plasteel,
/area/engine/engineering)
"c" = (
/obj/machinery/atmospherics/pipe/smart/manifold4w/supply/hidden/layer4,
/obj/machinery/atmospherics/pipe/smart/manifold4w/scrubbers/hidden/layer4,
/turf/open/floor/plasteel,
/area/engine/engineering)
"d" = (
/obj/structure/table,
/obj/item/clothing/gloves/color/yellow,
/obj/item/storage/toolbox/electrical{
	pixel_y = 5
	},
/turf/open/floor/plasteel,
/area/engine/engineering)
"f" = (
/obj/machinery/atmospherics/pipe/smart/manifold4w/scrubbers/hidden/layer4{
	dir = 5
	},
/turf/open/floor/plasteel,
/area/engine/engineering)
"l" = (
/obj/structure/cable,
/obj/machinery/atmospherics/pipe/smart/manifold4w/supply/hidden/layer4,
/obj/machinery/atmospherics/pipe/smart/manifold4w/scrubbers/hidden/layer4,
/turf/open/floor/plasteel,
/area/engine/engineering)
"n" = (
/obj/structure/lattice/catwalk,
/turf/template_noop,
/area/space/nearstation)
"p" = (
/obj/machinery/atmospherics/pipe/smart/manifold4w/orange/visible{
	dir = 4
	},
/turf/open/floor/plasteel,
/area/engine/engineering)
"q" = (
/obj/effect/mapping_helpers/airlock/cyclelink_helper,
/obj/machinery/door/airlock/external{
	name = "Engineering External Access";
	req_access_txt = "10;13"
	},
/turf/open/floor/plating,
/area/engine/engineering)
"r" = (
/obj/machinery/door/firedoor,
/obj/machinery/door/airlock/engineering/glass{
	name = "Supermatter Engine Room";
	req_access_txt = "10"
	},
/obj/structure/cable,
/turf/open/floor/engine,
/area/engine/engineering)
"u" = (
/obj/machinery/door/firedoor,
/obj/machinery/door/airlock/engineering/glass{
	name = "Supermatter Engine Room";
	req_access_txt = "10"
	},
/obj/machinery/atmospherics/pipe/smart/manifold4w/scrubbers/hidden/layer4,
/obj/machinery/atmospherics/pipe/smart/manifold4w/supply/hidden/layer4,
/turf/open/floor/engine,
/area/engine/engineering)
"v" = (
/obj/structure/table,
/obj/item/storage/toolbox/mechanical{
	pixel_y = 5
	},
/obj/item/flashlight{
	pixel_x = 1;
	pixel_y = 5
	},
/obj/item/flashlight{
	pixel_x = 1;
	pixel_y = 5
	},
/turf/open/floor/plasteel,
/area/engine/engineering)
"w" = (
/obj/machinery/atmospherics/pipe/smart/manifold4w/orange/visible{
	dir = 10
	},
/turf/open/floor/plasteel,
/area/engine/engineering)
"x" = (
/obj/structure/cable,
/obj/machinery/atmospherics/pipe/smart/manifold4w/supply/hidden/layer4{
	dir = 4
	},
/obj/machinery/atmospherics/pipe/smart/manifold4w/scrubbers/hidden/layer4{
	dir = 8
	},
/turf/open/floor/plasteel,
/area/engine/engineering)
"y" = (
/obj/effect/turf_decal/stripes/box,
/obj/structure/ladder,
/turf/open/floor/plating,
/area/space/nearstation)
"z" = (
/obj/structure/cable,
/obj/machinery/atmospherics/pipe/smart/manifold4w/supply/hidden/layer4,
/obj/machinery/atmospherics/pipe/smart/manifold4w/scrubbers/hidden/layer2,
/turf/open/floor/plasteel,
/area/engine/engineering)
"B" = (
/obj/machinery/door/firedoor,
/obj/machinery/door/airlock/engineering/glass{
	name = "Supermatter Engine Room";
	req_access_txt = "10"
	},
/obj/machinery/atmospherics/pipe/smart/manifold4w/supply/hidden/layer4,
/obj/machinery/atmospherics/pipe/smart/manifold4w/scrubbers/hidden/layer4,
/turf/open/floor/plasteel/dark,
/area/engine/engineering)
"D" = (
/turf/closed/wall,
/area/engine/engineering)
"E" = (
/obj/structure/rack,
/obj/item/clothing/mask/gas{
	pixel_x = 3;
	pixel_y = 3
	},
/obj/item/clothing/mask/gas,
/obj/item/clothing/mask/gas{
	pixel_x = -3;
	pixel_y = -3
	},
/turf/open/floor/plasteel,
/area/engine/engineering)
"G" = (
/turf/closed/wall/r_wall,
/area/engine/engineering)
"H" = (
/obj/machinery/light/small{
	dir = 8
	},
/turf/open/floor/plating,
/area/engine/engineering)
"I" = (
/obj/effect/mapping_helpers/airlock/cyclelink_helper{
	dir = 1
	},
/obj/machinery/door/airlock/external{
	name = "Engineering External Access";
	req_access_txt = "10;13"
	},
/obj/structure/fans/tiny,
/turf/open/floor/plating,
/area/engine/engineering)
"J" = (
/obj/effect/spawner/structure/window/plasma/reinforced,
/turf/open/floor/plating,
/area/engine/engineering)
"K" = (
/turf/open/space/basic,
/area/engine/engineering)
"N" = (
/obj/effect/spawner/structure/window/plasma/reinforced,
/obj/machinery/atmospherics/pipe/smart/manifold4w/orange/visible{
	dir = 4
	},
/turf/open/floor/plating,
/area/engine/engineering)
"O" = (
/obj/machinery/atmospherics/pipe/smart/manifold4w/orange/visible{
	dir = 5
	},
/turf/open/floor/plasteel,
/area/engine/engineering)
"P" = (
/obj/machinery/meter,
/obj/machinery/atmospherics/pipe/smart/manifold4w/orange/visible{
	dir = 4
	},
/obj/machinery/atmospherics/pipe/smart/manifold4w/supply/hidden/layer4,
/obj/machinery/atmospherics/pipe/smart/manifold4w/scrubbers/hidden/layer4,
/turf/open/floor/plasteel,
/area/engine/engineering)
"R" = (
/obj/machinery/door/firedoor,
/obj/machinery/door/airlock/engineering/glass{
	name = "Supermatter Engine Room";
	req_access_txt = "10"
	},
/obj/machinery/atmospherics/pipe/smart/manifold4w/supply/hidden/layer4{
	dir = 4
	},
/obj/machinery/atmospherics/pipe/smart/manifold4w/scrubbers/hidden/layer4{
	dir = 4
	},
/obj/structure/cable,
/obj/effect/turf_decal/stripes/end{
	dir = 4
	},
/turf/open/floor/engine,
/area/engine/engineering)
"V" = (
/obj/machinery/door/firedoor,
/obj/machinery/door/airlock/engineering/glass{
	name = "Supermatter Engine Room";
	req_access_txt = "10"
	},
/obj/machinery/atmospherics/pipe/smart/manifold4w/scrubbers/hidden/layer4{
	dir = 4
	},
/obj/effect/turf_decal/stripes/end{
	dir = 8
	},
/turf/open/floor/engine,
/area/engine/engineering)
"X" = (
/turf/open/floor/plasteel,
/area/engine/engineering)
"Z" = (
/obj/structure/cable,
/obj/machinery/atmospherics/pipe/smart/manifold4w/supply/hidden/layer4{
	dir = 1
	},
/obj/machinery/atmospherics/pipe/smart/manifold4w/scrubbers/hidden/layer2{
	dir = 1
	},
/turf/open/floor/plasteel,
/area/engine/engineering)

(1,1,1) = {"
a
a
a
a
a
a
a
a
a
a
a
a
a
a
a
a
a
a
a
a
a
a
a
a
a
a
"}
(2,1,1) = {"
a
a
a
a
a
a
a
G
G
a
a
a
a
a
a
a
a
a
a
a
a
a
a
a
a
a
"}
(3,1,1) = {"
a
a
a
a
a
a
a
G
a
a
a
a
a
a
a
a
a
a
a
a
a
a
a
a
a
a
"}
(4,1,1) = {"
a
a
a
a
a
a
a
n
a
a
a
a
a
a
a
a
a
a
a
a
a
a
a
a
a
a
"}
(5,1,1) = {"
a
a
a
a
a
a
a
n
a
a
a
a
a
a
a
a
a
a
a
a
a
a
a
a
a
a
"}
(6,1,1) = {"
a
a
a
a
a
a
a
n
a
a
a
a
a
a
a
a
a
a
a
a
a
a
a
a
a
a
"}
(7,1,1) = {"
a
a
a
a
a
a
a
n
a
a
a
a
a
a
a
a
a
a
a
a
a
a
a
a
a
a
"}
(8,1,1) = {"
a
a
a
a
a
a
a
n
a
a
a
a
a
a
a
a
a
a
a
a
a
a
a
a
a
a
"}
(9,1,1) = {"
a
a
a
a
a
a
a
n
a
a
a
a
a
a
a
a
a
a
a
a
a
a
a
a
a
a
"}
(10,1,1) = {"
a
a
a
a
D
D
G
n
a
a
a
a
a
a
a
a
a
a
a
a
a
a
a
a
a
a
"}
(11,1,1) = {"
a
a
d
v
D
D
G
n
a
a
a
a
a
a
a
a
a
a
a
a
a
a
a
a
a
a
"}
(12,1,1) = {"
a
a
f
X
q
H
I
n
y
n
n
n
n
n
n
a
a
a
a
a
a
a
a
a
a
a
"}
(13,1,1) = {"
a
J
V
J
G
G
G
J
J
J
J
J
J
G
a
a
a
a
a
a
a
a
a
a
a
a
"}
(14,1,1) = {"
J
J
K
K
K
K
K
K
K
K
K
K
K
G
a
a
a
a
a
a
a
a
a
a
a
a
"}
(15,1,1) = {"
G
K
K
K
K
K
K
K
K
K
K
K
K
G
a
a
a
a
a
a
a
a
a
a
a
a
"}
(16,1,1) = {"
J
K
K
K
K
K
K
K
K
K
K
K
K
G
a
a
a
a
a
a
a
a
a
a
a
a
"}
(17,1,1) = {"
J
K
K
K
K
K
K
K
K
K
K
K
K
G
a
a
a
a
a
a
a
a
a
a
a
a
"}
(18,1,1) = {"
G
K
K
K
K
K
K
K
K
K
K
K
K
G
a
a
a
a
a
a
a
a
a
a
a
a
"}
(19,1,1) = {"
G
K
K
K
K
K
K
K
K
K
K
K
K
G
a
a
a
a
a
a
a
a
a
a
a
a
"}
(20,1,1) = {"
r
K
K
K
K
K
K
K
K
K
K
K
K
G
a
a
a
a
a
a
a
a
a
a
a
a
"}
(21,1,1) = {"
J
K
K
K
K
K
K
K
K
K
K
K
K
G
a
a
a
a
a
a
a
a
a
a
a
a
"}
(22,1,1) = {"
u
K
K
K
K
K
K
K
K
K
K
K
K
G
a
a
a
a
a
a
a
a
a
a
a
a
"}
(23,1,1) = {"
G
K
K
K
K
K
K
K
K
K
K
K
K
G
a
a
a
a
a
a
a
a
a
a
a
a
"}
(24,1,1) = {"
G
K
K
K
K
K
K
K
K
K
K
K
K
G
a
a
a
a
a
a
a
a
a
a
a
a
"}
(25,1,1) = {"
J
K
K
K
K
K
K
K
K
K
K
K
K
G
a
a
a
a
a
a
a
a
a
a
a
a
"}
(26,1,1) = {"
J
K
K
K
K
K
K
K
K
K
K
K
K
G
a
a
a
a
a
a
a
a
a
a
a
a
"}
(27,1,1) = {"
G
K
K
K
K
K
K
K
K
K
K
K
K
G
a
a
a
a
a
a
a
a
a
a
a
a
"}
(28,1,1) = {"
J
J
K
K
K
K
K
K
K
K
K
K
K
G
a
a
a
a
a
a
a
a
a
a
a
a
"}
(29,1,1) = {"
b
J
R
N
G
G
G
K
K
K
K
K
K
J
a
a
a
a
a
a
a
a
a
a
a
a
"}
(30,1,1) = {"
a
l
z
p
E
J
K
K
K
K
K
K
K
G
a
a
a
a
a
a
a
a
a
a
a
a
"}
(31,1,1) = {"
a
X
Z
P
c
B
K
K
K
K
K
K
K
G
a
a
a
a
a
a
a
a
a
a
a
a
"}
(32,1,1) = {"
a
X
x
w
O
G
G
G
G
G
J
J
J
G
a
a
a
a
a
a
a
a
a
a
a
a
"}
