//MAP CONVERTED BY dmm2tgm.py THIS HEADER COMMENT PREVENTS RECONVERSION, DO NOT REMOVE
"ab" = (
/turf/template_noop,
/area/template_noop)
"ad" = (
/turf/closed/wall/r_wall,
/area/engine/engineering)
"ag" = (
/obj/structure/sign/warning/fire,
/turf/closed/wall/r_wall,
/area/engine/engineering)
"ao" = (
/obj/machinery/door/airlock/maintenance{
	name = "Engineering Maintenance";
	req_access_txt = "10"
	},
/obj/machinery/door/firedoor/border_only,
/obj/machinery/door/firedoor/border_only{
	dir = 1
	},
/turf/open/floor/plating,
/area/engine/engineering)
"ar" = (
/obj/structure/sign/warning/hottemp,
/turf/closed/wall/r_wall,
/area/engine/engineering)
"as" = (
/obj/machinery/airalarm{
	dir = 4;
	pixel_x = -23
	},
/obj/machinery/camera{
	c_tag = "Engineering Supermatter Port";
	dir = 4;
	network = list("ss13","engine")
	},
/obj/effect/turf_decal/tile/yellow{
	dir = 1
	},
/obj/machinery/light{
	dir = 1;
	pixel_y = 0
	},
/turf/open/floor/plasteel/dark,
/area/engine/engineering)
"aw" = (
/obj/machinery/atmospherics/components/binary/pump{
	dir = 4
	},
/turf/closed/wall/r_wall,
/area/engine/supermatter)
"aF" = (
/obj/structure/stairs/east,
/obj/structure/railing,
/obj/effect/turf_decal/tile/yellow{
	dir = 1
	},
/turf/open/floor/plasteel/dark,
/area/engine/engineering)
"aH" = (
/obj/structure/stairs/east,
/obj/structure/railing{
	dir = 6
	},
/obj/effect/turf_decal/tile/yellow{
	dir = 1
	},
/turf/open/floor/plasteel/dark,
/area/engine/engineering)
"aK" = (
/obj/structure/table/reinforced,
/obj/item/storage/toolbox/mechanical,
/obj/item/flashlight,
/obj/item/pipe_dispenser,
/obj/effect/turf_decal/tile/yellow{
	dir = 1
	},
/turf/open/floor/plasteel/dark,
/area/engine/engineering)
"aL" = (
/obj/structure/table/reinforced,
/obj/item/tank/internals/emergency_oxygen/engi{
	pixel_x = 5
	},
/obj/item/clothing/gloves/color/black,
/obj/item/clothing/glasses/meson/engine,
/obj/effect/turf_decal/tile/yellow{
	dir = 1
	},
/obj/machinery/light{
	dir = 1;
	pixel_y = 0
	},
/turf/open/floor/plasteel/dark,
/area/engine/engineering)
"aM" = (
/obj/effect/turf_decal/stripes/line{
	dir = 1
	},
/obj/effect/turf_decal/tile/yellow{
	dir = 4
	},
/obj/effect/turf_decal/tile/yellow{
	dir = 1
	},
/turf/open/floor/plasteel/dark,
/area/engine/engineering)
"aO" = (
/obj/effect/turf_decal/stripes/box,
/obj/structure/cable/multilayer/multiz,
/obj/effect/turf_decal/tile/yellow{
	dir = 4
	},
/obj/effect/turf_decal/tile/yellow{
	dir = 1
	},
/turf/open/floor/plasteel/dark,
/area/engine/engineering)
"aP" = (
/obj/machinery/camera{
	c_tag = "Engineering Supermatter Aft";
	network = list("ss13","engine");
	pixel_x = 23
	},
/obj/effect/turf_decal/tile/yellow{
	dir = 4
	},
/obj/effect/turf_decal/tile/yellow{
	dir = 1
	},
/obj/machinery/light{
	dir = 1;
	pixel_y = 0
	},
/turf/open/floor/plasteel/dark,
/area/engine/engineering)
"aQ" = (
/obj/structure/table/reinforced,
/obj/item/clothing/suit/radiation,
/obj/item/clothing/head/radiation,
/obj/item/clothing/glasses/meson,
/obj/item/geiger_counter,
/obj/item/geiger_counter,
/obj/effect/turf_decal/tile/yellow{
	dir = 4
	},
/turf/open/floor/plasteel/dark,
/area/engine/engineering)
"aU" = (
/obj/structure/table/reinforced,
/obj/item/clothing/suit/radiation,
/obj/item/clothing/head/radiation,
/obj/item/clothing/glasses/meson,
/obj/item/clothing/glasses/meson,
/obj/effect/turf_decal/tile/yellow{
	dir = 4
	},
/turf/open/floor/plasteel/dark,
/area/engine/engineering)
"aV" = (
/obj/structure/stairs/west,
/obj/structure/railing{
	dir = 10
	},
/obj/effect/turf_decal/tile/yellow{
	dir = 4
	},
/turf/open/floor/plasteel/dark,
/area/engine/engineering)
"aW" = (
/obj/structure/stairs/west,
/obj/structure/railing,
/obj/effect/turf_decal/tile/yellow{
	dir = 4
	},
/turf/open/floor/plasteel/dark,
/area/engine/engineering)
"ba" = (
/obj/effect/turf_decal/tile/yellow{
	dir = 4
	},
/obj/machinery/light{
	dir = 1;
	pixel_y = 0
	},
/turf/open/floor/plasteel/dark,
/area/engine/engineering)
"bb" = (
/obj/structure/lattice,
/turf/template_noop,
/area/space/nearstation)
"bc" = (
/obj/machinery/atmospherics/pipe/heat_exchanging/simple{
	dir = 4
	},
/obj/structure/lattice,
/turf/template_noop,
/area/space/nearstation)
"bd" = (
/obj/machinery/atmospherics/pipe/heat_exchanging/simple{
	dir = 4
	},
/obj/structure/lattice/catwalk,
/turf/template_noop,
/area/space/nearstation)
"be" = (
/obj/machinery/atmospherics/pipe/heat_exchanging/junction{
	dir = 8
	},
/turf/closed/wall/r_wall,
/area/engine/engineering)
"bt" = (
/obj/machinery/atmospherics/pipe/smart/manifold4w/general/visible{
	dir = 4
	},
/obj/machinery/meter,
/obj/effect/turf_decal/tile/yellow{
	dir = 8
	},
/turf/open/floor/plasteel/dark,
/area/engine/engineering)
"bv" = (
/obj/structure/cable,
/obj/machinery/power/generator,
/obj/effect/turf_decal/bot_white,
/turf/open/floor/engine,
/area/engine/engineering)
"by" = (
/obj/structure/cable,
/turf/open/floor/plasteel/dark,
/area/engine/engineering)
"bA" = (
/obj/machinery/atmospherics/components/binary/pump/on{
	dir = 8;
	name = "Cooling Loop to Gas"
	},
/turf/open/floor/plasteel/dark,
/area/engine/engineering)
"bC" = (
/obj/machinery/atmospherics/components/trinary/filter/flipped{
	dir = 4
	},
/obj/effect/turf_decal/bot,
/turf/open/floor/plasteel/monofloor,
/area/engine/engineering)
"bE" = (
/obj/machinery/atmospherics/components/trinary/filter{
	dir = 4
	},
/obj/effect/turf_decal/bot,
/turf/open/floor/plasteel/monofloor,
/area/engine/engineering)
"bI" = (
/obj/machinery/atmospherics/components/binary/pump{
	dir = 1
	},
/turf/open/floor/engine,
/area/engine/engineering)
"bJ" = (
/obj/effect/turf_decal/tile/yellow{
	dir = 4
	},
/turf/open/floor/plasteel/dark,
/area/engine/engineering)
"bK" = (
/obj/structure/cable,
/obj/effect/turf_decal/stripes/line{
	dir = 8
	},
/turf/open/floor/plasteel/dark,
/area/engine/engineering)
"bN" = (
/turf/open/floor/plasteel/dark,
/area/engine/engineering)
"bS" = (
/obj/machinery/atmospherics/pipe/heat_exchanging/simple{
	dir = 10
	},
/obj/structure/lattice,
/turf/template_noop,
/area/space/nearstation)
"bZ" = (
/obj/machinery/atmospherics/pipe/smart/manifold4w/cyan/visible{
	dir = 8
	},
/obj/machinery/meter,
/obj/effect/turf_decal/stripes/line{
	dir = 1
	},
/turf/open/floor/plasteel/dark,
/area/engine/engineering)
"ca" = (
/obj/machinery/atmospherics/components/binary/pump{
	dir = 8
	},
/obj/effect/turf_decal/stripes/line{
	dir = 1
	},
/obj/effect/turf_decal/bot_red,
/turf/open/floor/plasteel/monofloor,
/area/engine/engineering)
"cb" = (
/obj/machinery/atmospherics/pipe/smart/manifold4w/orange/visible,
/obj/machinery/meter,
/obj/effect/turf_decal/stripes/line{
	dir = 1
	},
/turf/open/floor/plasteel/dark,
/area/engine/engineering)
"ch" = (
/obj/effect/turf_decal/stripes/corner,
/turf/open/floor/plasteel/dark,
/area/engine/engineering)
"ci" = (
/obj/machinery/atmospherics/pipe/heat_exchanging/junction{
	dir = 4
	},
/turf/closed/wall/r_wall,
/area/engine/supermatter)
"cj" = (
/obj/machinery/atmospherics/pipe/smart/manifold4w/cyan/visible{
	dir = 8
	},
/obj/machinery/meter,
/obj/effect/turf_decal/stripes/line,
/turf/open/floor/plasteel/dark,
/area/engine/engineering)
"cm" = (
/obj/structure/cable,
/obj/effect/turf_decal/stripes/line,
/turf/open/floor/plasteel/dark,
/area/engine/engineering)
"cw" = (
/obj/structure/cable,
/turf/open/floor/engine,
/area/engine/engineering)
"cy" = (
/obj/machinery/atmospherics/pipe/smart/manifold4w/orange/visible,
/obj/machinery/meter,
/obj/effect/turf_decal/stripes/line,
/turf/open/floor/plasteel/dark,
/area/engine/engineering)
"cB" = (
/obj/structure/cable,
/obj/machinery/atmospherics/pipe/smart/manifold4w/orange/visible,
/turf/open/floor/plasteel/dark,
/area/engine/engineering)
"cC" = (
/obj/effect/turf_decal/stripes/corner{
	dir = 8
	},
/turf/open/floor/plasteel/dark,
/area/engine/engineering)
"cD" = (
/obj/machinery/atmospherics/pipe/layer_manifold/general/hidden,
/obj/effect/turf_decal/tile/yellow{
	dir = 4
	},
/obj/machinery/camera{
	c_tag = "Engineering Supermatter Starboard";
	dir = 8;
	network = list("ss13","engine")
	},
/turf/open/floor/plasteel/dark,
/area/engine/engineering)
"cH" = (
/obj/effect/turf_decal/tile/yellow{
	dir = 8
	},
/obj/machinery/door/firedoor,
/turf/open/floor/plasteel/dark,
/area/engine/engineering)
"cK" = (
/obj/machinery/atmospherics/components/binary/circulator/cold{
	dir = 4
	},
/obj/structure/cable,
/obj/effect/turf_decal/bot_white,
/turf/open/floor/engine,
/area/engine/engineering)
"cL" = (
/obj/machinery/atmospherics/components/binary/circulator/flipped{
	dir = 8
	},
/obj/structure/cable,
/obj/effect/turf_decal/bot_white,
/turf/open/floor/engine,
/area/engine/engineering)
"cM" = (
/obj/effect/turf_decal/tile/yellow{
	dir = 8
	},
/obj/machinery/light{
	dir = 8
	},
/turf/open/floor/plasteel/dark,
/area/engine/engineering)
"cP" = (
/obj/machinery/atmospherics/pipe/heat_exchanging/simple{
	dir = 9
	},
/obj/machinery/atmospherics/pipe/heat_exchanging/simple{
	dir = 6
	},
/obj/structure/lattice,
/turf/template_noop,
/area/space/nearstation)
"cQ" = (
/obj/machinery/camera{
	c_tag = "Engineering Supermatter Port";
	dir = 4;
	network = list("ss13","engine")
	},
/obj/effect/turf_decal/tile/yellow{
	dir = 8
	},
/obj/machinery/light{
	dir = 8
	},
/turf/open/floor/plasteel/dark,
/area/engine/engineering)
"cU" = (
/obj/machinery/atmospherics/pipe/heat_exchanging/manifold{
	dir = 8
	},
/obj/effect/turf_decal/stripes/red/line{
	dir = 8
	},
/turf/open/floor/engine/airless,
/area/engine/supermatter)
"cV" = (
/obj/machinery/atmospherics/pipe/smart/manifold4w/orange/visible,
/obj/machinery/atmospherics/pipe/heat_exchanging/simple{
	dir = 6
	},
/turf/open/floor/engine/airless,
/area/engine/supermatter)
"cW" = (
/obj/structure/lattice/catwalk,
/obj/machinery/atmospherics/pipe/heat_exchanging/simple{
	dir = 4
	},
/turf/template_noop,
/area/space/nearstation)
"cX" = (
/obj/machinery/portable_atmospherics/canister/nitrogen,
/obj/effect/turf_decal/box,
/obj/machinery/atmospherics/components/unary/portables_connector/visible{
	name = "output gas connector port"
	},
/turf/open/floor/plasteel/monofloor,
/area/engine/engineering)
"cY" = (
/obj/effect/turf_decal/box,
/obj/machinery/portable_atmospherics/canister/toxins,
/obj/machinery/atmospherics/components/unary/portables_connector/visible{
	name = "output gas connector port"
	},
/turf/open/floor/plasteel/monofloor,
/area/engine/engineering)
"cZ" = (
/obj/effect/turf_decal/tile/yellow{
	dir = 4
	},
/obj/machinery/atmospherics/pipe/smart/manifold4w/scrubbers/hidden/layer2{
	dir = 1
	},
/turf/open/floor/plasteel/dark,
/area/engine/engineering)
"da" = (
/obj/machinery/atmospherics/components/unary/portables_connector/visible{
	dir = 1
	},
/obj/effect/turf_decal/box,
/turf/open/floor/plasteel/monofloor,
/area/engine/engineering)
"dd" = (
/obj/effect/turf_decal/stripes/line{
	dir = 8
	},
/turf/open/floor/plasteel/dark,
/area/engine/engineering)
"de" = (
/obj/machinery/firealarm{
	dir = 8;
	pixel_x = 24
	},
/obj/effect/turf_decal/stripes/box,
/obj/machinery/atmospherics/pipe/multiz/orange/visible/layer1{
	dir = 1
	},
/turf/open/floor/plating,
/area/engine/engineering)
"di" = (
/obj/structure/lattice/catwalk,
/obj/machinery/atmospherics/pipe/heat_exchanging/simple{
	dir = 6
	},
/turf/template_noop,
/area/space/nearstation)
"dj" = (
/turf/closed/wall,
/area/engine/engineering)
"dk" = (
/obj/machinery/camera{
	c_tag = "Engineering Supermatter Port";
	dir = 4;
	network = list("ss13","engine")
	},
/obj/effect/turf_decal/tile/yellow{
	dir = 8
	},
/turf/open/floor/plasteel/dark,
/area/engine/engineering)
"dm" = (
/obj/effect/turf_decal/tile/yellow{
	dir = 8
	},
/obj/machinery/atmospherics/pipe/smart/manifold4w/cyan/visible{
	dir = 8
	},
/turf/open/floor/plasteel/dark,
/area/engine/engineering)
"do" = (
/obj/effect/turf_decal/stripes/corner{
	dir = 4
	},
/turf/open/floor/plasteel/dark,
/area/engine/engineering)
"dp" = (
/obj/effect/turf_decal/stripes/corner{
	dir = 1
	},
/turf/open/floor/plasteel/dark,
/area/engine/engineering)
"ds" = (
/obj/machinery/atmospherics/components/binary/pump,
/turf/open/floor/plasteel/dark,
/area/engine/engineering)
"dt" = (
/obj/machinery/atmospherics/components/binary/pump/on{
	name = "Gas to Cooling Loop"
	},
/obj/effect/turf_decal/tile/yellow{
	dir = 8
	},
/obj/machinery/light{
	dir = 8
	},
/turf/open/floor/plasteel/dark,
/area/engine/engineering)
"dx" = (
/obj/effect/turf_decal/stripes/box,
/obj/structure/cable/multilayer/multiz,
/obj/machinery/light{
	dir = 4
	},
/turf/open/floor/plating,
/area/engine/engineering)
"dy" = (
/obj/machinery/atmospherics/pipe/heat_exchanging/simple{
	dir = 5
	},
/obj/machinery/atmospherics/pipe/smart/manifold4w/scrubbers/visible{
	dir = 4
	},
/turf/open/floor/engine/airless,
/area/engine/supermatter)
"dz" = (
/obj/machinery/atmospherics/pipe/heat_exchanging/manifold,
/obj/machinery/atmospherics/pipe/smart/manifold4w/scrubbers/visible{
	dir = 4
	},
/turf/open/floor/engine/airless,
/area/engine/supermatter)
"dA" = (
/obj/machinery/atmospherics/pipe/heat_exchanging/simple{
	dir = 9
	},
/obj/machinery/atmospherics/pipe/smart/manifold4w/scrubbers/visible{
	dir = 4
	},
/obj/machinery/meter,
/turf/open/floor/engine/airless,
/area/engine/supermatter)
"dF" = (
/obj/machinery/atmospherics/pipe/smart/manifold4w/cyan/visible{
	dir = 8
	},
/turf/open/floor/plasteel/dark,
/area/engine/engineering)
"dG" = (
/obj/machinery/atmospherics/components/binary/pump{
	dir = 4
	},
/obj/effect/turf_decal/bot_red,
/turf/open/floor/plasteel/monofloor,
/area/engine/engineering)
"dH" = (
/obj/machinery/atmospherics/components/binary/pump/on{
	dir = 1
	},
/turf/open/floor/engine,
/area/engine/engineering)
"dO" = (
/obj/machinery/atmospherics/pipe/multiz/scrubbers/visible/layer2{
	color = "#ff0000";
	dir = 4;
	name = "Scrubbers multi deck pipe adapter"
	},
/obj/effect/turf_decal/stripes/box,
/turf/open/floor/plating,
/area/engine/engineering)
"dP" = (
/obj/machinery/computer/atmos_control/incinerator{
	dir = 8;
	name = "TEG Air Control"
	},
/turf/open/floor/plasteel/monofloor,
/area/engine/supermatter)
"dQ" = (
/obj/machinery/button/ignition{
	id = "TEG"
	},
/turf/closed/wall/r_wall,
/area/engine/supermatter)
"dR" = (
/obj/machinery/atmospherics/pipe/heat_exchanging/manifold4w,
/obj/machinery/igniter{
	id = "TEG"
	},
/obj/machinery/air_sensor/atmos/incinerator_tank{
	name = "TEG chamber gas sensor"
	},
/turf/open/floor/engine/airless,
/area/engine/supermatter)
"dS" = (
/obj/machinery/atmospherics/pipe/heat_exchanging/manifold{
	dir = 4
	},
/obj/machinery/meter,
/turf/open/floor/engine/airless,
/area/engine/supermatter)
"dT" = (
/obj/machinery/atmospherics/components/binary/pump{
	dir = 8
	},
/obj/machinery/light{
	dir = 4
	},
/obj/machinery/airalarm/engine{
	dir = 8;
	pixel_x = 23;
	pixel_y = 0
	},
/turf/open/floor/plasteel/dark,
/area/engine/supermatter)
"dU" = (
/obj/machinery/atmospherics/pipe/multiz/supply/visible/layer4{
	color = "#0000ff";
	dir = 4;
	name = "Supply multi deck pipe adapter"
	},
/obj/effect/turf_decal/stripes/box,
/turf/open/floor/plating,
/area/engine/engineering)
"dW" = (
/obj/machinery/firealarm{
	dir = 8;
	pixel_x = 24
	},
/obj/machinery/atmospherics/pipe/smart/manifold4w/supply/hidden/layer4{
	dir = 10
	},
/obj/effect/turf_decal/tile/yellow,
/turf/open/floor/plasteel/dark,
/area/engine/engineering)
"dZ" = (
/obj/structure/cable,
/obj/machinery/power/floodlight{
	anchored = 1
	},
/turf/open/floor/engine,
/area/engine/engineering)
"ea" = (
/obj/effect/turf_decal/tile/yellow,
/obj/machinery/light{
	dir = 4
	},
/obj/machinery/door/firedoor,
/turf/open/floor/plasteel/dark,
/area/engine/engineering)
"eb" = (
/obj/machinery/atmospherics/pipe/smart/manifold4w/cyan/visible{
	dir = 8
	},
/obj/effect/turf_decal/tile/yellow{
	dir = 8
	},
/turf/open/floor/plasteel/dark,
/area/engine/engineering)
"ec" = (
/obj/machinery/atmospherics/pipe/heat_exchanging/simple{
	dir = 4
	},
/obj/machinery/atmospherics/pipe/heat_exchanging/simple,
/obj/structure/lattice,
/turf/template_noop,
/area/space/nearstation)
"ef" = (
/obj/structure/lattice/catwalk,
/obj/machinery/atmospherics/pipe/heat_exchanging/simple{
	dir = 5
	},
/turf/template_noop,
/area/space/nearstation)
"eg" = (
/obj/effect/turf_decal/tile/yellow{
	dir = 8
	},
/turf/open/floor/plasteel/dark,
/area/engine/engineering)
"eh" = (
/obj/machinery/atmospherics/components/unary/thermomachine/heater,
/obj/effect/turf_decal/bot_white,
/turf/open/floor/plasteel/monofloor,
/area/engine/engineering)
"ei" = (
/obj/structure/cable,
/obj/machinery/door/airlock/engineering/glass{
	name = "Engine Room";
	req_access_txt = "10"
	},
/obj/machinery/door/firedoor/border_only{
	dir = 1
	},
/obj/machinery/door/firedoor/border_only,
/turf/open/floor/plasteel/dark,
/area/engine/engineering)
"ej" = (
/obj/machinery/meter,
/obj/machinery/atmospherics/pipe/smart/manifold4w/orange/visible,
/obj/machinery/light{
	dir = 4
	},
/turf/open/floor/plasteel/dark,
/area/engine/engineering)
"ek" = (
/obj/structure/fans/tiny,
/obj/machinery/door/airlock/engineering/glass{
	name = "Engine Room";
	req_access_txt = "10"
	},
/obj/effect/turf_decal/stripes/full,
/turf/open/floor/engine/airless,
/area/engine/supermatter)
"eq" = (
/obj/machinery/atmospherics/pipe/heat_exchanging/simple{
	dir = 10
	},
/turf/closed/wall/r_wall,
/area/engine/supermatter)
"er" = (
/obj/machinery/atmospherics/pipe/smart/manifold4w/orange/visible,
/turf/open/floor/plasteel/dark,
/area/engine/engineering)
"es" = (
/obj/machinery/atmospherics/components/unary/portables_connector/visible{
	dir = 4
	},
/obj/effect/turf_decal/box,
/obj/machinery/portable_atmospherics/canister/oxygen,
/turf/open/floor/plasteel/monofloor,
/area/engine/engineering)
"et" = (
/obj/effect/turf_decal/tile/yellow,
/turf/open/floor/plasteel/dark,
/area/engine/engineering)
"ev" = (
/obj/machinery/atmospherics/components/binary/pump{
	dir = 4
	},
/turf/open/floor/plasteel/dark,
/area/engine/engineering)
"ew" = (
/obj/effect/turf_decal/bot,
/obj/machinery/atmospherics/components/trinary/mixer/flipped{
	dir = 8
	},
/turf/open/floor/plasteel/monofloor,
/area/engine/engineering)
"eA" = (
/obj/machinery/atmospherics/pipe/smart/manifold4w/orange/visible,
/obj/effect/spawner/structure/window/plasma/reinforced,
/turf/open/floor/plating,
/area/engine/supermatter)
"eC" = (
/obj/machinery/atmospherics/pipe/heat_exchanging/manifold4w,
/obj/machinery/atmospherics/components/unary/vent_scrubber/on,
/turf/open/floor/engine/airless,
/area/engine/supermatter)
"eD" = (
/obj/structure/lattice/catwalk,
/obj/machinery/atmospherics/pipe/heat_exchanging/simple{
	dir = 9
	},
/turf/template_noop,
/area/space/nearstation)
"eG" = (
/obj/machinery/atmospherics/pipe/smart/manifold4w/scrubbers/visible,
/turf/open/floor/plating/airless,
/area/engine/engineering)
"eH" = (
/obj/effect/turf_decal/stripes/line{
	dir = 4
	},
/turf/open/floor/plasteel/dark,
/area/engine/engineering)
"eI" = (
/obj/structure/sign/warning/nosmoking,
/turf/closed/wall/r_wall,
/area/engine/engineering)
"eJ" = (
/obj/machinery/atmospherics/pipe/smart/manifold4w/orange/visible,
/obj/machinery/atmospherics/pipe/heat_exchanging/manifold4w,
/turf/open/floor/engine/airless,
/area/engine/supermatter)
"eK" = (
/obj/machinery/atmospherics/pipe/smart/manifold4w/orange/visible,
/obj/machinery/atmospherics/pipe/heat_exchanging/simple{
	dir = 10
	},
/obj/machinery/meter,
/turf/open/floor/engine/airless,
/area/engine/supermatter)
"eN" = (
/obj/machinery/atmospherics/components/unary/portables_connector/visible{
	dir = 4
	},
/obj/effect/turf_decal/box,
/obj/machinery/portable_atmospherics/canister/tier_2,
/turf/open/floor/plasteel/monofloor,
/area/engine/engineering)
"eO" = (
/obj/machinery/atmospherics/components/binary/pump{
	dir = 8
	},
/turf/open/floor/plasteel/dark,
/area/engine/engineering)
"eP" = (
/obj/effect/spawner/structure/window/plasma/reinforced,
/obj/machinery/atmospherics/pipe/smart/manifold4w/scrubbers/visible{
	dir = 4
	},
/turf/open/floor/plating,
/area/engine/supermatter)
"eT" = (
/obj/machinery/atmospherics/components/unary/thermomachine/freezer{
	dir = 1
	},
/obj/effect/turf_decal/bot_white,
/turf/open/floor/plasteel/monofloor,
/area/engine/engineering)
"eV" = (
/obj/machinery/atmospherics/components/unary/portables_connector/visible{
	dir = 1
	},
/obj/effect/turf_decal/box,
/obj/machinery/portable_atmospherics/canister/nitrogen,
/turf/open/floor/plasteel/monofloor,
/area/engine/engineering)
"fb" = (
/turf/closed/wall/r_wall,
/area/engine/supermatter)
"fe" = (
/obj/structure/chair/office/light{
	dir = 4
	},
/turf/open/floor/plasteel/dark,
/area/engine/engineering)
"fi" = (
/obj/machinery/atmospherics/components/unary/vent_pump/on{
	dir = 1
	},
/obj/machinery/atmospherics/pipe/heat_exchanging/manifold{
	dir = 8
	},
/turf/open/floor/engine/airless,
/area/engine/supermatter)
"fk" = (
/obj/machinery/atmospherics/components/unary/vent_pump/on{
	dir = 1
	},
/obj/machinery/atmospherics/pipe/heat_exchanging/manifold4w,
/turf/open/floor/engine/airless,
/area/engine/supermatter)
"fm" = (
/obj/structure/lattice,
/obj/machinery/atmospherics/pipe/heat_exchanging/simple{
	dir = 4
	},
/turf/template_noop,
/area/space/nearstation)
"fq" = (
/obj/machinery/portable_atmospherics/canister/nitrogen,
/turf/open/floor/plasteel/dark,
/area/engine/engineering)
"fH" = (
/obj/machinery/portable_atmospherics/canister/nitrogen,
/obj/machinery/light{
	dir = 8
	},
/turf/open/floor/plasteel/dark,
/area/engine/engineering)
"jJ" = (
/obj/machinery/portable_atmospherics/canister/oxygen,
/obj/machinery/light{
	dir = 4
	},
/turf/open/floor/plasteel/dark,
/area/engine/engineering)
"me" = (
/obj/effect/turf_decal/tile/yellow,
/obj/machinery/camera{
	c_tag = "Engineering Supermatter Starboard";
	dir = 8;
	network = list("ss13","engine")
	},
/turf/open/floor/plasteel/dark,
/area/engine/engineering)
"oi" = (
/obj/structure/lattice/catwalk,
/obj/machinery/atmospherics/pipe/heat_exchanging/simple{
	dir = 10
	},
/turf/template_noop,
/area/space/nearstation)
"oO" = (
/obj/machinery/atmospherics/components/unary/vent_pump/on{
	dir = 1
	},
/obj/machinery/atmospherics/pipe/heat_exchanging/manifold{
	dir = 4
	},
/turf/open/floor/engine/airless,
/area/engine/supermatter)
"ph" = (
/obj/structure/lattice,
/turf/open/space/basic,
/area/space/nearstation)
"pC" = (
/obj/machinery/portable_atmospherics/canister/toxins,
/turf/open/floor/plasteel/dark,
/area/engine/engineering)
"tB" = (
/obj/effect/spawner/structure/window/plasma/reinforced,
/turf/open/floor/plating,
/area/engine/engineering)
"uH" = (
/obj/machinery/atmospherics/components/unary/outlet_injector/atmos/engine_waste{
	dir = 8
	},
/turf/open/floor/plating/airless,
/area/engine/engineering)
"vJ" = (
/obj/machinery/door/airlock/engineering/glass{
	name = "Engine Room";
	req_access_txt = "10"
	},
/obj/machinery/door/firedoor/border_only{
	dir = 1
	},
/obj/machinery/door/firedoor/border_only,
/turf/open/floor/plasteel/dark,
/area/engine/engineering)
"AD" = (
/obj/machinery/atmospherics/pipe/heat_exchanging/simple{
	dir = 4
	},
/obj/structure/lattice,
/obj/machinery/atmospherics/pipe/heat_exchanging/simple,
/turf/template_noop,
/area/space/nearstation)
"EJ" = (
/obj/machinery/camera{
	c_tag = "Engineering Supermatter Fore";
	dir = 1;
	network = list("ss13","engine");
	pixel_x = 23
	},
/obj/effect/turf_decal/tile/yellow{
	dir = 8
	},
/turf/open/floor/plasteel/dark,
/area/engine/engineering)
"Fo" = (
/obj/effect/turf_decal/stripes/line{
	dir = 4
	},
/obj/effect/turf_decal/caution{
	dir = 8
	},
/turf/open/floor/plasteel/dark,
/area/engine/engineering)
"Fw" = (
/obj/machinery/atmospherics/pipe/smart/manifold4w/orange/visible,
/obj/machinery/meter,
/turf/open/floor/plasteel/dark,
/area/engine/engineering)
"Gs" = (
/obj/machinery/portable_atmospherics/canister/oxygen,
/turf/open/floor/plasteel/dark,
/area/engine/engineering)
"GA" = (
/obj/machinery/camera{
	c_tag = "Engineering Supermatter Fore";
	dir = 1;
	network = list("ss13","engine");
	pixel_x = 23
	},
/obj/effect/turf_decal/tile/yellow,
/turf/open/floor/plasteel/dark,
/area/engine/engineering)
"GN" = (
/obj/machinery/light{
	pixel_y = 0
	},
/turf/open/floor/plasteel/dark,
/area/engine/engineering)
"Hg" = (
/obj/machinery/atmospherics/pipe/heat_exchanging/manifold{
	dir = 4
	},
/obj/machinery/atmospherics/components/unary/vent_scrubber/on,
/turf/open/floor/engine/airless,
/area/engine/supermatter)
"Kt" = (
/obj/machinery/atmospherics/components/binary/pump{
	dir = 1
	},
/turf/open/floor/plasteel/dark,
/area/engine/engineering)
"LD" = (
/obj/machinery/door/firedoor,
/turf/open/floor/plasteel/dark,
/area/engine/engineering)
"LF" = (
/obj/structure/lattice/catwalk,
/turf/template_noop,
/area/space/nearstation)

(1,1,1) = {"
ab
LF
di
ef
di
ef
di
ef
di
ef
di
ef
di
ef
di
ef
di
ef
di
ef
ab
bb
ab
ab
ab
ab
"}
(2,1,1) = {"
ab
LF
fm
fm
fm
fm
fm
fm
fm
fm
fm
fm
fm
fm
fm
fm
fm
fm
fm
cW
ab
bb
ab
ab
ab
ab
"}
(3,1,1) = {"
ab
di
ec
ec
ec
ec
ec
ec
ec
ec
ec
ec
ec
ec
ec
ec
ec
ec
ec
eD
ab
bb
ab
ab
ab
ab
"}
(4,1,1) = {"
ab
oi
ec
ec
ec
ec
ec
ec
ec
ec
ec
ec
ec
ec
ec
ec
ec
ec
ec
ef
ab
bb
ab
ab
ab
ab
"}
(5,1,1) = {"
ab
di
ec
ec
ec
ec
ec
ec
ec
ec
ec
ec
ec
ec
ec
ec
ec
ec
ec
eD
ab
bb
ab
ab
ab
ab
"}
(6,1,1) = {"
ab
oi
ec
ec
ec
ec
ec
ec
ec
ec
ec
ec
ec
ec
ec
ec
ec
ec
ec
ef
ab
bb
ab
ab
ab
ab
"}
(7,1,1) = {"
ab
di
ec
ec
ec
ec
ec
ec
ec
ec
ec
ec
ec
ec
ec
ec
ec
ec
ec
eD
ab
bb
ab
ab
ab
ab
"}
(8,1,1) = {"
ab
oi
ec
ec
ec
ec
ec
ec
ec
ec
ec
ec
ec
ec
ec
ec
ec
ec
ec
ef
ab
bb
ab
ab
ab
ab
"}
(9,1,1) = {"
ab
di
ec
ec
ec
ec
ec
ec
ec
ec
ec
ec
ec
ec
ec
ec
ec
ec
ec
eD
ab
bb
ab
ab
ab
ab
"}
(10,1,1) = {"
ab
oi
ec
ec
ec
ec
ec
ec
ec
ec
ec
ec
ec
ec
ec
ec
ec
ec
ec
ef
ab
bb
ab
ab
ab
ab
"}
(11,1,1) = {"
ph
LF
bc
bS
cP
AD
AD
AD
AD
AD
AD
ec
ec
ec
ec
ec
ec
ec
ec
eD
ab
bb
ab
ab
ab
ab
"}
(12,1,1) = {"
ab
LF
bd
LF
cW
oi
eD
oi
eD
oi
eD
oi
eD
oi
eD
oi
eD
oi
eD
LF
LF
LF
ab
ab
ab
ab
"}
(13,1,1) = {"
ab
ad
be
tB
be
ad
ad
tB
tB
tB
ad
ad
ad
ad
tB
tB
tB
ad
ad
ad
ad
LF
ab
ab
ab
ab
"}
(14,1,1) = {"
ad
ad
bt
eg
bt
dt
dm
eb
eb
eg
cM
eg
dk
eg
eg
cH
eg
cQ
eg
eg
ad
LF
ab
ab
ab
ab
"}
(15,1,1) = {"
ad
as
bA
bN
bN
bN
bN
bN
dF
bN
bN
bN
bN
bN
bN
ad
ad
ad
ad
eg
ad
LF
ab
ab
ab
ab
"}
(16,1,1) = {"
ad
aF
bC
ds
da
bN
cX
ds
dF
eT
eh
er
Kt
eV
bN
ad
fH
fq
ad
eg
tB
LF
ab
ab
ab
ab
"}
(17,1,1) = {"
ad
aH
dF
bN
bN
bN
bN
bN
dF
bN
bN
er
bN
bN
bN
ad
fq
fq
ad
eg
tB
LF
ab
ab
ab
ab
"}
(18,1,1) = {"
ad
aK
bC
ds
da
bN
cX
ds
dF
eT
eh
er
Kt
eV
bN
ad
fq
fq
ad
EJ
ad
LF
ab
ab
ab
ab
"}
(19,1,1) = {"
ag
aL
dF
ch
eH
eH
eH
do
dF
bN
bN
er
bN
bN
bN
ad
LD
LD
ad
GN
ad
LF
ab
ab
ab
ab
"}
(20,1,1) = {"
ao
aM
dF
cj
bI
cK
dH
bZ
dF
bN
bN
er
bN
bN
bN
ag
bN
GN
eI
bN
tB
LF
ab
ab
ab
ab
"}
(21,1,1) = {"
ar
aO
by
cm
cw
bv
dZ
ca
dG
bN
bN
er
bN
bN
bN
ei
bN
bN
vJ
bN
tB
LF
ab
ab
ab
ab
"}
(22,1,1) = {"
ad
aP
er
cy
bI
cL
bI
cb
er
er
er
er
bN
bN
bN
eI
LD
LD
ag
bN
tB
LF
ab
ab
ab
ab
"}
(23,1,1) = {"
ad
aQ
er
cC
dd
bK
dd
dp
bN
bN
bN
er
bN
bN
bN
ad
Gs
pC
ad
GN
ad
LF
ab
ab
ab
ab
"}
(24,1,1) = {"
ad
aU
bE
ds
da
by
bN
bN
es
bN
bN
er
bN
bN
bN
ad
Gs
pC
ad
GA
ad
LF
ab
ab
ab
ab
"}
(25,1,1) = {"
ad
aV
er
bN
bN
by
bN
bN
ev
bN
bN
er
bN
bN
bN
ad
jJ
pC
ad
et
tB
LF
ab
ab
ab
ab
"}
(26,1,1) = {"
ad
aW
bE
ds
da
by
cY
ds
ew
fe
bN
Fw
eN
bN
bN
ad
ad
ad
ad
et
tB
LF
ab
ab
ab
ab
"}
(27,1,1) = {"
ad
ba
er
er
er
cB
er
ej
ev
dP
Fo
dT
eO
et
et
ea
me
et
et
et
ad
LF
ab
ab
ab
ab
"}
(28,1,1) = {"
ad
ad
bJ
cD
de
dx
cZ
aw
eA
dQ
ek
ci
eP
fb
ad
ad
ad
ad
ad
ad
ad
LF
ab
ab
ab
ab
"}
(29,1,1) = {"
ab
ad
ad
ad
dj
ad
dO
ci
cV
fi
cU
eC
dy
fb
LF
eG
LF
LF
LF
LF
LF
LF
ab
ab
ab
ab
"}
(30,1,1) = {"
ab
bb
ab
ab
ab
ad
dU
eq
eJ
fk
dR
eC
dz
fb
LF
uH
LF
ab
ab
ab
ab
bb
ab
ab
ab
ab
"}
(31,1,1) = {"
ab
bb
ab
ab
ab
ad
dW
fb
eK
oO
dS
Hg
dA
fb
LF
LF
LF
ab
ab
ab
ab
bb
ab
ab
ab
ab
"}
(32,1,1) = {"
ab
bb
bb
bb
bb
ad
ad
fb
fb
fb
fb
fb
fb
fb
bb
bb
bb
bb
bb
bb
bb
bb
ab
ab
ab
ab
"}
