//MAP CONVERTED BY dmm2tgm.py THIS HEADER COMMENT PREVENTS RECONVERSION, DO NOT REMOVE
"aJ" = (
/obj/structure/barricade/sandbags,
/turf/open/floor/pod/dark,
/area/violence)
"bR" = (
/obj/structure/barricade/sandbags,
/obj/structure/barricade/sandbags,
/obj/structure/barricade/sandbags,
/turf/open/floor/pod/dark,
/area/violence)
"bX" = (
/obj/effect/spawner/random/trash,
/turf/open/floor/pod/dark,
/area/violence)
"gG" = (
/obj/item/grenade/clusterbuster/cleaner,
/obj/structure/table/rolling,
/turf/open/floor/pod/dark,
/area/violence)
"jl" = (
/obj/machinery/door/airlock/highsecurity,
/turf/open/floor/pod/dark,
/area/violence)
"ju" = (
/obj/machinery/door/airlock/highsecurity,
/obj/effect/mapping_helpers/airlock/access/all,
/obj/effect/mine/gas/n2o,
/turf/open/floor/pod/dark,
/area/violence)
"kJ" = (
/obj/structure/deployable_barricade/plasteel,
/turf/open/floor/pod/dark,
/area/violence)
"ld" = (
/turf/closed/indestructible/reinforced,
/area/violence)
"lp" = (
/turf/closed/indestructible/fakeglass,
/area/violence)
"nM" = (
/obj/machinery/door/airlock/highsecurity,
/obj/structure/barricade/wooden/snowed,
/turf/open/floor/pod/dark,
/area/violence)
"oA" = (
/obj/effect/spawner/random/trash/cigbutt,
/turf/open/floor/pod/dark,
/area/violence)
"qw" = (
/obj/machinery/door/poddoor/ert,
/obj/machinery/door/poddoor/ert,
/turf/open/floor/pod/dark,
/area/violence)
"qF" = (
/obj/machinery/door/airlock/highsecurity,
/obj/effect/mapping_helpers/airlock/access/all,
/obj/effect/mine/stun,
/turf/open/floor/pod/dark,
/area/violence)
"rY" = (
/obj/effect/mine/pickup/speed,
/turf/open/floor/pod/dark,
/area/violence)
"sk" = (
/turf/open/floor/pod/dark,
/area/violence)
"uX" = (
/obj/machinery/door/airlock/highsecurity,
/obj/machinery/door/airlock/highsecurity,
/obj/structure/barricade/wooden/snowed,
/turf/open/floor/pod/dark,
/area/violence)
"vH" = (
/obj/machinery/door/airlock/highsecurity,
/obj/effect/mapping_helpers/airlock/access/all,
/turf/open/floor/pod/dark,
/area/violence)
"wb" = (
/obj/effect/spawner/random/medical/injector,
/obj/structure/table/rolling,
/obj/structure/table/rolling,
/turf/open/floor/pod/dark,
/area/violence)
"zl" = (
/obj/effect/mob_spawn/human/corpse/scientist,
/turf/open/floor/pod/dark,
/area/violence)
"Bk" = (
/obj/effect/spawner/random/trash,
/obj/effect/spawner/random/trash,
/turf/open/floor/pod/dark,
/area/violence)
"Cz" = (
/obj/effect/mapping_helpers/airlock/access/all,
/obj/machinery/door/airlock/highsecurity,
/turf/open/floor/pod/dark,
/area/violence)
"CF" = (
/obj/effect/temp_visual/cult/rune_spawn,
/obj/item/item_generator/brick,
/turf/closed/indestructible/fakeglass,
/area/violence)
"CV" = (
/obj/item/stack/tile/fakepit,
/turf/closed/indestructible/fakeglass,
/area/violence)
"DB" = (
/obj/structure/barricade/sandbags,
/obj/structure/barricade/sandbags,
/turf/open/floor/pod/dark,
/area/violence)
"DK" = (
/obj/structure/deployable_barricade/plasteel,
/obj/structure/deployable_barricade/plasteel,
/turf/open/floor/pod/dark,
/area/violence)
"FK" = (
/obj/item/grenade/spawnergrenade/syndiesoap,
/obj/structure/table/rolling,
/turf/open/floor/pod/dark,
/area/violence)
"Gc" = (
/obj/item/flasher_portable_item,
/turf/open/floor/pod/dark,
/area/violence)
"Kr" = (
/obj/effect/spawner/random/medical/injector,
/obj/structure/table/rolling,
/turf/open/floor/pod/dark,
/area/violence)
"Ld" = (
/obj/effect/mapping_helpers/airlock/access/all,
/obj/machinery/door/airlock/highsecurity,
/turf/open/floor/clockwork,
/area/violence)
"PN" = (
/obj/machinery/door/poddoor/ert,
/turf/open/floor/pod/dark,
/area/violence)
"Sq" = (
/obj/effect/landmark/bomb_plant_location,
/obj/effect/spawner/random/trash/graffiti,
/turf/open/floor/pod/dark,
/area/violence)
"Te" = (
/obj/machinery/door/airlock/highsecurity,
/obj/effect/mapping_helpers/airlock/access/all,
/obj/effect/mine/sound/bwoink,
/turf/open/floor/pod/dark,
/area/violence)
"Vq" = (
/obj/effect/landmark/start/combatant/red,
/turf/open/floor/pod/dark,
/area/violence)
"VQ" = (
/turf/closed/wall/rust,
/area/violence)
"Wo" = (
/obj/effect/spawner/random/contraband/prison,
/turf/open/floor/pod/dark,
/area/violence)
"Xp" = (
/obj/effect/mine/pickup/healing,
/turf/open/floor/pod/dark,
/area/violence)
"XS" = (
/turf/open/lava/plasma/ice_moon,
/area/violence)
"ZO" = (
/turf/open/floor/plating/asteroid/dirty/fake_lava_v2,
/area/violence)
"ZQ" = (
/obj/effect/landmark/start/combatant/blue,
/turf/open/floor/pod/dark,
/area/violence)
"ZY" = (
/obj/effect/mob_spawn/human/corpse/russian,
/turf/open/floor/pod/dark,
/area/violence)

(1,1,1) = {"
ld
ld
ld
ld
ld
ld
ld
ld
ld
ld
ld
ld
ld
ld
ld
ld
ld
ld
ld
ld
ld
ld
ld
ld
ld
ld
ld
ld
ld
ld
ld
ld
"}
(2,1,1) = {"
ld
VQ
rY
sk
sk
sk
sk
sk
sk
sk
rY
sk
sk
sk
sk
sk
sk
sk
sk
sk
sk
rY
sk
sk
sk
sk
sk
sk
sk
rY
VQ
ld
"}
(3,1,1) = {"
ld
VQ
nM
VQ
VQ
VQ
VQ
VQ
VQ
VQ
nM
VQ
VQ
VQ
PN
PN
PN
qw
VQ
VQ
VQ
nM
VQ
VQ
VQ
VQ
VQ
VQ
VQ
nM
VQ
ld
"}
(4,1,1) = {"
ld
VQ
sk
sk
Kr
VQ
XS
zl
sk
sk
sk
sk
Wo
PN
ZQ
ZQ
ZQ
ZQ
PN
Wo
sk
sk
sk
sk
zl
XS
VQ
Kr
sk
sk
VQ
ld
"}
(5,1,1) = {"
ld
VQ
FK
sk
Kr
VQ
XS
sk
sk
gG
sk
sk
sk
PN
ZQ
ZQ
ZQ
ZQ
PN
sk
sk
sk
gG
sk
sk
XS
VQ
Kr
sk
FK
VQ
ld
"}
(6,1,1) = {"
ld
VQ
sk
sk
sk
nM
sk
sk
sk
sk
sk
sk
sk
PN
ZQ
ZQ
ZQ
ZQ
PN
sk
sk
sk
sk
sk
sk
sk
nM
sk
sk
sk
VQ
ld
"}
(7,1,1) = {"
ld
VQ
sk
sk
wb
VQ
XS
sk
sk
zl
sk
sk
sk
PN
ZQ
ZQ
ZQ
ZQ
PN
sk
sk
sk
zl
sk
sk
XS
VQ
Kr
sk
sk
VQ
ld
"}
(8,1,1) = {"
ld
VQ
sk
sk
Kr
VQ
XS
sk
sk
sk
sk
Wo
sk
PN
ZQ
ZQ
ZQ
ZQ
PN
sk
Wo
sk
sk
sk
sk
XS
VQ
Kr
sk
sk
VQ
ld
"}
(9,1,1) = {"
ld
VQ
VQ
jl
VQ
VQ
lp
lp
lp
VQ
VQ
VQ
VQ
VQ
ZQ
ZQ
ZQ
ZQ
VQ
VQ
VQ
VQ
VQ
lp
lp
lp
VQ
VQ
jl
VQ
VQ
ld
"}
(10,1,1) = {"
ld
VQ
sk
sk
sk
VQ
sk
sk
sk
sk
sk
sk
sk
PN
ZQ
ZQ
ZQ
ZQ
PN
sk
sk
sk
sk
sk
sk
sk
VQ
sk
sk
sk
VQ
ld
"}
(11,1,1) = {"
ld
VQ
sk
sk
sk
VQ
sk
aJ
sk
sk
sk
aJ
sk
PN
ZQ
ZQ
ZQ
ZQ
PN
sk
aJ
sk
sk
sk
aJ
sk
VQ
sk
sk
sk
VQ
ld
"}
(12,1,1) = {"
ld
VQ
aJ
Xp
aJ
VQ
sk
aJ
sk
Xp
sk
aJ
sk
PN
ZQ
ZQ
ZQ
ZQ
PN
sk
aJ
sk
Xp
sk
aJ
sk
VQ
aJ
Xp
aJ
VQ
ld
"}
(13,1,1) = {"
ld
VQ
sk
sk
sk
VQ
sk
DB
aJ
aJ
aJ
DB
sk
PN
ZQ
ZQ
ZQ
ZQ
PN
sk
DB
aJ
aJ
aJ
bR
sk
VQ
sk
sk
sk
VQ
ld
"}
(14,1,1) = {"
ld
VQ
sk
sk
sk
VQ
sk
sk
sk
sk
sk
sk
sk
VQ
PN
PN
PN
PN
VQ
sk
sk
sk
sk
sk
sk
sk
VQ
sk
sk
sk
VQ
ld
"}
(15,1,1) = {"
ld
VQ
aJ
sk
aJ
VQ
XS
XS
XS
sk
XS
XS
XS
VQ
ZO
rY
rY
ZO
VQ
XS
XS
XS
sk
XS
XS
XS
VQ
aJ
sk
aJ
VQ
ld
"}
(16,1,1) = {"
ld
VQ
sk
sk
sk
VQ
VQ
VQ
VQ
vH
VQ
VQ
VQ
VQ
ZO
sk
sk
ZO
VQ
VQ
VQ
VQ
vH
VQ
VQ
VQ
VQ
sk
sk
sk
VQ
ld
"}
(17,1,1) = {"
ld
VQ
sk
sk
sk
VQ
sk
sk
sk
sk
sk
sk
bX
VQ
ZO
sk
sk
ZO
VQ
sk
sk
sk
sk
sk
sk
bX
VQ
sk
sk
sk
VQ
ld
"}
(18,1,1) = {"
ld
VQ
aJ
sk
aJ
VQ
sk
bX
sk
sk
sk
sk
sk
VQ
ZO
sk
sk
ZO
VQ
sk
bX
sk
sk
sk
sk
sk
VQ
aJ
sk
aJ
VQ
ld
"}
(19,1,1) = {"
ld
VQ
sk
sk
sk
VQ
sk
sk
sk
oA
sk
bX
sk
VQ
ZO
sk
sk
ZO
VQ
sk
sk
sk
oA
sk
bX
sk
VQ
sk
sk
sk
VQ
ld
"}
(20,1,1) = {"
ld
VQ
sk
sk
sk
VQ
bX
sk
sk
sk
sk
sk
sk
VQ
ZO
sk
sk
ZO
VQ
bX
sk
sk
sk
sk
sk
sk
VQ
sk
sk
sk
VQ
ld
"}
(21,1,1) = {"
ld
VQ
aJ
sk
aJ
VQ
VQ
VQ
VQ
Te
VQ
VQ
VQ
VQ
VQ
sk
sk
VQ
VQ
VQ
VQ
VQ
Te
VQ
VQ
VQ
VQ
aJ
sk
aJ
VQ
ld
"}
(22,1,1) = {"
ld
VQ
sk
sk
XS
lp
XS
sk
sk
sk
sk
sk
sk
sk
sk
sk
sk
sk
sk
sk
sk
sk
sk
sk
sk
XS
lp
XS
sk
sk
VQ
ld
"}
(23,1,1) = {"
ld
VQ
sk
sk
XS
lp
sk
sk
aJ
sk
aJ
sk
aJ
sk
sk
sk
sk
sk
sk
aJ
sk
aJ
sk
aJ
sk
sk
lp
XS
sk
sk
VQ
ld
"}
(24,1,1) = {"
ld
VQ
sk
sk
XS
lp
sk
sk
sk
sk
oA
sk
sk
sk
kJ
kJ
kJ
kJ
sk
sk
sk
oA
sk
sk
sk
sk
lp
XS
sk
sk
VQ
ld
"}
(25,1,1) = {"
ld
VQ
sk
sk
sk
lp
sk
sk
aJ
sk
aJ
sk
aJ
sk
sk
sk
sk
sk
sk
aJ
sk
aJ
sk
aJ
sk
sk
lp
sk
sk
sk
VQ
ld
"}
(26,1,1) = {"
ld
VQ
VQ
jl
VQ
lp
aJ
sk
sk
sk
sk
sk
sk
sk
sk
sk
sk
sk
sk
sk
sk
sk
sk
sk
sk
aJ
lp
VQ
jl
VQ
VQ
ld
"}
(27,1,1) = {"
ld
VQ
sk
sk
sk
lp
sk
sk
VQ
VQ
VQ
VQ
VQ
VQ
VQ
sk
sk
VQ
VQ
VQ
VQ
VQ
VQ
VQ
sk
sk
lp
sk
sk
sk
VQ
ld
"}
(28,1,1) = {"
ld
VQ
sk
sk
sk
lp
sk
aJ
VQ
XS
sk
sk
XS
VQ
Gc
sk
sk
Gc
VQ
XS
sk
sk
XS
VQ
aJ
sk
lp
sk
sk
sk
VQ
ld
"}
(29,1,1) = {"
ld
VQ
sk
sk
sk
lp
sk
sk
VQ
sk
bX
sk
sk
sk
sk
sk
sk
sk
sk
sk
sk
bX
sk
VQ
sk
sk
lp
sk
sk
sk
VQ
ld
"}
(30,1,1) = {"
ld
VQ
sk
sk
sk
lp
aJ
sk
VQ
sk
sk
sk
sk
sk
sk
sk
sk
sk
sk
sk
sk
sk
sk
VQ
sk
aJ
lp
sk
sk
sk
VQ
ld
"}
(31,1,1) = {"
ld
VQ
sk
sk
VQ
lp
sk
sk
qF
sk
sk
VQ
sk
sk
CV
CV
CV
sk
sk
VQ
sk
sk
sk
ju
sk
sk
lp
VQ
sk
sk
VQ
ld
"}
(32,1,1) = {"
ld
VQ
sk
sk
rY
Cz
sk
aJ
VQ
VQ
VQ
VQ
Sq
lp
lp
CF
lp
lp
Sq
VQ
VQ
VQ
VQ
VQ
aJ
sk
Ld
rY
sk
sk
VQ
ld
"}
(33,1,1) = {"
ld
VQ
sk
sk
VQ
lp
sk
sk
ju
sk
sk
VQ
sk
sk
CV
CV
CV
sk
sk
VQ
sk
sk
sk
qF
sk
sk
lp
VQ
sk
sk
VQ
ld
"}
(34,1,1) = {"
ld
VQ
sk
sk
sk
lp
aJ
sk
VQ
sk
sk
sk
sk
sk
sk
sk
sk
sk
sk
sk
sk
sk
sk
VQ
sk
aJ
lp
sk
sk
sk
VQ
ld
"}
(35,1,1) = {"
ld
VQ
sk
sk
sk
lp
sk
sk
VQ
sk
bX
sk
sk
sk
sk
sk
sk
sk
sk
sk
sk
bX
sk
VQ
sk
sk
lp
sk
sk
sk
VQ
ld
"}
(36,1,1) = {"
ld
VQ
sk
sk
sk
lp
sk
aJ
VQ
XS
sk
sk
XS
VQ
Gc
sk
sk
Gc
VQ
XS
sk
sk
XS
VQ
aJ
sk
lp
sk
sk
sk
VQ
ld
"}
(37,1,1) = {"
ld
VQ
sk
sk
sk
lp
sk
sk
VQ
VQ
VQ
VQ
VQ
VQ
VQ
sk
sk
VQ
VQ
VQ
VQ
VQ
VQ
VQ
sk
sk
lp
sk
sk
sk
VQ
ld
"}
(38,1,1) = {"
ld
VQ
VQ
jl
VQ
lp
aJ
sk
sk
sk
sk
sk
sk
sk
sk
sk
sk
sk
sk
sk
sk
sk
sk
sk
sk
aJ
lp
VQ
jl
VQ
VQ
ld
"}
(39,1,1) = {"
ld
VQ
sk
sk
sk
lp
sk
sk
aJ
sk
aJ
sk
aJ
sk
DK
kJ
kJ
kJ
sk
aJ
sk
aJ
sk
aJ
sk
sk
lp
sk
sk
sk
VQ
ld
"}
(40,1,1) = {"
ld
VQ
sk
sk
XS
lp
sk
sk
sk
sk
oA
sk
sk
sk
sk
sk
sk
sk
sk
sk
sk
oA
sk
sk
sk
sk
lp
XS
sk
sk
VQ
ld
"}
(41,1,1) = {"
ld
VQ
sk
sk
XS
lp
sk
sk
aJ
sk
aJ
sk
aJ
sk
sk
sk
sk
sk
sk
aJ
sk
aJ
sk
aJ
sk
sk
lp
XS
sk
sk
VQ
ld
"}
(42,1,1) = {"
ld
VQ
sk
sk
XS
lp
XS
sk
sk
sk
sk
sk
sk
sk
sk
sk
sk
sk
sk
sk
sk
sk
sk
sk
sk
XS
lp
XS
sk
sk
VQ
ld
"}
(43,1,1) = {"
ld
VQ
aJ
sk
aJ
VQ
VQ
VQ
VQ
Te
VQ
VQ
VQ
VQ
VQ
sk
sk
VQ
VQ
VQ
VQ
VQ
Te
VQ
VQ
VQ
VQ
aJ
sk
aJ
VQ
ld
"}
(44,1,1) = {"
ld
VQ
sk
sk
sk
VQ
bX
sk
sk
sk
sk
sk
sk
VQ
ZO
sk
sk
ZO
VQ
bX
sk
sk
sk
sk
sk
sk
VQ
sk
sk
sk
VQ
ld
"}
(45,1,1) = {"
ld
VQ
sk
sk
sk
VQ
sk
sk
sk
oA
sk
bX
sk
VQ
ZO
sk
sk
ZO
VQ
sk
sk
sk
oA
sk
bX
sk
VQ
sk
sk
sk
VQ
ld
"}
(46,1,1) = {"
ld
VQ
aJ
sk
aJ
VQ
sk
Bk
sk
sk
sk
sk
sk
VQ
ZO
sk
sk
ZO
VQ
sk
bX
sk
sk
sk
sk
sk
VQ
aJ
sk
aJ
VQ
ld
"}
(47,1,1) = {"
ld
VQ
sk
sk
sk
VQ
sk
sk
sk
sk
sk
sk
bX
VQ
ZO
sk
sk
ZO
VQ
sk
sk
sk
sk
sk
sk
bX
VQ
sk
sk
sk
VQ
ld
"}
(48,1,1) = {"
ld
VQ
sk
sk
sk
VQ
VQ
VQ
VQ
vH
VQ
VQ
VQ
VQ
ZO
sk
sk
ZO
VQ
VQ
VQ
VQ
vH
VQ
VQ
VQ
VQ
sk
sk
sk
VQ
ld
"}
(49,1,1) = {"
ld
VQ
aJ
sk
aJ
VQ
XS
XS
XS
sk
XS
XS
XS
VQ
ZO
rY
rY
ZO
VQ
XS
XS
XS
sk
XS
XS
XS
VQ
aJ
sk
aJ
VQ
ld
"}
(50,1,1) = {"
ld
VQ
sk
sk
sk
VQ
sk
sk
sk
sk
sk
sk
sk
VQ
PN
PN
PN
PN
VQ
sk
sk
sk
sk
sk
sk
sk
VQ
sk
sk
sk
VQ
ld
"}
(51,1,1) = {"
ld
VQ
sk
sk
sk
VQ
sk
DB
aJ
aJ
aJ
DB
sk
PN
Vq
Vq
Vq
Vq
PN
sk
DB
aJ
aJ
aJ
DB
sk
VQ
sk
sk
sk
VQ
ld
"}
(52,1,1) = {"
ld
VQ
aJ
Xp
aJ
VQ
sk
aJ
sk
Xp
sk
aJ
sk
PN
Vq
Vq
Vq
Vq
PN
sk
aJ
sk
Xp
sk
aJ
sk
VQ
aJ
Xp
aJ
VQ
ld
"}
(53,1,1) = {"
ld
VQ
sk
sk
sk
VQ
sk
DB
sk
sk
sk
DB
sk
PN
Vq
Vq
Vq
Vq
PN
sk
DB
sk
sk
sk
DB
sk
VQ
sk
sk
sk
VQ
ld
"}
(54,1,1) = {"
ld
VQ
sk
sk
sk
VQ
sk
sk
sk
sk
sk
sk
sk
PN
Vq
Vq
Vq
Vq
PN
sk
sk
sk
sk
sk
sk
sk
VQ
sk
sk
sk
VQ
ld
"}
(55,1,1) = {"
ld
VQ
VQ
jl
VQ
VQ
lp
lp
lp
VQ
VQ
VQ
VQ
VQ
Vq
Vq
Vq
Vq
VQ
VQ
VQ
VQ
VQ
lp
lp
lp
VQ
VQ
jl
VQ
VQ
ld
"}
(56,1,1) = {"
ld
VQ
sk
sk
Kr
VQ
XS
sk
sk
sk
sk
Wo
sk
PN
Vq
Vq
Vq
Vq
PN
sk
Wo
sk
sk
sk
sk
XS
VQ
Kr
sk
sk
VQ
ld
"}
(57,1,1) = {"
ld
VQ
sk
sk
Kr
VQ
XS
sk
sk
ZY
sk
sk
sk
PN
Vq
Vq
Vq
Vq
PN
sk
sk
sk
ZY
sk
sk
XS
VQ
Kr
sk
sk
VQ
ld
"}
(58,1,1) = {"
ld
VQ
sk
sk
sk
nM
sk
sk
sk
sk
sk
sk
sk
PN
Vq
Vq
Vq
Vq
PN
sk
sk
sk
sk
sk
sk
sk
nM
sk
sk
sk
VQ
ld
"}
(59,1,1) = {"
ld
VQ
FK
sk
Kr
VQ
XS
sk
sk
gG
sk
sk
sk
PN
Vq
Vq
Vq
Vq
PN
sk
sk
sk
gG
sk
sk
XS
VQ
Kr
sk
FK
VQ
ld
"}
(60,1,1) = {"
ld
VQ
sk
sk
Kr
VQ
XS
ZY
sk
sk
sk
sk
Wo
PN
Vq
Vq
Vq
Vq
PN
Wo
sk
sk
sk
sk
ZY
XS
VQ
Kr
sk
sk
VQ
ld
"}
(61,1,1) = {"
ld
VQ
nM
VQ
VQ
VQ
VQ
VQ
VQ
VQ
nM
VQ
VQ
VQ
PN
PN
PN
PN
VQ
VQ
VQ
nM
VQ
VQ
VQ
VQ
VQ
VQ
VQ
uX
VQ
ld
"}
(62,1,1) = {"
ld
VQ
rY
sk
sk
sk
sk
sk
sk
sk
rY
sk
sk
sk
sk
sk
sk
sk
sk
sk
sk
rY
sk
sk
sk
sk
sk
sk
sk
rY
VQ
ld
"}
(63,1,1) = {"
ld
ld
ld
ld
ld
ld
ld
ld
ld
ld
ld
ld
ld
ld
ld
ld
ld
ld
ld
ld
ld
ld
ld
ld
ld
ld
ld
ld
ld
ld
ld
ld
"}
(64,1,1) = {"
ld
ld
ld
ld
ld
ld
ld
ld
ld
ld
ld
ld
ld
ld
ld
ld
ld
ld
ld
ld
ld
ld
ld
ld
ld
ld
ld
ld
ld
ld
ld
ld
"}
