//MAP CONVERTED BY dmm2tgm.py THIS HEADER COMMENT PREVENTS RECONVERSION, DO NOT REMOVE
"ar" = (
/obj/effect/turf_decal/box/red/corners{
	dir = 8
	},
/turf/open/floor/plating/sandy_dirt,
/area/violence)
"bP" = (
/obj/effect/bump_teleporter{
	id = "dd8t";
	id_target = "dd8"
	},
/turf/open/floor/plasteel/stairs{
	dir = 1
	},
/area/violence)
"cO" = (
/obj/effect/bump_teleporter{
	id = "dt1";
	id_target = "dt1t"
	},
/obj/effect/turf_decal/weather/side{
	dir = 1
	},
/turf/open/floor/plasteel/stairs,
/area/violence)
"cV" = (
/obj/effect/bump_teleporter{
	id = "dt2t";
	id_target = "dt2"
	},
/turf/open/floor/plasteel/stairs,
/area/violence)
"dv" = (
/obj/structure/barricade/wooden,
/obj/effect/turf_decal/weather/side/corner{
	dir = 4
	},
/turf/open/floor/plating/beach/sand,
/area/violence)
"eA" = (
/obj/effect/turf_decal/weather/side/corner{
	dir = 4
	},
/obj/effect/turf_decal/weather/side/corner{
	dir = 8
	},
/turf/open/floor/plating/sandy_dirt,
/area/violence)
"eO" = (
/obj/effect/turf_decal/weather/side{
	dir = 4
	},
/turf/open/floor/plating/beach/sand,
/area/violence)
"gB" = (
/obj/effect/bump_teleporter{
	id = "dd6";
	id_target = "dd6t"
	},
/obj/effect/turf_decal/weather/side,
/turf/open/floor/plasteel/stairs{
	dir = 1
	},
/area/violence)
"ht" = (
/turf/open/floor/plasteel/stairs{
	dir = 4
	},
/area/violence)
"hP" = (
/obj/effect/turf_decal/weather/side,
/turf/open/floor/plating/beach/sand,
/area/violence)
"hZ" = (
/obj/effect/turf_decal/weather/side{
	dir = 6
	},
/turf/open/floor/plating/beach/sand,
/area/violence)
"iq" = (
/obj/effect/bump_teleporter{
	id = "dd3t";
	id_target = "dd3"
	},
/turf/open/floor/plasteel/stairs{
	dir = 1
	},
/area/violence)
"kW" = (
/obj/effect/bump_teleporter{
	id = "dd5t";
	id_target = "dd5"
	},
/turf/open/floor/plasteel/stairs{
	dir = 1
	},
/area/violence)
"lZ" = (
/obj/effect/bump_teleporter{
	id = "dt1t";
	id_target = "dt1"
	},
/turf/open/floor/plasteel/stairs,
/area/violence)
"mE" = (
/obj/effect/bump_teleporter{
	id = "dt5";
	id_target = "dt5t"
	},
/obj/effect/turf_decal/weather/side{
	dir = 1
	},
/turf/open/floor/plasteel/stairs,
/area/violence)
"mF" = (
/obj/effect/bump_teleporter{
	id = "dt4";
	id_target = "dt4t"
	},
/obj/effect/turf_decal/weather/side{
	dir = 1
	},
/turf/open/floor/plasteel/stairs,
/area/violence)
"mR" = (
/obj/structure/barricade/wooden,
/obj/effect/turf_decal/weather/side{
	dir = 5
	},
/turf/open/floor/plating/beach/sand,
/area/violence)
"os" = (
/obj/effect/turf_decal/weather/side/corner,
/obj/effect/turf_decal/weather/side/corner{
	dir = 1
	},
/turf/open/floor/plating/sandy_dirt,
/area/violence)
"pB" = (
/obj/effect/turf_decal/weather/side{
	dir = 4
	},
/turf/open/floor/plasteel/stairs{
	dir = 1
	},
/area/violence)
"pX" = (
/obj/effect/bump_teleporter{
	id = "dt4t";
	id_target = "dt4"
	},
/turf/open/floor/plasteel/stairs,
/area/violence)
"qA" = (
/obj/structure/barricade/security/ctf,
/obj/effect/turf_decal/weather/side{
	dir = 1
	},
/turf/open/floor/plating/beach/sand,
/area/violence)
"ra" = (
/obj/effect/bump_teleporter{
	id = "dt2";
	id_target = "dt2t"
	},
/obj/effect/turf_decal/weather/side{
	dir = 1
	},
/turf/open/floor/plasteel/stairs,
/area/violence)
"rh" = (
/obj/effect/turf_decal/weather/side{
	dir = 1
	},
/obj/effect/turf_decal/weather/side{
	dir = 8
	},
/turf/open/floor/plating/beach/sand,
/area/violence)
"rs" = (
/obj/structure/barricade/security/ctf,
/obj/effect/turf_decal/weather/side,
/turf/open/floor/plating/beach/sand,
/area/violence)
"rK" = (
/obj/structure/barricade/security/ctf,
/obj/effect/turf_decal/weather/side{
	dir = 4
	},
/turf/open/floor/plating/sandy_dirt,
/area/violence)
"sj" = (
/obj/machinery/door/poddoor/multi_tile/three_tile_hor{
	resistance_flags = 115
	},
/turf/open/floor/plating/sandy_dirt,
/area/violence)
"sG" = (
/turf/closed/indestructible/black,
/area/violence)
"ug" = (
/obj/structure/barricade/wooden,
/obj/effect/turf_decal/weather/side{
	dir = 8
	},
/turf/open/floor/plating/beach/sand,
/area/violence)
"uj" = (
/obj/effect/turf_decal/weather/side{
	dir = 9
	},
/turf/open/floor/plating/beach/sand,
/area/violence)
"uD" = (
/obj/effect/turf_decal/weather/side{
	dir = 1
	},
/turf/open/floor/plating/beach/sand,
/area/violence)
"vw" = (
/obj/machinery/door/poddoor/multi_tile/two_tile_ver{
	resistance_flags = 115
	},
/turf/open/floor/plating/beach/sand,
/area/violence)
"wB" = (
/obj/effect/bump_teleporter{
	id = "dd2t";
	id_target = "dd2"
	},
/turf/open/floor/plasteel/stairs{
	dir = 1
	},
/area/violence)
"wK" = (
/obj/machinery/door/poddoor/multi_tile/three_tile_hor{
	resistance_flags = 115
	},
/turf/open/floor/plating/beach/sand,
/area/violence)
"wT" = (
/turf/open/floor/plating/beach/sand,
/area/violence)
"xj" = (
/turf/closed/indestructible/sandstone,
/area/violence)
"xv" = (
/obj/effect/turf_decal/box/red/corners,
/turf/open/floor/plating/beach/sand,
/area/violence)
"xO" = (
/obj/effect/bump_teleporter{
	id = "dd5";
	id_target = "dd5t"
	},
/obj/effect/turf_decal/weather/side,
/turf/open/floor/plasteel/stairs{
	dir = 1
	},
/area/violence)
"yq" = (
/obj/effect/bump_teleporter{
	id = "dt5t";
	id_target = "dt5"
	},
/turf/open/floor/plasteel/stairs,
/area/violence)
"yF" = (
/obj/structure/barricade/security/ctf,
/obj/effect/turf_decal/weather/side{
	dir = 8
	},
/turf/open/floor/plating/beach/sand,
/area/violence)
"yV" = (
/obj/effect/landmark/start/combatant/blue,
/turf/open/floor/plating/sandy_dirt,
/area/violence)
"zo" = (
/obj/effect/turf_decal/weather/side{
	dir = 8
	},
/obj/effect/turf_decal/weather/side{
	dir = 4
	},
/turf/open/floor/plating/sandy_dirt,
/area/violence)
"Aq" = (
/obj/effect/turf_decal/weather/side,
/turf/open/floor/plating/sandy_dirt,
/area/violence)
"AN" = (
/obj/structure/barricade/sandbags,
/turf/open/floor/plating/beach/sand,
/area/violence)
"AS" = (
/obj/effect/turf_decal/weather/side/corner{
	dir = 8
	},
/turf/open/floor/plating/beach/sand,
/area/violence)
"Bd" = (
/obj/effect/landmark/start/combatant/red,
/turf/open/floor/plating/sandy_dirt,
/area/violence)
"Bm" = (
/obj/effect/bump_teleporter{
	id = "dt3t";
	id_target = "dt3"
	},
/turf/open/floor/plasteel/stairs,
/area/violence)
"BW" = (
/obj/effect/turf_decal/weather/side/corner,
/turf/open/floor/plating/beach/sand,
/area/violence)
"Cp" = (
/obj/effect/turf_decal/box/red/corners{
	dir = 4
	},
/turf/open/floor/plating/sandy_dirt,
/area/violence)
"Dg" = (
/obj/effect/turf_decal/box/red,
/obj/effect/landmark/bomb_plant_location,
/turf/open/floor/plating/sandy_dirt,
/area/violence)
"Dr" = (
/obj/effect/turf_decal/weather/side{
	dir = 1
	},
/turf/open/floor/plasteel/stairs{
	dir = 8
	},
/area/violence)
"DU" = (
/obj/effect/bump_teleporter{
	id = "dd4";
	id_target = "dd4t"
	},
/obj/effect/turf_decal/weather/side,
/turf/open/floor/plasteel/stairs{
	dir = 1
	},
/area/violence)
"DV" = (
/obj/effect/bump_teleporter{
	id = "dd9t";
	id_target = "dd9"
	},
/turf/open/floor/plasteel/stairs{
	dir = 1
	},
/area/violence)
"Fe" = (
/obj/structure/barricade/security/ctf,
/obj/effect/turf_decal/weather/side{
	dir = 5
	},
/turf/open/floor/plating/beach/sand,
/area/violence)
"Fw" = (
/obj/effect/bump_teleporter{
	id = "dd2";
	id_target = "dd2t"
	},
/obj/effect/turf_decal/weather/side,
/turf/open/floor/plasteel/stairs{
	dir = 1
	},
/area/violence)
"FD" = (
/obj/effect/turf_decal/box/red,
/obj/effect/landmark/bomb_plant_location,
/turf/open/floor/plating/beach/sand,
/area/violence)
"FF" = (
/obj/effect/turf_decal/weather/side{
	dir = 8
	},
/turf/open/floor/plating/beach/sand,
/area/violence)
"Gs" = (
/turf/open/floor/plating/sandy_dirt,
/area/violence)
"Gu" = (
/obj/effect/baseturf_helper/dune,
/turf/closed/indestructible/sandstone,
/area/violence)
"GB" = (
/obj/effect/bump_teleporter{
	id = "dd1";
	id_target = "dd1t"
	},
/obj/effect/turf_decal/weather/side{
	dir = 6
	},
/turf/open/floor/plasteel/stairs{
	dir = 1
	},
/area/violence)
"Ik" = (
/obj/effect/bump_teleporter{
	id = "dd9";
	id_target = "dd9t"
	},
/obj/effect/turf_decal/weather/side,
/turf/open/floor/plasteel/stairs{
	dir = 1
	},
/area/violence)
"In" = (
/obj/effect/turf_decal/weather/side/corner{
	dir = 1
	},
/turf/open/floor/plating/beach/sand,
/area/violence)
"IT" = (
/obj/effect/bump_teleporter{
	id = "dd10";
	id_target = "dd10t"
	},
/obj/effect/turf_decal/weather/side{
	dir = 10
	},
/turf/open/floor/plasteel/stairs{
	dir = 1
	},
/area/violence)
"IU" = (
/obj/structure/barricade/security/ctf,
/turf/open/floor/plating/sandy_dirt,
/area/violence)
"JM" = (
/obj/machinery/door/poddoor/multi_tile/four_tile_hor{
	resistance_flags = 115
	},
/turf/open/floor/plating/beach/sand,
/area/violence)
"JQ" = (
/obj/effect/bump_teleporter{
	id = "dd7";
	id_target = "dd7t"
	},
/obj/effect/turf_decal/weather/side,
/turf/open/floor/plasteel/stairs{
	dir = 1
	},
/area/violence)
"Kw" = (
/turf/open/floor/plasteel/stairs,
/area/violence)
"KA" = (
/obj/effect/bump_teleporter{
	id = "dd1t";
	id_target = "dd1"
	},
/turf/open/floor/plasteel/stairs{
	dir = 1
	},
/area/violence)
"Lo" = (
/obj/machinery/door/poddoor/multi_tile/two_tile_hor{
	resistance_flags = 115
	},
/turf/open/floor/plating/beach/sand,
/area/violence)
"Lp" = (
/obj/effect/turf_decal/box/red/corners{
	dir = 1
	},
/turf/open/floor/plating/sandy_dirt,
/area/violence)
"LW" = (
/obj/effect/turf_decal/weather/side{
	dir = 10
	},
/turf/open/floor/plating/beach/sand,
/area/violence)
"Mh" = (
/obj/structure/barricade/wooden,
/turf/open/floor/plating/beach/sand,
/area/violence)
"MD" = (
/obj/effect/bump_teleporter{
	id = "dd3";
	id_target = "dd3t"
	},
/obj/effect/turf_decal/weather/side,
/turf/open/floor/plasteel/stairs{
	dir = 1
	},
/area/violence)
"MV" = (
/obj/effect/bump_teleporter{
	id = "dd10t";
	id_target = "dd10"
	},
/turf/open/floor/plasteel/stairs{
	dir = 1
	},
/area/violence)
"MY" = (
/obj/effect/landmark/start/combatant/blue,
/turf/open/floor/plating/beach/sand,
/area/violence)
"Nx" = (
/turf/open/floor/plasteel/stairs{
	dir = 8
	},
/area/violence)
"Oe" = (
/obj/effect/turf_decal/box/red/corners{
	dir = 4
	},
/turf/open/floor/plating/beach/sand,
/area/violence)
"Oy" = (
/obj/effect/bump_teleporter{
	id = "dd8";
	id_target = "dd8t"
	},
/obj/effect/turf_decal/weather/side,
/turf/open/floor/plasteel/stairs{
	dir = 1
	},
/area/violence)
"OQ" = (
/obj/effect/turf_decal/weather/side{
	dir = 1
	},
/turf/open/floor/plating/sandy_dirt,
/area/violence)
"Pn" = (
/obj/structure/barricade/wooden,
/obj/effect/turf_decal/weather/side{
	dir = 4
	},
/turf/open/floor/plating/beach/sand,
/area/violence)
"Qg" = (
/obj/effect/turf_decal/box/red/corners{
	dir = 1
	},
/turf/open/floor/plating/beach/sand,
/area/violence)
"Rh" = (
/turf/template_noop,
/area/template_noop)
"Rr" = (
/obj/structure/barricade/wooden,
/turf/open/floor/plating/sandy_dirt,
/area/violence)
"RO" = (
/obj/effect/bump_teleporter{
	id = "dd7t";
	id_target = "dd7"
	},
/turf/open/floor/plasteel/stairs{
	dir = 1
	},
/area/violence)
"St" = (
/obj/effect/turf_decal/weather/side{
	dir = 4
	},
/turf/open/floor/plating/sandy_dirt,
/area/violence)
"SY" = (
/turf/open/floor/plasteel/stairs{
	dir = 1
	},
/area/violence)
"Tp" = (
/obj/effect/bump_teleporter{
	id = "dd4t";
	id_target = "dd4"
	},
/turf/open/floor/plasteel/stairs{
	dir = 1
	},
/area/violence)
"Tq" = (
/obj/effect/bump_teleporter{
	id = "dd6t";
	id_target = "dd6"
	},
/turf/open/floor/plasteel/stairs{
	dir = 1
	},
/area/violence)
"TT" = (
/obj/effect/landmark/observer_start,
/obj/effect/turf_decal/weather/side,
/turf/open/floor/plating/beach/sand,
/area/violence)
"Ul" = (
/obj/machinery/door/poddoor/multi_tile/four_tile_ver{
	resistance_flags = 115
	},
/turf/open/floor/plating/beach/sand,
/area/violence)
"UB" = (
/obj/structure/barricade/wooden,
/obj/effect/turf_decal/weather/side,
/turf/open/floor/plating/beach/sand,
/area/violence)
"UE" = (
/obj/effect/turf_decal/box/red/corners,
/turf/open/floor/plating/sandy_dirt,
/area/violence)
"WY" = (
/obj/effect/turf_decal/weather/side/corner{
	dir = 4
	},
/turf/open/floor/plating/beach/sand,
/area/violence)
"XY" = (
/obj/structure/barricade/security/ctf,
/turf/open/floor/plating/beach/sand,
/area/violence)
"Yc" = (
/obj/structure/barricade/wooden,
/obj/effect/turf_decal/weather/side{
	dir = 1
	},
/turf/open/floor/plating/beach/sand,
/area/violence)
"Yk" = (
/obj/effect/turf_decal/weather/side{
	dir = 5
	},
/turf/open/floor/plating/beach/sand,
/area/violence)
"Ym" = (
/obj/effect/bump_teleporter{
	id = "dt3";
	id_target = "dt3t"
	},
/obj/effect/turf_decal/weather/side{
	dir = 1
	},
/turf/open/floor/plasteel/stairs,
/area/violence)
"Yr" = (
/obj/structure/barricade/wooden,
/obj/effect/turf_decal/weather/side{
	dir = 9
	},
/turf/open/floor/plating/beach/sand,
/area/violence)
"ZD" = (
/obj/machinery/door/poddoor/multi_tile/four_tile_hor{
	resistance_flags = 115
	},
/turf/open/floor/plating/sandy_dirt,
/area/violence)
"ZO" = (
/obj/effect/turf_decal/box/red/corners{
	dir = 8
	},
/turf/open/floor/plating/beach/sand,
/area/violence)

(1,1,1) = {"
Rh
Rh
Rh
Rh
Rh
sG
sG
sG
sG
sG
sG
sG
Rh
Rh
Rh
Rh
Rh
Rh
Rh
Rh
Rh
Rh
Rh
Rh
Rh
Rh
Rh
Rh
Rh
Rh
Rh
Rh
Rh
Rh
Rh
Rh
Rh
Rh
Rh
Rh
Rh
Rh
Rh
Rh
Rh
Rh
Rh
Rh
Rh
Rh
Rh
Rh
Rh
Rh
Rh
Rh
Rh
Rh
Rh
Rh
Rh
Rh
Rh
Rh
Rh
Rh
Rh
Rh
Rh
Rh
Rh
"}
(2,1,1) = {"
Rh
Rh
Rh
Rh
sG
sG
xj
xj
xj
xj
xj
sG
sG
sG
sG
sG
sG
sG
sG
Rh
Rh
Rh
Rh
Rh
Rh
Rh
Rh
Rh
Rh
Rh
Rh
Rh
Rh
Rh
Rh
Rh
Rh
Rh
Rh
Rh
Rh
Rh
Rh
Rh
Rh
Rh
Rh
Rh
Rh
Rh
Rh
Rh
Rh
Rh
Rh
Rh
Rh
Rh
Rh
Rh
sG
sG
sG
sG
sG
sG
sG
sG
sG
Rh
Rh
"}
(3,1,1) = {"
Rh
Rh
Rh
Rh
sG
Gu
xj
Gs
Gs
Gs
xj
xj
xj
xj
xj
xj
xj
xj
sG
Rh
Rh
Rh
Rh
Rh
Rh
Rh
Rh
Rh
Rh
Rh
Rh
Rh
Rh
Rh
Rh
Rh
Rh
Rh
Rh
Rh
Rh
Rh
Rh
Rh
Rh
Rh
Rh
Rh
Rh
Rh
Rh
Rh
Rh
Rh
Rh
Rh
Rh
Rh
Rh
Rh
sG
xj
xj
xj
xj
xj
xj
xj
sG
Rh
Rh
"}
(4,1,1) = {"
Rh
Rh
Rh
Rh
sG
xj
wT
Gs
Gs
Gs
wT
wT
wT
wT
wT
Mh
Mh
xj
sG
Rh
Rh
Rh
Rh
Rh
Rh
Rh
Rh
Rh
Rh
Rh
Rh
Rh
Rh
Rh
Rh
Rh
Rh
Rh
Rh
Rh
Rh
Rh
Rh
Rh
Rh
Rh
Rh
Rh
Rh
Rh
Rh
Rh
Rh
Rh
Rh
Rh
Rh
Rh
Rh
Rh
sG
xj
wT
wT
wT
wT
wT
xj
sG
Rh
Rh
"}
(5,1,1) = {"
Rh
Rh
Rh
Rh
sG
xj
wT
Gs
Gs
Gs
wT
wT
wT
wT
wT
Mh
Mh
xj
sG
Rh
Rh
Rh
Rh
Rh
Rh
Rh
Rh
Rh
Rh
Rh
Rh
Rh
Rh
Rh
Rh
Rh
Rh
Rh
Rh
Rh
Rh
Rh
Rh
Rh
Rh
Rh
Rh
Rh
Rh
Rh
Rh
Rh
Rh
Rh
Rh
Rh
Rh
Rh
Rh
Rh
sG
xj
Mh
Mh
Mh
Mh
Mh
xj
sG
Rh
Rh
"}
(6,1,1) = {"
Rh
Rh
Rh
Rh
sG
xj
wT
Gs
Gs
Gs
wT
wT
wT
wT
wT
wT
wT
xj
sG
sG
Rh
Rh
Rh
Rh
Rh
Rh
Rh
Rh
Rh
Rh
Rh
Rh
Rh
Rh
Rh
Rh
Rh
Rh
Rh
Rh
Rh
Rh
Rh
Rh
Rh
Rh
Rh
Rh
Rh
Rh
Rh
Rh
Rh
Rh
Rh
Rh
Rh
Rh
Rh
Rh
sG
xj
Mh
Mh
Mh
Mh
Mh
xj
sG
Rh
Rh
"}
(7,1,1) = {"
Rh
Rh
Rh
Rh
sG
xj
wT
Gs
Gs
Gs
AS
FF
FF
FF
FF
FF
FF
xj
xj
sG
sG
sG
sG
sG
sG
sG
sG
sG
sG
sG
sG
sG
Rh
Rh
Rh
Rh
Rh
Rh
Rh
Rh
Rh
Rh
Rh
Rh
Rh
Rh
Rh
Rh
Rh
Rh
Rh
Rh
sG
sG
sG
sG
sG
sG
sG
sG
sG
xj
wT
wT
wT
wT
Mh
xj
sG
Rh
Rh
"}
(8,1,1) = {"
Rh
Rh
Rh
Rh
sG
xj
hP
Gs
Gs
Gs
uD
AN
Nx
Nx
Nx
Nx
Nx
AN
xj
xj
xj
xj
xj
xj
xj
xj
xj
xj
xj
xj
xj
sG
Rh
Rh
Rh
Rh
Rh
Rh
Rh
Rh
Rh
Rh
Rh
Rh
Rh
Rh
Rh
Rh
Rh
Rh
Rh
Rh
sG
xj
xj
xj
xj
xj
xj
xj
xj
xj
wT
wT
wT
wT
wT
xj
sG
Rh
Rh
"}
(9,1,1) = {"
Rh
Rh
Rh
Rh
sG
xj
hP
Gs
Gs
Gs
uD
AN
wT
wT
wT
wT
wT
wT
wT
wT
wT
uD
AN
AN
AN
hP
wT
wT
wT
wT
xj
sG
Rh
Rh
Rh
Rh
Rh
Rh
Rh
Rh
Rh
Rh
Rh
Rh
sG
sG
sG
sG
sG
sG
sG
Rh
sG
xj
hZ
St
St
St
rK
Fe
AN
wT
wT
wT
wT
Mh
Mh
xj
sG
Rh
Rh
"}
(10,1,1) = {"
Rh
Rh
Rh
Rh
sG
xj
hP
Gs
Gs
Gs
uD
AN
wT
wT
wT
wT
wT
wT
wT
wT
wT
WY
eO
eO
eO
BW
wT
wT
wT
wT
xj
sG
Rh
Rh
Rh
Rh
Rh
Rh
Rh
Rh
Rh
Rh
sG
sG
sG
xj
xj
xj
xj
xj
sG
sG
sG
xj
hP
Gs
Gs
Gs
IU
qA
AN
wT
wT
wT
wT
Mh
Mh
xj
sG
Rh
Rh
"}
(11,1,1) = {"
Rh
Rh
Rh
Rh
sG
xj
hP
Gs
Gs
Gs
uD
AN
XY
xv
wT
Oe
wT
wT
wT
wT
wT
wT
wT
wT
wT
wT
wT
wT
wT
wT
xj
sG
Rh
Rh
Rh
Rh
Rh
Rh
Rh
Rh
Rh
Rh
sG
xj
xj
xj
wT
wT
wT
xj
xj
xj
sG
xj
rs
Gs
Gs
Gs
Gs
uD
AN
wT
wT
wT
wT
wT
wT
xj
sG
Rh
Rh
"}
(12,1,1) = {"
Rh
Rh
Rh
Rh
sG
xj
hP
Gs
Gs
Gs
uD
AN
XY
wT
FD
wT
XY
XY
wT
wT
wT
wT
wT
wT
wT
wT
wT
wT
wT
wT
xj
sG
sG
sG
sG
sG
sG
Rh
Rh
Rh
Rh
sG
sG
xj
wT
wT
wT
wT
wT
wT
wT
xj
xj
xj
UB
IU
Gs
Gs
Gs
uD
AN
wT
wT
wT
wT
wT
wT
xj
sG
Rh
Rh
"}
(13,1,1) = {"
Rh
Rh
Rh
Rh
sG
xj
hP
Gs
Gs
Gs
uD
AN
wT
ZO
wT
Qg
XY
XY
wT
wT
wT
wT
wT
wT
wT
wT
wT
wT
wT
wT
xj
xj
xj
xj
xj
xj
sG
Rh
Rh
Rh
Rh
sG
xj
xj
wT
wT
wT
wT
wT
wT
wT
wT
wT
AN
hP
UE
Gs
Cp
Gs
uD
AN
wT
wT
wT
wT
wT
wT
xj
sG
Rh
Rh
"}
(14,1,1) = {"
Rh
Rh
Rh
Rh
sG
xj
hP
Gs
Gs
IU
qA
AN
wT
wT
wT
XY
XY
AN
AN
AN
AN
AN
AN
AN
AN
wT
wT
wT
wT
wT
xj
GB
eO
eO
Yk
xj
sG
Rh
Rh
Rh
Rh
sG
xj
wT
wT
wT
wT
wT
wT
wT
wT
wT
wT
AN
hP
Gs
Dg
Gs
IU
uD
AN
wT
wT
wT
wT
Mh
Mh
xj
sG
Rh
Rh
"}
(15,1,1) = {"
Rh
Rh
Rh
Rh
sG
xj
hP
Gs
Gs
IU
qA
AN
wT
wT
wT
XY
XY
AN
hZ
eO
eO
eO
Pn
mR
AN
wT
wT
wT
wT
wT
xj
Fw
wT
wT
uD
xj
sG
Rh
Rh
Rh
Rh
sG
xj
wT
wT
wT
XY
XY
wT
wT
wT
Mh
Mh
xj
hP
ar
Gs
Lp
IU
uD
AN
wT
wT
wT
wT
Mh
Mh
xj
sG
sG
Rh
"}
(16,1,1) = {"
Rh
Rh
Rh
Rh
sG
xj
hP
Gs
Gs
Gs
uD
AN
wT
wT
wT
wT
wT
AN
hP
wT
wT
wT
Mh
Yc
AN
wT
wT
wT
wT
wT
xj
MD
wT
wT
uD
xj
sG
sG
sG
sG
sG
sG
xj
wT
wT
wT
XY
wT
wT
wT
Mh
Mh
Mh
xj
hP
Gs
Gs
Gs
Gs
uD
AN
AN
ht
ht
ht
AN
AN
xj
xj
sG
Rh
"}
(17,1,1) = {"
Rh
Rh
Rh
Rh
sG
xj
hP
Gs
Gs
Gs
uD
AN
AN
AN
AN
AN
AN
AN
hP
wT
wT
wT
wT
uD
AN
wT
wT
wT
wT
wT
xj
DU
wT
Mh
Yc
xj
xj
xj
xj
xj
xj
xj
xj
wT
wT
wT
wT
wT
wT
wT
Mh
Mh
Mh
xj
hP
Gs
Gs
Gs
Gs
WY
eO
Pn
eO
eO
eO
eO
eO
Yk
xj
sG
Rh
"}
(18,1,1) = {"
Rh
sG
sG
sG
sG
xj
hP
Gs
Gs
Gs
WY
eO
eO
eO
eO
eO
eO
eO
BW
wT
wT
wT
wT
cO
AN
wT
wT
wT
wT
wT
xj
xO
wT
Mh
dv
eO
Pn
Pn
eO
eO
eO
eO
eO
eO
eO
eO
eO
eO
eO
eO
eO
eO
Yk
xj
hP
Gs
Gs
Gs
Gs
wT
wT
wT
wT
wT
wT
wT
wT
uD
xj
sG
Rh
"}
(19,1,1) = {"
Rh
sG
xj
xj
xj
xj
hP
Gs
Gs
Gs
Gs
Gs
Gs
Gs
Gs
Gs
Gs
Gs
Gs
Gs
Gs
Gs
Gs
ra
AN
wT
wT
wT
wT
wT
xj
gB
Gs
Gs
Gs
Gs
Rr
Rr
Gs
Gs
Gs
Gs
Gs
Gs
Gs
Gs
Gs
Gs
Gs
Gs
Gs
Gs
OQ
xj
Aq
Gs
Gs
Gs
Gs
Gs
Gs
Gs
Gs
Gs
Gs
Gs
Gs
OQ
xj
sG
Rh
"}
(20,1,1) = {"
Rh
sG
xj
wT
wT
wT
hP
Gs
Gs
Gs
Gs
Gs
Gs
Gs
Gs
Gs
Gs
Gs
Gs
Gs
Gs
Gs
Gs
Ym
AN
wT
wT
wT
wT
wT
xj
JQ
Gs
Gs
Gs
Gs
Gs
Gs
Gs
Gs
Gs
Gs
Gs
Gs
Gs
Gs
Gs
Gs
Gs
Gs
Gs
Gs
eA
zo
os
Gs
Gs
Gs
Gs
Gs
Gs
Gs
Gs
Gs
Gs
Gs
Gs
OQ
xj
sG
Rh
"}
(21,1,1) = {"
Rh
sG
xj
wT
wT
wT
hP
Gs
Gs
Gs
Gs
Gs
Gs
Gs
Gs
Gs
Gs
Gs
Gs
Gs
Gs
Gs
Gs
mF
AN
wT
wT
wT
wT
wT
xj
Oy
Gs
Gs
Gs
Gs
Gs
Gs
Gs
Gs
Gs
Gs
Gs
Gs
Gs
Gs
Gs
Gs
Gs
Gs
Gs
Gs
OQ
xj
Aq
Gs
Gs
Gs
Gs
Gs
Gs
Gs
Gs
Gs
Gs
Gs
Gs
OQ
xj
sG
Rh
"}
(22,1,1) = {"
Rh
sG
xj
wT
wT
wT
hP
Gs
Gs
Gs
Gs
Gs
Gs
Gs
Gs
Gs
Gs
Gs
Gs
Gs
Gs
Gs
Gs
mE
AN
wT
wT
wT
wT
wT
xj
Ik
Gs
Gs
Gs
Gs
Gs
Gs
Gs
Gs
Gs
Gs
Gs
Gs
Gs
Gs
Gs
Gs
Gs
Gs
Rr
Rr
OQ
xj
Aq
Gs
Gs
Gs
Gs
Gs
Gs
Gs
Gs
Gs
Gs
Gs
Gs
OQ
xj
sG
Rh
"}
(23,1,1) = {"
Rh
sG
xj
wT
wT
wT
hP
Gs
Gs
Gs
wT
xj
xj
xj
wT
wT
wT
wT
wT
wT
wT
xj
xj
xj
xj
wT
wT
wT
wT
wT
xj
IT
FF
FF
FF
FF
FF
yF
In
Gs
Gs
Gs
AS
FF
FF
FF
FF
FF
FF
FF
ug
ug
Yr
xj
hP
wT
wT
wT
wT
wT
wT
wT
wT
wT
wT
wT
wT
uD
xj
sG
Rh
"}
(24,1,1) = {"
Rh
sG
xj
Mh
Mh
wT
hP
Gs
Gs
Gs
wT
xj
sG
xj
xj
xj
xj
xj
xj
xj
xj
xj
sG
sG
xj
wT
wT
wT
wT
wT
xj
xj
xj
xj
xj
xj
xj
xj
hP
Gs
Gs
Gs
uD
xj
xj
xj
xj
xj
xj
xj
xj
xj
xj
xj
LW
In
wT
wT
wT
wT
wT
wT
wT
wT
wT
wT
wT
uD
xj
sG
Rh
"}
(25,1,1) = {"
Rh
sG
xj
Mh
Mh
wT
hP
Gs
Gs
Gs
wT
xj
xj
sG
sG
xj
xj
xj
xj
xj
xj
xj
xj
xj
xj
Mh
Mh
wT
wT
wT
xj
sG
sG
sG
sG
sG
sG
xj
hP
Gs
Gs
Gs
uD
xj
sG
sG
sG
sG
sG
sG
sG
sG
sG
xj
xj
LW
In
wT
wT
wT
AS
FF
ug
FF
FF
FF
FF
uj
xj
sG
Rh
"}
(26,1,1) = {"
Rh
sG
xj
xj
xj
xj
hP
Gs
Gs
Gs
wT
wT
xj
sG
sG
xj
wT
MY
wT
MY
wT
JM
KA
xj
xj
Mh
Mh
wT
wT
wT
xj
sG
Rh
Rh
Rh
Rh
sG
xj
xj
Gs
Gs
Gs
xj
xj
sG
Rh
Rh
Rh
Rh
Rh
Rh
Rh
sG
sG
xj
xj
LW
In
wT
wT
uD
xj
xj
xj
Nx
Nx
Nx
xj
xj
sG
Rh
"}
(27,1,1) = {"
Rh
sG
sG
sG
sG
xj
hP
Gs
Gs
Gs
wT
wT
xj
sG
sG
xj
wT
wT
wT
wT
wT
wT
wB
xj
xj
wT
wT
wT
wT
wT
xj
sG
Rh
Rh
Rh
Rh
sG
sG
xj
xj
Gs
xj
xj
sG
sG
Rh
Rh
Rh
Rh
Rh
Rh
Rh
Rh
sG
sG
xj
xj
LW
In
wT
uD
xj
sG
xj
wT
wT
wT
xj
sG
sG
Rh
"}
(28,1,1) = {"
Rh
Rh
Rh
Rh
sG
xj
hP
Gs
Gs
Gs
wT
wT
xj
sG
sG
xj
wT
MY
wT
MY
wT
wT
iq
xj
xj
wT
wT
wT
wT
wT
xj
sG
Rh
Rh
Rh
Rh
sG
xj
xj
Gs
Gs
Gs
xj
xj
sG
Rh
Rh
Rh
Rh
Rh
Rh
Rh
Rh
Rh
sG
sG
xj
xj
Mh
Mh
uD
xj
sG
xj
wT
wT
wT
xj
sG
Rh
Rh
"}
(29,1,1) = {"
Rh
Rh
Rh
Rh
sG
xj
hP
Gs
Gs
Gs
wT
wT
xj
sG
xj
xj
wK
wT
wT
wT
wT
wT
Tp
xj
xj
wT
wT
wT
wT
wT
xj
sG
Rh
Rh
Rh
sG
sG
xj
hP
Gs
Gs
Gs
uD
xj
sG
Rh
Rh
Rh
Rh
Rh
Rh
Rh
Rh
Rh
Rh
sG
sG
xj
Mh
Mh
uD
xj
sG
xj
wT
wT
wT
xj
sG
Rh
Rh
"}
(30,1,1) = {"
Rh
Rh
Rh
Rh
sG
xj
hP
Gs
Gs
Gs
wT
wT
xj
sG
xj
lZ
wT
MY
wT
MY
wT
Lo
kW
xj
xj
AN
AN
ht
ht
ht
xj
sG
sG
sG
sG
sG
xj
xj
hP
Gs
Gs
Gs
uD
xj
sG
sG
sG
sG
sG
sG
sG
sG
sG
sG
sG
Rh
sG
xj
LW
FF
uj
xj
sG
xj
wT
wT
wT
xj
sG
Rh
Rh
"}
(31,1,1) = {"
Rh
Rh
Rh
Rh
sG
xj
hP
Gs
Gs
Gs
wT
wT
xj
sG
xj
cV
Gs
Gs
Gs
Gs
Gs
Gs
Tq
xj
xj
Yk
AN
ht
ht
ht
xj
sG
sG
xj
xj
xj
xj
AN
hP
Gs
Gs
Gs
uD
xj
xj
xj
xj
xj
xj
xj
xj
xj
xj
xj
sG
Rh
sG
xj
xj
xj
xj
xj
sG
xj
wT
wT
wT
xj
sG
Rh
Rh
"}
(32,1,1) = {"
Rh
Rh
Rh
Rh
sG
xj
hP
Gs
Gs
Gs
wT
wT
xj
sG
xj
Bm
sj
yV
Gs
yV
Gs
ZD
RO
xj
xj
uD
AN
ht
ht
ht
xj
xj
xj
xj
wT
wT
wT
AN
hP
Gs
Gs
Gs
uD
xj
wT
wT
wT
wT
wT
wT
wT
Mh
Mh
xj
sG
Rh
sG
sG
sG
sG
sG
sG
sG
xj
wT
wT
wT
xj
sG
Rh
Rh
"}
(33,1,1) = {"
Rh
Rh
Rh
Rh
sG
xj
hP
Gs
Gs
Gs
wT
wT
xj
sG
xj
pX
Gs
Gs
Gs
Gs
Gs
Gs
bP
xj
xj
WY
eO
eO
eO
eO
BW
Mh
Mh
wT
wT
wT
wT
AN
UB
Rr
Gs
Gs
uD
wT
wT
wT
wT
wT
wT
wT
wT
wT
wT
xj
sG
Rh
Rh
Rh
Rh
Rh
Rh
Rh
sG
xj
wT
wT
wT
xj
sG
Rh
Rh
"}
(34,1,1) = {"
Rh
Rh
Rh
Rh
sG
xj
hP
Gs
Gs
Gs
wT
wT
xj
sG
xj
yq
Gs
yV
Gs
yV
Gs
Gs
DV
xj
xj
wT
wT
wT
wT
wT
wT
wT
wT
wT
wT
wT
wT
AN
UB
Rr
Gs
Gs
uD
wT
wT
wT
wT
wT
wT
wT
wT
wT
wT
xj
sG
sG
sG
sG
sG
sG
sG
sG
sG
xj
wT
wT
wT
xj
sG
sG
sG
"}
(35,1,1) = {"
Rh
Rh
Rh
Rh
sG
xj
hP
Gs
Gs
Gs
wT
xj
xj
sG
xj
xj
xj
xj
xj
xj
wT
wT
MV
xj
xj
Mh
Mh
wT
wT
wT
wT
wT
wT
wT
wT
wT
wT
AN
hP
Gs
Gs
Gs
uD
wT
wT
Mh
Mh
wT
wT
wT
wT
wT
AS
xj
xj
xj
xj
xj
xj
xj
xj
xj
xj
xj
wT
wT
wT
xj
xj
xj
sG
"}
(36,1,1) = {"
Rh
Rh
Rh
Rh
sG
xj
hP
Gs
Gs
Gs
wT
xj
sG
sG
sG
sG
sG
sG
sG
xj
xj
xj
xj
xj
xj
Mh
Mh
wT
wT
wT
wT
wT
wT
wT
wT
wT
wT
AN
TT
Gs
Gs
Gs
uD
xj
wT
Mh
Mh
wT
wT
AS
FF
FF
rh
AN
Mh
Mh
wT
wT
wT
wT
wT
wT
wT
wT
wT
wT
wT
Mh
Mh
xj
sG
"}
(37,1,1) = {"
Rh
Rh
Rh
Rh
sG
xj
hP
Gs
Gs
Gs
wT
xj
xj
xj
xj
xj
xj
xj
xj
sG
sG
sG
sG
sG
xj
xj
xj
xj
xj
xj
xj
xj
xj
xj
wT
wT
wT
AN
hP
Gs
Gs
Gs
uD
xj
xj
xj
xj
xj
xj
xj
Nx
Nx
Dr
AN
wT
wT
wT
wT
wT
wT
wT
wT
wT
wT
wT
wT
wT
Mh
Mh
xj
sG
"}
(38,1,1) = {"
Rh
Rh
Rh
Rh
sG
xj
hP
Gs
Gs
Gs
wT
wT
wT
wT
XY
Mh
Mh
wT
xj
xj
xj
xj
xj
sG
sG
sG
sG
sG
sG
sG
sG
sG
sG
xj
wT
wT
wT
AN
hP
Gs
Gs
Gs
uD
xj
sG
sG
sG
sG
sG
xj
Nx
Nx
Dr
AN
AN
wT
wT
wT
wT
wT
wT
wT
wT
wT
wT
wT
wT
wT
wT
xj
sG
"}
(39,1,1) = {"
Rh
Rh
Rh
Rh
sG
xj
hP
Gs
Gs
Gs
wT
wT
wT
wT
wT
Mh
Mh
wT
wT
wT
wT
wT
xj
xj
sG
Rh
Rh
Rh
Rh
Rh
Rh
Rh
sG
xj
wT
wT
wT
AN
hP
Gs
Gs
Gs
uD
xj
sG
Rh
Rh
Rh
sG
xj
wT
wT
uD
pB
pB
BW
wT
wT
wT
wT
wT
wT
wT
wT
wT
wT
wT
wT
wT
xj
sG
"}
(40,1,1) = {"
Rh
Rh
Rh
Rh
sG
xj
hP
Gs
Gs
Gs
wT
wT
wT
wT
wT
wT
wT
wT
wT
wT
wT
wT
wT
xj
sG
Rh
Rh
Rh
Rh
Rh
Rh
Rh
sG
xj
wT
wT
wT
AN
hP
Gs
Gs
Gs
uD
xj
sG
Rh
Rh
Rh
sG
xj
wT
wT
uD
SY
SY
wT
wT
wT
wT
wT
wT
wT
wT
wT
wT
wT
wT
wT
wT
xj
sG
"}
(41,1,1) = {"
sG
sG
sG
sG
sG
xj
hP
Gs
Gs
Gs
wT
wT
wT
wT
wT
wT
wT
wT
wT
wT
wT
wT
wT
xj
sG
Rh
Rh
Rh
Rh
Rh
Rh
Rh
sG
xj
wT
wT
wT
AN
hP
Gs
Gs
Gs
uD
xj
sG
Rh
Rh
Rh
sG
xj
xj
xj
xj
xj
xj
xj
xj
wT
wT
wT
xj
xj
xj
xj
xj
xj
xj
xj
xj
xj
sG
"}
(42,1,1) = {"
sG
xj
xj
xj
xj
xj
hP
Gs
Gs
Gs
wT
wT
wT
wT
wT
wT
wT
wT
wT
wT
wT
wT
wT
xj
sG
Rh
Rh
Rh
Rh
Rh
Rh
Rh
sG
xj
wT
wT
wT
AN
hP
Gs
Gs
Gs
uD
xj
sG
Rh
Rh
Rh
sG
sG
sG
sG
sG
sG
sG
sG
xj
wT
wT
wT
xj
sG
sG
sG
sG
sG
sG
sG
sG
sG
sG
"}
(43,1,1) = {"
sG
xj
Mh
wT
wT
AN
hP
Gs
Gs
Gs
Gs
Gs
Gs
Gs
Gs
Gs
Gs
Gs
Gs
Gs
Gs
Gs
Gs
xj
sG
Rh
Rh
Rh
Rh
Rh
Rh
Rh
sG
xj
wT
wT
wT
AN
hP
Gs
Gs
Gs
uD
xj
sG
Rh
Rh
Rh
Rh
Rh
Rh
Rh
Rh
Rh
Rh
sG
xj
wT
wT
wT
xj
sG
Rh
Rh
Rh
Rh
Rh
Rh
Rh
Rh
Rh
"}
(44,1,1) = {"
sG
xj
wT
wT
wT
AN
hP
Gs
Gs
Gs
Gs
Gs
Gs
Gs
Gs
Gs
Gs
Gs
Gs
Gs
Gs
Gs
Gs
xj
sG
Rh
Rh
Rh
Rh
Rh
Rh
Rh
sG
xj
wT
wT
wT
AN
hP
Gs
Gs
Gs
uD
xj
sG
Rh
Rh
Rh
Rh
Rh
Rh
Rh
Rh
Rh
Rh
sG
xj
wT
wT
wT
xj
sG
Rh
Rh
Rh
Rh
Rh
Rh
Rh
Rh
Rh
"}
(45,1,1) = {"
sG
xj
wT
wT
wT
Kw
hP
Gs
Gs
Gs
Gs
Gs
Gs
Gs
Gs
Gs
Gs
Gs
Gs
Gs
Gs
Gs
Gs
xj
sG
Rh
Rh
Rh
Rh
Rh
Rh
Rh
sG
xj
wT
wT
wT
wT
hP
Gs
Gs
Gs
uD
xj
sG
sG
Rh
Rh
Rh
Rh
Rh
Rh
Rh
Rh
Rh
sG
xj
wT
wT
wT
xj
sG
Rh
Rh
Rh
Rh
Rh
Rh
Rh
Rh
Rh
"}
(46,1,1) = {"
sG
xj
wT
wT
wT
Kw
hP
Gs
Gs
Gs
wT
wT
wT
wT
wT
wT
wT
xj
xj
Gs
Gs
Gs
xj
xj
sG
Rh
Rh
Rh
Rh
Rh
Rh
Rh
sG
xj
wT
wT
wT
wT
hP
Gs
Gs
Gs
uD
xj
xj
sG
sG
sG
Rh
Rh
Rh
Rh
Rh
Rh
Rh
sG
xj
wT
wT
wT
xj
sG
Rh
Rh
Rh
Rh
Rh
Rh
Rh
Rh
Rh
"}
(47,1,1) = {"
sG
xj
wT
wT
wT
AN
hP
Gs
Gs
Gs
uD
AN
wT
wT
wT
wT
wT
xj
wT
Gs
Gs
Gs
wT
xj
sG
Rh
Rh
Rh
Rh
Rh
Rh
Rh
sG
xj
wT
wT
wT
wT
wT
Gs
Gs
Gs
wT
wT
xj
xj
xj
sG
Rh
Rh
Rh
sG
sG
sG
sG
sG
xj
wT
wT
wT
xj
sG
sG
sG
sG
sG
Rh
Rh
Rh
Rh
Rh
"}
(48,1,1) = {"
sG
xj
wT
wT
wT
AN
hP
Gs
Gs
Gs
uD
AN
wT
wT
wT
wT
wT
xj
Mh
Rr
Gs
Gs
wT
xj
sG
sG
sG
sG
sG
sG
sG
sG
sG
xj
wT
wT
wT
wT
wT
Gs
Gs
Gs
wT
wT
XY
XY
xj
sG
Rh
Rh
Rh
sG
xj
xj
xj
xj
xj
wT
wT
wT
xj
xj
xj
xj
xj
sG
Rh
Rh
Rh
Rh
Rh
"}
(49,1,1) = {"
sG
xj
Mh
wT
wT
AN
hP
Gs
Gs
Gs
uD
AN
wT
wT
wT
wT
wT
xj
Mh
Rr
Gs
Gs
wT
xj
sG
sG
xj
xj
xj
xj
sG
xj
xj
xj
wT
wT
wT
wT
wT
Gs
Gs
Gs
wT
wT
XY
XY
xj
sG
Rh
Rh
Rh
sG
xj
wT
wT
wT
wT
wT
wT
wT
wT
wT
Mh
Mh
xj
sG
Rh
Rh
Rh
Rh
Rh
"}
(50,1,1) = {"
sG
xj
xj
xj
xj
AN
hP
Gs
Gs
Gs
uD
AN
wT
wT
wT
wT
wT
xj
wT
Gs
Gs
Gs
wT
xj
sG
sG
xj
wT
wT
xj
xj
xj
wT
wT
wT
wT
wT
wT
wT
Gs
Gs
Gs
Gs
Gs
Gs
Gs
xj
sG
Rh
Rh
Rh
sG
xj
wT
wT
wT
wT
wT
wT
wT
wT
wT
Mh
Mh
xj
sG
Rh
Rh
Rh
Rh
Rh
"}
(51,1,1) = {"
sG
sG
sG
sG
xj
xj
hP
Gs
Gs
Gs
uD
xj
xj
xj
wT
wT
wT
xj
wT
Gs
Gs
Gs
wT
xj
sG
sG
xj
wT
wT
wT
wT
wT
wT
wT
wT
wT
wT
wT
wT
Gs
Gs
Gs
Gs
Gs
Gs
Gs
xj
sG
Rh
Rh
Rh
sG
xj
wT
wT
wT
wT
wT
wT
wT
wT
wT
wT
wT
xj
sG
Rh
Rh
Rh
Rh
Rh
"}
(52,1,1) = {"
Rh
Rh
Rh
sG
sG
xj
hP
Gs
Gs
Gs
uD
xj
sG
xj
xj
Mh
Mh
xj
wT
Gs
Gs
Gs
wT
xj
sG
sG
xj
wT
wT
wT
wT
wT
wT
wT
wT
wT
wT
wT
wT
Gs
Gs
Gs
Gs
Gs
Gs
Gs
xj
sG
Rh
Rh
Rh
sG
xj
wT
wT
wT
wT
wT
wT
wT
wT
wT
wT
wT
xj
sG
Rh
Rh
Rh
Rh
Rh
"}
(53,1,1) = {"
Rh
Rh
Rh
Rh
sG
xj
UB
Gs
Gs
Gs
uD
xj
sG
sG
xj
Mh
Mh
xj
wT
Gs
Gs
Gs
wT
xj
sG
sG
xj
Mh
wT
wT
wT
wT
wT
wT
wT
wT
wT
wT
wT
Gs
Gs
Gs
Gs
Gs
Gs
Gs
xj
sG
Rh
Rh
Rh
sG
xj
ht
ht
ht
ht
ht
ht
ht
ht
ht
ht
ht
xj
sG
Rh
Rh
Rh
Rh
Rh
"}
(54,1,1) = {"
Rh
Rh
Rh
Rh
sG
xj
UB
Gs
Gs
Gs
uD
xj
sG
sG
xj
xj
xj
xj
wT
Gs
Gs
Gs
wT
xj
sG
sG
xj
wT
wT
wT
wT
wT
wT
wT
wT
wT
wT
wT
XY
XY
wT
wT
wT
wT
Mh
Mh
xj
sG
Rh
Rh
Rh
sG
xj
St
St
St
St
St
St
St
St
St
St
St
xj
sG
Rh
Rh
Rh
Rh
Rh
"}
(55,1,1) = {"
Rh
Rh
Rh
Rh
sG
xj
hP
Gs
Gs
Gs
Yc
xj
sG
sG
sG
sG
sG
xj
xj
xj
Gs
xj
xj
xj
xj
xj
xj
wT
wT
wT
wT
wT
wT
wT
wT
wT
wT
wT
XY
XY
wT
wT
wT
wT
Mh
Mh
xj
sG
Rh
Rh
Rh
sG
xj
Gs
Gs
Gs
Gs
Gs
Gs
Gs
Gs
Gs
Gs
Gs
xj
sG
Rh
Rh
Rh
Rh
Rh
"}
(56,1,1) = {"
Rh
Rh
Rh
Rh
sG
xj
hP
Gs
Gs
Gs
Yc
xj
sG
Rh
Rh
Rh
sG
xj
wT
Gs
Gs
Gs
wT
wT
wT
wT
wT
wT
wT
wT
wT
wT
wT
xj
xj
xj
xj
xj
xj
xj
xj
wT
uD
xj
xj
xj
xj
sG
Rh
Rh
Rh
sG
xj
Rr
Gs
Gs
Gs
Gs
Gs
Gs
Gs
Gs
Gs
Gs
xj
sG
Rh
Rh
Rh
Rh
Rh
"}
(57,1,1) = {"
Rh
Rh
Rh
Rh
sG
xj
xj
xj
xj
xj
xj
xj
sG
Rh
Rh
Rh
sG
xj
wT
Gs
Gs
Gs
wT
wT
wT
wT
wT
wT
wT
wT
wT
wT
xj
xj
sG
sG
sG
sG
sG
sG
xj
wT
uD
xj
sG
sG
sG
sG
Rh
Rh
Rh
sG
xj
ug
FF
FF
FF
FF
FF
In
Gs
Gs
Gs
AS
xj
sG
Rh
Rh
Rh
Rh
Rh
"}
(58,1,1) = {"
Rh
Rh
Rh
Rh
sG
sG
sG
sG
sG
sG
sG
sG
sG
Rh
Rh
Rh
sG
xj
wT
Gs
Gs
Gs
wT
wT
wT
wT
wT
wT
wT
wT
wT
wT
xj
sG
sG
Rh
Rh
Rh
Rh
sG
xj
wT
Yc
xj
sG
Rh
Rh
Rh
Rh
Rh
Rh
sG
xj
AN
AN
AN
AN
AN
AN
hP
Gs
Gs
Gs
uD
xj
sG
Rh
Rh
Rh
Rh
Rh
"}
(59,1,1) = {"
Rh
Rh
Rh
Rh
Rh
Rh
Rh
Rh
Rh
Rh
Rh
Rh
Rh
Rh
Rh
Rh
sG
xj
wT
Gs
Gs
Gs
wT
wT
wT
wT
wT
wT
wT
wT
wT
wT
xj
xj
sG
sG
sG
sG
sG
sG
xj
wT
Yc
xj
sG
Rh
Rh
Rh
Rh
Rh
Rh
sG
xj
wT
wT
wT
Mh
Mh
AN
hP
Gs
Gs
Gs
uD
xj
sG
Rh
Rh
Rh
Rh
Rh
"}
(60,1,1) = {"
Rh
Rh
Rh
Rh
Rh
Rh
Rh
Rh
Rh
Rh
Rh
Rh
Rh
Rh
Rh
Rh
sG
xj
wT
Gs
Gs
Gs
wT
wT
wT
wT
wT
wT
wT
wT
wT
wT
wT
xj
xj
xj
xj
xj
xj
xj
xj
wT
uD
xj
sG
Rh
Rh
Rh
sG
sG
sG
sG
xj
wT
wT
wT
Mh
Mh
AN
hP
Gs
Gs
Gs
uD
xj
sG
sG
sG
sG
Rh
Rh
"}
(61,1,1) = {"
Rh
Rh
Rh
Rh
Rh
Rh
Rh
Rh
Rh
Rh
Rh
Rh
Rh
Rh
Rh
Rh
sG
xj
wT
Gs
Gs
Gs
wT
wT
wT
wT
wT
wT
wT
wT
wT
wT
wT
wT
wT
wT
wT
wT
wT
wT
wT
wT
uD
xj
sG
Rh
Rh
Rh
sG
xj
xj
xj
xj
wT
wT
wT
wT
Mh
AN
hP
Gs
Gs
Gs
uD
xj
xj
xj
xj
sG
Rh
Rh
"}
(62,1,1) = {"
Rh
Rh
Rh
Rh
Rh
Rh
Rh
Rh
Rh
Rh
Rh
Rh
Rh
Rh
Rh
Rh
sG
xj
wT
Gs
Gs
Gs
wT
wT
wT
wT
wT
wT
wT
wT
wT
wT
wT
wT
AS
FF
FF
FF
FF
FF
FF
FF
uj
xj
sG
sG
sG
sG
sG
xj
Mh
wT
wT
wT
wT
wT
wT
wT
AN
hP
Gs
Gs
Gs
uD
AN
wT
wT
xj
sG
Rh
Rh
"}
(63,1,1) = {"
Rh
Rh
Rh
Rh
Rh
Rh
Rh
Rh
Rh
Rh
Rh
Rh
Rh
Rh
Rh
Rh
sG
xj
wT
Gs
Gs
Gs
wT
wT
wT
wT
Mh
Mh
wT
wT
wT
wT
wT
wT
wT
AN
AN
AN
AN
AN
AN
AN
AN
xj
xj
xj
xj
sG
sG
xj
Mh
Mh
wT
wT
wT
wT
wT
wT
AN
hP
Gs
Gs
Gs
uD
AN
wT
wT
xj
sG
Rh
Rh
"}
(64,1,1) = {"
Rh
Rh
Rh
Rh
Rh
Rh
Rh
Rh
Rh
Rh
Rh
Rh
Rh
Rh
Rh
Rh
sG
xj
xj
Gs
Gs
Gs
xj
xj
xj
xj
Mh
Mh
wT
wT
wT
wT
wT
wT
wT
wT
wT
wT
wT
wT
wT
wT
wT
wT
wT
wT
xj
sG
sG
xj
Mh
Mh
wT
wT
wT
wT
wT
wT
wT
wT
Gs
Gs
Gs
wT
wT
wT
wT
xj
sG
Rh
Rh
"}
(65,1,1) = {"
Rh
Rh
Rh
Rh
Rh
Rh
Rh
Rh
Rh
Rh
Rh
Rh
Rh
Rh
Rh
Rh
sG
sG
xj
xj
xj
xj
xj
sG
sG
xj
xj
wT
wT
wT
wT
wT
wT
wT
wT
wT
wT
wT
wT
wT
wT
wT
wT
wT
wT
Ul
xj
xj
xj
xj
wT
vw
wT
wT
wT
wT
wT
wT
wT
wT
Gs
Gs
Gs
wT
wT
wT
wT
xj
sG
Rh
Rh
"}
(66,1,1) = {"
Rh
Rh
Rh
Rh
Rh
Rh
Rh
Rh
Rh
Rh
Rh
Rh
Rh
Rh
Rh
Rh
Rh
sG
sG
sG
sG
sG
sG
sG
sG
sG
xj
Gs
Gs
Gs
Gs
Gs
Gs
Gs
Gs
Gs
Gs
Gs
Gs
Gs
Gs
Gs
sj
Bd
Gs
Bd
Gs
Gs
Bd
Gs
Bd
sj
Gs
Gs
Gs
Gs
Gs
Gs
Gs
Gs
Gs
Gs
Gs
Gs
Gs
Gs
Gs
xj
sG
Rh
Rh
"}
(67,1,1) = {"
Rh
Rh
Rh
Rh
Rh
Rh
Rh
Rh
Rh
Rh
Rh
Rh
Rh
Rh
Rh
Rh
Rh
Rh
Rh
Rh
Rh
Rh
Rh
Rh
Rh
sG
xj
Gs
Gs
Gs
Gs
Gs
Gs
Gs
Gs
Gs
Gs
Gs
Gs
Gs
Gs
Gs
Gs
Gs
Bd
Gs
Bd
Bd
Gs
Bd
Gs
Gs
Gs
Gs
Gs
Gs
Gs
Gs
Gs
Gs
Gs
Gs
Gs
Gs
Gs
Gs
Gs
xj
sG
Rh
Rh
"}
(68,1,1) = {"
Rh
Rh
Rh
Rh
Rh
Rh
Rh
Rh
Rh
Rh
Rh
Rh
Rh
Rh
Rh
Rh
Rh
Rh
Rh
Rh
Rh
Rh
Rh
Rh
Rh
sG
xj
Gs
Gs
Gs
Gs
Gs
Gs
Gs
Gs
Gs
Gs
Gs
Gs
Gs
Gs
Gs
Gs
Bd
Gs
Bd
Gs
Gs
Bd
Gs
Bd
Gs
Gs
Gs
Gs
Gs
Gs
Gs
Gs
Gs
Gs
Gs
Gs
Gs
Gs
Gs
Gs
xj
sG
Rh
Rh
"}
(69,1,1) = {"
Rh
Rh
Rh
Rh
Rh
Rh
Rh
Rh
Rh
Rh
Rh
Rh
Rh
Rh
Rh
Rh
Rh
Rh
Rh
Rh
Rh
Rh
Rh
Rh
Rh
sG
xj
wT
wT
wT
wT
wT
wT
wT
wT
wT
wT
wT
wT
wT
wT
wT
wT
wT
wT
Ul
xj
xj
xj
xj
wT
vw
wT
wT
wT
wT
wT
wT
wT
wT
wT
wT
wT
wT
wT
wT
wT
xj
sG
Rh
Rh
"}
(70,1,1) = {"
Rh
Rh
Rh
Rh
Rh
Rh
Rh
Rh
Rh
Rh
Rh
Rh
Rh
Rh
Rh
Rh
Rh
Rh
Rh
Rh
Rh
Rh
Rh
Rh
Rh
sG
xj
wT
wT
wT
wT
wT
wT
wT
wT
wT
wT
wT
wT
wT
wT
wT
wT
wT
wT
wT
xj
sG
sG
xj
wT
wT
wT
wT
wT
wT
wT
wT
wT
wT
wT
wT
wT
wT
wT
wT
wT
xj
sG
Rh
Rh
"}
(71,1,1) = {"
Rh
Rh
Rh
Rh
Rh
Rh
Rh
Rh
Rh
Rh
Rh
Rh
Rh
Rh
Rh
Rh
Rh
Rh
Rh
Rh
Rh
Rh
Rh
Rh
Rh
sG
xj
xj
xj
xj
xj
xj
xj
xj
xj
xj
xj
wT
wT
wT
wT
wT
wT
wT
wT
wT
xj
sG
sG
xj
wT
wT
wT
xj
xj
xj
wT
wT
wT
wT
xj
xj
xj
wT
wT
wT
wT
xj
sG
Rh
Rh
"}
(72,1,1) = {"
Rh
Rh
Rh
Rh
Rh
Rh
Rh
Rh
Rh
Rh
Rh
Rh
Rh
Rh
Rh
Rh
Rh
Rh
Rh
Rh
Rh
Rh
Rh
Rh
Rh
sG
sG
sG
sG
sG
sG
sG
sG
sG
sG
sG
xj
xj
xj
xj
xj
xj
xj
xj
xj
xj
xj
sG
sG
xj
xj
xj
xj
xj
xj
xj
xj
xj
xj
xj
xj
xj
xj
xj
xj
xj
xj
xj
sG
Rh
Rh
"}
(73,1,1) = {"
Rh
Rh
Rh
Rh
Rh
Rh
Rh
Rh
Rh
Rh
Rh
Rh
Rh
Rh
Rh
Rh
Rh
Rh
Rh
Rh
Rh
Rh
Rh
Rh
Rh
Rh
Rh
Rh
Rh
Rh
Rh
Rh
Rh
Rh
Rh
sG
sG
sG
sG
sG
sG
sG
sG
sG
sG
sG
sG
sG
sG
sG
sG
sG
sG
sG
sG
sG
sG
sG
sG
sG
sG
sG
sG
sG
sG
sG
sG
sG
sG
Rh
Rh
"}
