//MAP CONVERTED BY dmm2tgm.py THIS HEADER COMMENT PREVENTS RECONVERSION, DO NOT REMOVE
"ac" = (
/obj/effect/gibspawner/human,
/obj/structure/headpike,
/turf/open/floor/plasteel/tg/freezer,
/area/violence)
"aZ" = (
/turf/closed/wall/rospilovo/beton,
/area/violence)
"bl" = (
/obj/effect/turf_decal/box/red/corners{
	dir = 1
	},
/turf/open/floor/rospilovo,
/area/violence)
"bM" = (
/obj/effect/gibspawner/human,
/turf/open/floor/plasteel/tg/freezer,
/area/violence)
"bW" = (
/obj/structure/table/reinforced,
/obj/item/food/strawberryicecreamsandwich,
/turf/open/floor/plasteel/tg/freezer,
/area/violence)
"dG" = (
/turf/open/floor/grass/gensgrass/dirty,
/area/violence)
"dP" = (
/obj/structure/chair/wood,
/turf/open/floor/wood/parquet,
/area/violence)
"dT" = (
/obj/structure/window/reinforced/spawner,
/turf/open/floor/wood/parquet,
/area/violence)
"iP" = (
/obj/effect/turf_decal/tile/bar/half{
	color = "#ffffff";
	dir = 8
	},
/turf/open/floor/rospilovo,
/area/violence)
"iT" = (
/obj/structure/window/reinforced/spawner{
	dir = 8
	},
/turf/open/floor/wood/parquet,
/area/violence)
"jT" = (
/obj/structure/closet/secure_closet/freezer/money,
/turf/open/floor/wood/parquet,
/area/violence)
"jU" = (
/obj/structure/window/reinforced/spawner{
	dir = 4
	},
/turf/open/floor/wood/parquet,
/area/violence)
"lW" = (
/obj/effect/turf_decal/tile/bar/half{
	color = "#ffffff";
	dir = 1
	},
/turf/closed/indestructible/black,
/area/violence)
"ma" = (
/obj/structure/flora/tree/jungle/small,
/turf/open/floor/grass,
/area/violence)
"mF" = (
/obj/machinery/door/airlock/freezer,
/obj/effect/mapping_helpers/airlock/access/all,
/turf/open/floor/plasteel/tg/freezer,
/area/violence)
"nQ" = (
/obj/item/target,
/turf/open/floor/wood/parquet,
/area/violence)
"oP" = (
/obj/structure/table/greyscale,
/obj/machinery/reagentgrinder,
/obj/machinery/reagentgrinder,
/turf/open/floor/wood/parquet,
/area/violence)
"qU" = (
/obj/structure/table/reinforced,
/turf/open/floor/wood/parquet,
/area/violence)
"rr" = (
/obj/structure/flora/tree/jungle,
/turf/open/floor/grass,
/area/violence)
"rO" = (
/obj/effect/mapping_helpers/airlock/access/all,
/turf/open/floor/wood/parquet,
/area/violence)
"sy" = (
/obj/structure/grille,
/obj/effect/spawner/structure/window,
/turf/open/floor/wood/parquet,
/area/violence)
"sD" = (
/obj/effect/landmark/bomb_plant_location,
/obj/effect/turf_decal/box/red,
/turf/open/floor/rospilovo,
/area/violence)
"sY" = (
/obj/effect/landmark/start/combatant/blue,
/turf/open/floor/plasteel/tg/freezer,
/area/violence)
"tH" = (
/turf/open/floor/plasteel/tg/freezer,
/area/violence)
"tZ" = (
/obj/effect/turf_decal/tile/bar/half{
	color = "#ffffff";
	dir = 4
	},
/turf/open/floor/rospilovo,
/area/violence)
"uq" = (
/turf/open/floor/beton,
/area/violence)
"wf" = (
/obj/effect/gibspawner/human,
/obj/item/bodypart/head,
/turf/open/floor/plasteel/tg/freezer,
/area/violence)
"xs" = (
/turf/closed/indestructible/black,
/area/violence)
"xF" = (
/obj/structure/table/greyscale,
/obj/machinery/reagentgrinder,
/turf/open/floor/wood/parquet,
/area/violence)
"xW" = (
/turf/open/floor/grass,
/area/violence)
"yC" = (
/obj/machinery/light/streetlight,
/turf/open/floor/beton,
/area/violence)
"yG" = (
/turf/open/floor/rospilovo,
/area/violence)
"zH" = (
/obj/structure/grille,
/obj/effect/spawner/structure/window,
/obj/machinery/door/poddoor/multi_tile/three_tile_ver,
/turf/open/floor/wood/parquet,
/area/violence)
"AW" = (
/obj/structure/table/greyscale,
/obj/item/reagent_containers/food/condiment/enzyme,
/turf/open/floor/wood/parquet,
/area/violence)
"Bd" = (
/obj/machinery/door/window/brigdoor/eastright,
/obj/effect/mapping_helpers/airlock/access/all,
/turf/open/floor/wood/parquet,
/area/violence)
"Cz" = (
/obj/structure/window/reinforced/spawner{
	dir = 1
	},
/obj/structure/window/reinforced/spawner,
/turf/open/floor/wood/parquet,
/area/violence)
"ES" = (
/obj/machinery/light/streetlight,
/turf/closed/indestructible/black,
/area/violence)
"Fl" = (
/obj/effect/turf_decal/box,
/turf/open/floor/beton,
/area/violence)
"Fo" = (
/obj/structure/closet/secure_closet/freezer/meat,
/turf/open/floor/wood/parquet,
/area/violence)
"GC" = (
/obj/structure/barricade/wooden,
/turf/open/floor/wood/parquet,
/area/violence)
"Hv" = (
/obj/effect/turf_decal/tile/bar/half{
	color = "#ffffff";
	dir = 1
	},
/turf/open/floor/rospilovo,
/area/violence)
"HH" = (
/obj/effect/turf_decal/tile/bar/half{
	color = "#ffffff";
	dir = 4
	},
/turf/closed/indestructible/black,
/area/violence)
"HN" = (
/turf/open/floor/grass/rospilovo,
/area/violence)
"JV" = (
/obj/effect/landmark/start/combatant/red,
/turf/open/floor/plasteel/tg/freezer,
/area/violence)
"Ke" = (
/turf/closed/wall/rospilovo/bricks,
/area/violence)
"Kq" = (
/obj/structure/table/reinforced,
/turf/open/floor/plasteel/tg/freezer,
/area/violence)
"Kz" = (
/obj/structure/grille,
/obj/effect/spawner/structure/window,
/obj/machinery/door/poddoor/multi_tile/three_tile_hor,
/turf/open/floor/wood/parquet,
/area/violence)
"KH" = (
/obj/structure/flora/tree/jungle,
/turf/closed/indestructible/black,
/area/violence)
"KS" = (
/obj/structure/closet/secure_closet/freezer/kitchen,
/turf/open/floor/wood/parquet,
/area/violence)
"KZ" = (
/obj/structure/table/wood,
/obj/effect/spawner/random/contraband/armory,
/turf/open/floor/wood/parquet,
/area/violence)
"Ls" = (
/obj/effect/turf_decal/tile/bar/half{
	color = "#ffffff"
	},
/turf/open/floor/rospilovo,
/area/violence)
"Lu" = (
/obj/structure/table/wood,
/turf/open/floor/wood/parquet,
/area/violence)
"Mx" = (
/obj/machinery/door/airlock/glass_large,
/obj/machinery/door/poddoor/multi_tile/two_tile_hor,
/obj/effect/mapping_helpers/airlock/access/all,
/turf/open/floor/wood/parquet,
/area/violence)
"MC" = (
/obj/structure/table/greyscale,
/obj/item/kitchen/knife,
/turf/open/floor/wood/parquet,
/area/violence)
"NI" = (
/obj/machinery/door/airlock/public/glass,
/obj/effect/mapping_helpers/airlock/access/all,
/turf/open/floor/wood/parquet,
/area/violence)
"Ok" = (
/obj/structure/closet/secure_closet/freezer/fridge,
/turf/open/floor/wood/parquet,
/area/violence)
"OS" = (
/obj/structure/table/reinforced,
/obj/item/food/icecreamsandwich,
/turf/open/floor/plasteel/tg/freezer,
/area/violence)
"PU" = (
/obj/structure/flora/tree/jungle/small,
/turf/open/floor/rospilovo,
/area/violence)
"Qw" = (
/obj/structure/table/greyscale,
/obj/machinery/oven,
/obj/item/plate/oven_tray,
/turf/open/floor/wood/parquet,
/area/violence)
"RO" = (
/obj/structure/window/reinforced/spawner,
/obj/structure/window/reinforced/spawner{
	dir = 1
	},
/turf/open/floor/wood/parquet,
/area/violence)
"Sy" = (
/obj/structure/chair/wood{
	dir = 4
	},
/turf/open/floor/wood/parquet,
/area/violence)
"SN" = (
/obj/effect/turf_decal/box/red/corners{
	dir = 8
	},
/turf/open/floor/rospilovo,
/area/violence)
"Uz" = (
/obj/structure/chair/wood{
	dir = 1
	},
/turf/open/floor/wood/parquet,
/area/violence)
"Vk" = (
/obj/machinery/icecream_vat,
/turf/open/floor/plasteel/tg/freezer,
/area/violence)
"Vl" = (
/turf/open/floor/wood/parquet,
/area/violence)
"VI" = (
/obj/structure/window/reinforced/spawner{
	dir = 1
	},
/turf/open/floor/wood/parquet,
/area/violence)
"VU" = (
/obj/effect/landmark/observer_start,
/turf/open/floor/rospilovo,
/area/violence)
"We" = (
/obj/effect/turf_decal/box/red/corners{
	dir = 4
	},
/turf/open/floor/rospilovo,
/area/violence)
"Xy" = (
/obj/machinery/door/window/brigdoor/security/cell/westright,
/obj/effect/mapping_helpers/airlock/access/all,
/turf/open/floor/wood/parquet,
/area/violence)
"YU" = (
/obj/structure/table/greyscale,
/obj/machinery/microwave,
/turf/open/floor/wood/parquet,
/area/violence)
"Zg" = (
/obj/structure/chair/wood{
	dir = 8
	},
/turf/open/floor/wood/parquet,
/area/violence)
"ZF" = (
/obj/effect/turf_decal/box/red/corners,
/turf/open/floor/rospilovo,
/area/violence)

(1,1,1) = {"
xs
xs
xs
xs
xs
xs
xs
xs
xs
xs
xs
xs
xs
xs
xs
xs
xs
xs
xs
xs
xs
xs
xs
xs
xs
ES
xs
xs
xs
xs
lW
xs
xs
xs
ES
xs
xs
xs
xs
xs
xs
xs
xs
xs
xs
xs
xs
xs
xs
xs
xs
xs
xs
xs
xs
xs
xs
xs
xs
xs
"}
(2,1,1) = {"
xs
HN
HN
HN
HN
HN
HN
HN
HN
HN
HN
HN
HN
HN
HN
HN
HN
HN
HN
HN
HN
HN
uq
uq
uq
xW
yG
yG
yG
yG
Hv
yG
yG
yG
xW
uq
uq
uq
HN
HN
HN
HN
HN
HN
HN
HN
HN
HN
HN
HN
HN
HN
HN
HN
HN
HN
HN
HN
HN
xs
"}
(3,1,1) = {"
xs
HN
dG
dG
dG
dG
dG
dG
dG
dG
dG
dG
dG
dG
dG
dG
dG
dG
dG
dG
dG
dG
uq
uq
uq
rr
yG
yG
yG
yG
yG
yG
yG
yG
rr
uq
uq
uq
dG
dG
dG
dG
dG
dG
dG
dG
dG
dG
dG
dG
dG
dG
dG
dG
dG
dG
dG
dG
HN
xs
"}
(4,1,1) = {"
xs
HN
dG
dG
dG
dG
dG
dG
dG
dG
dG
dG
dG
dG
dG
dG
dG
dG
dG
dG
dG
dG
uq
uq
uq
xW
yG
yG
yG
yG
Hv
yG
yG
yG
xW
uq
uq
uq
dG
dG
dG
dG
dG
dG
dG
dG
dG
dG
dG
dG
dG
dG
dG
dG
dG
dG
dG
dG
HN
xs
"}
(5,1,1) = {"
xs
HN
dG
dG
dG
dG
dG
dG
dG
dG
dG
dG
dG
dG
dG
dG
dG
dG
dG
dG
dG
dG
uq
uq
uq
yC
yG
yG
yG
yG
Hv
yG
yG
yG
yC
uq
uq
uq
dG
dG
dG
dG
dG
dG
dG
dG
dG
dG
dG
dG
dG
dG
dG
dG
dG
dG
dG
dG
HN
xs
"}
(6,1,1) = {"
xs
HN
dG
dG
dG
HN
HN
HN
HN
HN
HN
HN
HN
HN
HN
HN
HN
HN
HN
HN
HN
HN
uq
uq
uq
xW
yG
yG
yG
yG
yG
yG
yG
yG
xW
uq
uq
uq
HN
HN
HN
HN
HN
HN
HN
HN
HN
HN
HN
HN
HN
HN
HN
HN
HN
dG
dG
dG
HN
xs
"}
(7,1,1) = {"
xs
HN
dG
dG
dG
HN
HN
HN
HN
HN
HN
HN
HN
HN
HN
HN
HN
HN
HN
HN
HN
HN
uq
uq
uq
rr
yG
yG
yG
yG
Hv
yG
yG
yG
rr
uq
uq
uq
HN
HN
HN
HN
HN
HN
HN
HN
HN
HN
HN
HN
HN
HN
HN
HN
HN
dG
dG
dG
HN
xs
"}
(8,1,1) = {"
xs
HN
dG
dG
dG
HN
HN
HN
HN
HN
HN
HN
HN
HN
HN
HN
HN
HN
HN
HN
HN
HN
uq
uq
uq
xW
yG
yG
yG
yG
Hv
yG
yG
yG
xW
uq
uq
uq
HN
HN
HN
HN
HN
HN
HN
HN
HN
HN
HN
HN
HN
HN
HN
HN
HN
dG
dG
dG
HN
xs
"}
(9,1,1) = {"
xs
HN
dG
dG
dG
HN
HN
aZ
aZ
aZ
aZ
aZ
aZ
aZ
aZ
aZ
aZ
aZ
aZ
aZ
aZ
aZ
uq
uq
uq
xW
yG
yG
yG
yG
yG
yG
yG
yG
xW
uq
uq
uq
aZ
aZ
aZ
aZ
aZ
aZ
aZ
aZ
aZ
aZ
aZ
aZ
aZ
aZ
aZ
HN
HN
dG
dG
dG
HN
xs
"}
(10,1,1) = {"
xs
HN
dG
dG
dG
HN
HN
aZ
Vl
Vl
Vl
Vl
Vl
Ke
Vl
VI
nQ
Vl
Vl
nQ
Vl
aZ
uq
uq
uq
xW
yG
yG
yG
yG
Hv
yG
yG
yG
xW
uq
uq
uq
aZ
ac
bM
bM
tH
tH
tH
tH
tH
tH
tH
Vk
tH
bW
aZ
HN
HN
dG
dG
dG
HN
xs
"}
(11,1,1) = {"
xs
HN
dG
dG
dG
HN
HN
aZ
Vl
Sy
Sy
Vl
Vl
Ke
Vl
VI
Vl
Vl
Vl
Vl
Vl
aZ
uq
uq
uq
rr
yG
yG
yG
yG
Hv
yG
yG
yG
rr
uq
uq
uq
aZ
wf
bM
bM
tH
tH
tH
tH
sY
sY
sY
sY
sY
OS
aZ
HN
HN
dG
dG
dG
HN
xs
"}
(12,1,1) = {"
xs
HN
dG
dG
dG
HN
HN
aZ
dP
Lu
Lu
Uz
Vl
NI
Vl
Cz
qU
VI
dT
qU
VI
aZ
uq
uq
uq
xW
yG
yG
yG
yG
yG
yG
yG
yG
xW
uq
uq
uq
aZ
Ke
Ke
Ke
Ke
Ke
mF
Ke
sY
sY
sY
sY
sY
Kq
aZ
HN
HN
dG
dG
dG
HN
xs
"}
(13,1,1) = {"
xs
HN
dG
dG
dG
HN
HN
aZ
dP
Lu
KZ
Uz
Vl
Ke
Vl
iT
Vl
iT
iT
Vl
iT
aZ
uq
uq
uq
yC
yG
yG
yG
yG
Hv
PU
yG
yG
yC
uq
uq
uq
Kz
Vl
Vl
Vl
Vl
Vl
Vl
Ke
OS
OS
Kq
bW
OS
bW
aZ
HN
HN
dG
dG
dG
HN
xs
"}
(14,1,1) = {"
xs
HN
dG
dG
dG
HN
HN
aZ
dP
Lu
Lu
Uz
Vl
Ke
Vl
Vl
Vl
Vl
Vl
Vl
Vl
aZ
uq
uq
uq
xW
yG
yG
yG
yG
Hv
yG
yG
yG
xW
uq
uq
uq
sy
Lu
Lu
Lu
Bd
Ke
Vl
Ke
Ke
Ke
Ke
Ke
Ke
Ke
aZ
HN
HN
dG
dG
dG
HN
xs
"}
(15,1,1) = {"
xs
HN
dG
dG
dG
HN
HN
aZ
dP
KZ
Lu
Uz
Vl
Ke
Ke
Ke
Ke
Ke
Ke
Ke
Vl
aZ
uq
uq
uq
rr
yG
yG
yG
yG
yG
yG
yG
yG
rr
uq
uq
uq
sy
Vl
Vl
Vl
Vl
Ke
Vl
Vl
Vl
Vl
Vl
Vl
Vl
Vl
aZ
HN
HN
dG
dG
dG
HN
xs
"}
(16,1,1) = {"
xs
HN
dG
dG
dG
HN
HN
aZ
dP
Lu
Lu
Uz
Vl
Sy
Sy
Vl
Ke
Vl
Vl
Vl
Vl
aZ
uq
uq
uq
xW
yG
yG
yG
yG
Hv
yG
yG
yG
xW
uq
uq
uq
aZ
Vl
Vl
Vl
Vl
Ke
Vl
Vl
xF
MC
AW
YU
Qw
Vl
aZ
HN
HN
dG
dG
dG
HN
xs
"}
(17,1,1) = {"
xs
HN
dG
dG
dG
HN
HN
aZ
Vl
Zg
Zg
Vl
dP
Lu
Lu
Uz
Ke
GC
Lu
Lu
Lu
aZ
uq
uq
uq
yC
yG
yG
yG
yG
Hv
yG
yG
yG
yC
uq
uq
uq
Mx
Vl
dP
Lu
Uz
Ke
Ok
Vl
Vl
Vl
Vl
Vl
Vl
Vl
aZ
HN
HN
dG
dG
dG
HN
xs
"}
(18,1,1) = {"
xs
HN
dG
dG
dG
HN
HN
aZ
Vl
Vl
Vl
Vl
dP
Lu
KZ
Uz
Ke
Vl
Vl
Vl
Vl
NI
uq
uq
uq
xW
yG
yG
yG
yG
yG
yG
yG
yG
xW
uq
uq
uq
rO
Vl
Vl
Vl
Vl
Ke
Fo
Vl
oP
MC
AW
YU
Qw
Vl
aZ
HN
HN
dG
dG
dG
HN
xs
"}
(19,1,1) = {"
xs
HN
dG
dG
dG
HN
HN
aZ
Vl
Vl
Vl
Vl
Vl
Zg
Zg
Vl
Ke
Vl
Vl
Vl
Vl
NI
uq
uq
uq
rr
yG
yG
yG
yG
Hv
yG
yG
yG
rr
uq
uq
uq
aZ
Vl
dP
Lu
Uz
Ke
KS
Vl
Vl
Vl
Vl
Vl
Vl
jT
aZ
HN
HN
dG
dG
dG
HN
xs
"}
(20,1,1) = {"
xs
HN
dG
dG
dG
HN
HN
aZ
aZ
aZ
aZ
aZ
aZ
aZ
aZ
aZ
aZ
aZ
aZ
NI
NI
aZ
uq
uq
uq
xW
yG
yG
yG
yG
Hv
yG
yG
yG
xW
uq
uq
uq
aZ
aZ
sy
sy
zH
aZ
aZ
aZ
aZ
aZ
aZ
aZ
aZ
aZ
aZ
HN
HN
dG
dG
dG
HN
xs
"}
(21,1,1) = {"
xs
uq
uq
uq
uq
uq
uq
uq
uq
uq
uq
uq
uq
uq
uq
uq
uq
uq
uq
uq
uq
uq
uq
uq
uq
Fl
Ls
Ls
Ls
Ls
Ls
Ls
Ls
Ls
Fl
uq
uq
uq
uq
uq
uq
uq
uq
uq
uq
uq
uq
uq
uq
uq
uq
uq
uq
uq
uq
uq
uq
uq
uq
xs
"}
(22,1,1) = {"
xs
uq
uq
uq
uq
uq
uq
uq
uq
uq
uq
uq
uq
uq
uq
uq
uq
uq
uq
uq
uq
uq
uq
uq
uq
Fl
Ls
Ls
Ls
Ls
Ls
Ls
Ls
Ls
Fl
uq
uq
uq
uq
uq
uq
uq
uq
uq
uq
uq
uq
uq
uq
uq
uq
uq
uq
uq
uq
uq
uq
uq
uq
xs
"}
(23,1,1) = {"
xs
uq
uq
uq
uq
uq
uq
uq
uq
uq
uq
uq
uq
uq
uq
uq
uq
uq
uq
uq
uq
uq
uq
uq
uq
Fl
Ls
Ls
Ls
Ls
Ls
Ls
Ls
Ls
Fl
uq
uq
uq
uq
uq
uq
uq
uq
uq
uq
uq
uq
uq
uq
uq
uq
uq
uq
uq
uq
uq
uq
uq
uq
xs
"}
(24,1,1) = {"
KH
xW
yC
xW
rr
xW
yC
yC
rr
xW
yC
xW
rr
xW
yC
xW
rr
xW
yC
xW
rr
xW
Fl
Fl
Fl
ma
yG
yG
yG
yG
yG
yG
yG
yG
ma
Fl
Fl
Fl
xW
rr
xW
yC
xW
rr
xW
yC
xW
rr
xW
yC
xW
rr
yC
yC
xW
rr
xW
yC
xW
KH
"}
(25,1,1) = {"
xs
yG
yG
yG
yG
yG
yG
yG
yG
yG
yG
yG
yG
yG
yG
yG
yG
yG
yG
yG
yG
yG
iP
iP
iP
yG
yG
yG
yG
yG
Hv
yG
yG
yG
yG
tZ
tZ
tZ
yG
yG
yG
yG
yG
yG
yG
yG
yG
yG
yG
yG
yG
yG
yG
yG
yG
yG
yG
yG
yG
xs
"}
(26,1,1) = {"
xs
yG
yG
yG
yG
yG
yG
yG
yG
yG
yG
yG
yG
yG
yG
yG
yG
yG
yG
yG
yG
yG
iP
iP
iP
yG
yG
yG
yG
yG
Hv
yG
yG
yG
yG
tZ
tZ
tZ
yG
yG
yG
yG
yG
yG
yG
yG
yG
yG
yG
yG
yG
yG
yG
yG
yG
yG
yG
yG
yG
xs
"}
(27,1,1) = {"
xs
yG
yG
yG
yG
yG
yG
yG
yG
yG
yG
yG
yG
yG
yG
yG
yG
yG
yG
yG
yG
yG
iP
iP
iP
yG
yG
yG
yG
yG
yG
yG
yG
yG
yG
tZ
tZ
tZ
yG
yG
yG
yG
yG
yG
yG
yG
yG
yG
yG
yG
yG
yG
yG
yG
yG
yG
yG
yG
yG
xs
"}
(28,1,1) = {"
HH
yG
tZ
tZ
yG
tZ
tZ
yG
tZ
tZ
yG
tZ
tZ
yG
tZ
tZ
yG
tZ
tZ
yG
tZ
tZ
iP
iP
iP
yG
tZ
tZ
yG
ZF
VU
We
tZ
tZ
yG
tZ
tZ
tZ
tZ
tZ
yG
tZ
tZ
yG
tZ
tZ
yG
tZ
tZ
yG
tZ
tZ
yG
tZ
tZ
yG
tZ
tZ
yG
HH
"}
(29,1,1) = {"
xs
yG
yG
yG
yG
yG
yG
yG
yG
yG
yG
yG
yG
yG
yG
yG
yG
yG
yG
yG
yG
yG
iP
iP
iP
yG
yG
yG
yG
yG
sD
yG
yG
yG
yG
tZ
tZ
tZ
yG
yG
yG
yG
yG
yG
yG
yG
yG
yG
yG
yG
yG
yG
yG
yG
yG
yG
yG
yG
yG
xs
"}
(30,1,1) = {"
xs
yG
yG
yG
yG
yG
yG
yG
yG
yG
yG
yG
yG
yG
yG
yG
yG
yG
yG
yG
yG
yG
iP
iP
iP
yG
yG
yG
yG
SN
yG
bl
yG
yG
yG
tZ
tZ
tZ
yG
yG
yG
yG
yG
yG
yG
yG
yG
yG
yG
yG
yG
yG
yG
yG
yG
yG
yG
yG
yG
xs
"}
(31,1,1) = {"
xs
yG
yG
yG
yG
yG
yG
yG
yG
yG
yG
yG
yG
yG
yG
yG
yG
yG
yG
yG
yG
yG
iP
iP
iP
yG
yG
yG
yG
yG
Hv
yG
yG
yG
yG
tZ
tZ
tZ
yG
yG
yG
yG
yG
yG
yG
yG
yG
yG
yG
yG
yG
yG
yG
yG
yG
yG
yG
yG
yG
xs
"}
(32,1,1) = {"
xs
yG
yG
yG
yG
yG
yG
yG
yG
yG
yG
yG
yG
yG
yG
yG
yG
yG
yG
yG
yG
yG
iP
iP
iP
yG
yG
yG
yG
yG
Hv
yG
yG
yG
yG
tZ
tZ
tZ
yG
yG
yG
yG
yG
yG
yG
yG
yG
yG
yG
yG
yG
yG
yG
yG
yG
yG
yG
yG
yG
xs
"}
(33,1,1) = {"
KH
xW
yC
xW
rr
xW
yC
yC
rr
xW
yC
xW
rr
xW
yC
xW
rr
xW
yC
xW
rr
xW
Fl
Fl
Fl
ma
yG
yG
yG
yG
yG
yG
yG
yG
ma
Fl
Fl
Fl
xW
rr
xW
yC
xW
rr
xW
yC
xW
rr
xW
yC
xW
rr
yC
yC
xW
rr
xW
yC
xW
KH
"}
(34,1,1) = {"
xs
uq
uq
uq
uq
uq
uq
uq
uq
uq
uq
uq
uq
uq
uq
uq
uq
uq
uq
uq
uq
uq
uq
uq
uq
Fl
Hv
Hv
Hv
Hv
Hv
Hv
Hv
Hv
Fl
uq
uq
uq
uq
uq
uq
uq
uq
uq
uq
uq
uq
uq
uq
uq
uq
uq
uq
uq
uq
uq
uq
uq
uq
xs
"}
(35,1,1) = {"
xs
uq
uq
uq
uq
uq
uq
uq
uq
uq
uq
uq
uq
uq
uq
uq
uq
uq
uq
uq
uq
uq
uq
uq
uq
Fl
Hv
Hv
Hv
Hv
Hv
Hv
Hv
Hv
Fl
uq
uq
uq
uq
uq
uq
uq
uq
uq
uq
uq
uq
uq
uq
uq
uq
uq
uq
uq
uq
uq
uq
uq
uq
xs
"}
(36,1,1) = {"
xs
uq
uq
uq
uq
uq
uq
uq
uq
uq
uq
uq
uq
uq
uq
uq
uq
uq
uq
uq
uq
uq
uq
uq
uq
Fl
Hv
Hv
Hv
Hv
Hv
Hv
Hv
Hv
Fl
uq
uq
uq
uq
uq
uq
uq
uq
uq
uq
uq
uq
uq
uq
uq
uq
uq
uq
uq
uq
uq
uq
uq
uq
xs
"}
(37,1,1) = {"
xs
HN
dG
dG
dG
HN
HN
aZ
aZ
aZ
aZ
aZ
aZ
aZ
aZ
aZ
aZ
sy
sy
zH
aZ
aZ
uq
uq
uq
xW
yG
yG
yG
yG
Hv
yG
yG
yG
xW
uq
uq
uq
aZ
NI
NI
aZ
aZ
aZ
aZ
aZ
aZ
aZ
aZ
aZ
aZ
aZ
aZ
HN
HN
dG
dG
dG
HN
xs
"}
(38,1,1) = {"
xs
HN
dG
dG
dG
HN
HN
aZ
jT
Vl
Vl
Vl
Vl
Vl
Vl
KS
Ke
dP
Lu
Uz
Vl
aZ
uq
uq
uq
rr
yG
yG
yG
yG
Hv
yG
yG
yG
rr
uq
uq
uq
NI
Vl
Vl
Vl
Vl
Ke
Vl
Sy
Sy
Vl
Vl
Vl
Vl
Vl
aZ
HN
HN
dG
dG
dG
HN
xs
"}
(39,1,1) = {"
xs
HN
dG
dG
dG
HN
HN
aZ
Vl
Qw
YU
AW
xF
MC
Vl
Fo
Ke
Vl
Vl
Vl
Vl
Mx
uq
uq
uq
xW
yG
yG
yG
yG
yG
yG
yG
yG
xW
uq
uq
uq
NI
Vl
Vl
Vl
Vl
Ke
dP
KZ
Lu
Uz
Vl
Vl
Vl
Vl
aZ
HN
HN
dG
dG
dG
HN
xs
"}
(40,1,1) = {"
xs
HN
dG
dG
dG
HN
HN
aZ
Vl
Vl
Vl
Vl
Vl
Vl
Vl
Ok
Ke
dP
Lu
Uz
Vl
rO
uq
uq
uq
yC
yG
yG
yG
yG
Hv
yG
yG
yG
yC
uq
uq
uq
aZ
Lu
Lu
Lu
GC
Ke
dP
Lu
Lu
Uz
Vl
Sy
Sy
Vl
aZ
HN
HN
dG
dG
dG
HN
xs
"}
(41,1,1) = {"
xs
HN
dG
dG
dG
HN
HN
aZ
Vl
Qw
YU
AW
xF
MC
Vl
Vl
Ke
Vl
Vl
Vl
Vl
aZ
uq
uq
uq
xW
yG
yG
yG
yG
Hv
yG
yG
yG
xW
uq
uq
uq
aZ
Vl
Vl
Vl
Vl
Ke
Vl
Zg
Zg
Vl
dP
Lu
Lu
Uz
aZ
HN
HN
dG
dG
dG
HN
xs
"}
(42,1,1) = {"
xs
HN
dG
dG
dG
HN
HN
aZ
Vl
Vl
Vl
Vl
Vl
Vl
Vl
Vl
Ke
Vl
Vl
Vl
Vl
Kz
uq
uq
uq
rr
yG
yG
yG
yG
yG
yG
yG
yG
rr
uq
uq
uq
aZ
Vl
Ke
Ke
Ke
Ke
Ke
Ke
Ke
Vl
dP
Lu
KZ
Uz
aZ
HN
HN
dG
dG
dG
HN
xs
"}
(43,1,1) = {"
xs
HN
dG
dG
dG
HN
HN
aZ
Ke
Ke
Ke
Ke
Ke
Ke
Ke
Vl
Ke
Xy
Lu
Lu
Lu
sy
uq
uq
uq
xW
yG
yG
yG
yG
Hv
yG
yG
yG
xW
uq
uq
uq
aZ
Vl
Vl
Vl
Vl
Vl
Vl
Vl
Ke
Vl
dP
Lu
Lu
Uz
aZ
HN
HN
dG
dG
dG
HN
xs
"}
(44,1,1) = {"
xs
HN
dG
dG
dG
HN
HN
aZ
Kq
bW
OS
bW
Kq
bW
Ke
Vl
Vl
Vl
Vl
Vl
Vl
sy
uq
uq
uq
yC
yG
yG
yG
yG
Hv
yG
yG
yG
yC
uq
uq
uq
aZ
jU
Vl
jU
jU
Vl
jU
Vl
Ke
Vl
dP
KZ
Lu
Uz
aZ
HN
HN
dG
dG
dG
HN
xs
"}
(45,1,1) = {"
xs
HN
dG
dG
dG
HN
HN
aZ
bW
JV
JV
JV
JV
JV
Ke
mF
Ke
Ke
Ke
Ke
Ke
aZ
uq
uq
uq
xW
yG
yG
yG
yG
yG
yG
yG
yG
xW
uq
uq
uq
aZ
dT
qU
VI
dT
qU
RO
Vl
NI
Vl
dP
Lu
Lu
Uz
aZ
HN
HN
dG
dG
dG
HN
xs
"}
(46,1,1) = {"
xs
HN
dG
dG
dG
HN
HN
aZ
Kq
JV
JV
JV
JV
JV
tH
tH
tH
tH
bM
bM
wf
aZ
uq
uq
uq
rr
yG
yG
yG
yG
Hv
yG
yG
yG
rr
uq
uq
uq
aZ
Vl
Vl
Vl
Vl
Vl
dT
Vl
Ke
Vl
Vl
Zg
Zg
Vl
aZ
HN
HN
dG
dG
dG
HN
xs
"}
(47,1,1) = {"
xs
HN
dG
dG
dG
HN
HN
aZ
OS
tH
Vk
tH
tH
tH
tH
tH
tH
tH
bM
bM
ac
aZ
uq
uq
uq
xW
yG
yG
yG
yG
Hv
yG
yG
yG
xW
uq
uq
uq
aZ
Vl
nQ
Vl
Vl
nQ
dT
Vl
Ke
Vl
Vl
Vl
Vl
Vl
aZ
HN
HN
dG
dG
dG
HN
xs
"}
(48,1,1) = {"
xs
HN
dG
dG
dG
HN
HN
aZ
aZ
aZ
aZ
aZ
aZ
aZ
aZ
aZ
aZ
aZ
aZ
aZ
aZ
aZ
uq
uq
uq
xW
yG
yG
yG
yG
yG
yG
yG
yG
xW
uq
uq
uq
aZ
aZ
aZ
aZ
aZ
aZ
aZ
aZ
aZ
aZ
aZ
aZ
aZ
aZ
aZ
HN
HN
dG
dG
dG
HN
xs
"}
(49,1,1) = {"
xs
HN
dG
dG
dG
HN
HN
HN
HN
HN
HN
HN
HN
HN
HN
HN
HN
HN
HN
HN
HN
HN
uq
uq
uq
xW
yG
yG
yG
yG
Hv
yG
yG
yG
xW
uq
uq
uq
HN
HN
HN
HN
HN
HN
HN
HN
HN
HN
HN
HN
HN
HN
HN
HN
HN
dG
dG
dG
HN
xs
"}
(50,1,1) = {"
xs
HN
dG
dG
dG
HN
HN
HN
HN
HN
HN
HN
HN
HN
HN
HN
HN
HN
HN
HN
HN
HN
uq
uq
uq
rr
yG
yG
yG
yG
Hv
yG
yG
yG
rr
uq
uq
uq
HN
HN
HN
HN
HN
HN
HN
HN
HN
HN
HN
HN
HN
HN
HN
HN
HN
dG
dG
dG
HN
xs
"}
(51,1,1) = {"
xs
HN
dG
dG
dG
HN
HN
HN
HN
HN
HN
HN
HN
HN
HN
HN
HN
HN
HN
HN
HN
HN
uq
uq
uq
xW
yG
yG
yG
yG
yG
yG
yG
yG
xW
uq
uq
uq
HN
HN
HN
HN
HN
HN
HN
HN
HN
HN
HN
HN
HN
HN
HN
HN
HN
dG
dG
dG
HN
xs
"}
(52,1,1) = {"
xs
HN
dG
dG
dG
dG
dG
dG
dG
dG
dG
dG
dG
dG
dG
dG
dG
dG
dG
dG
dG
dG
uq
uq
uq
yC
yG
yG
yG
yG
Hv
yG
yG
yG
yC
uq
uq
uq
dG
dG
dG
dG
dG
dG
dG
dG
dG
dG
dG
dG
dG
dG
dG
dG
dG
dG
dG
dG
HN
xs
"}
(53,1,1) = {"
xs
HN
dG
dG
dG
dG
dG
dG
dG
dG
dG
dG
dG
dG
dG
dG
dG
dG
dG
dG
dG
dG
uq
uq
uq
xW
yG
yG
yG
yG
Hv
yG
yG
yG
xW
uq
uq
uq
dG
dG
dG
dG
dG
dG
dG
dG
dG
dG
dG
dG
dG
dG
dG
dG
dG
dG
dG
dG
HN
xs
"}
(54,1,1) = {"
xs
HN
dG
dG
dG
dG
dG
dG
dG
dG
dG
dG
dG
dG
dG
dG
dG
dG
dG
dG
dG
dG
uq
uq
uq
rr
yG
yG
yG
yG
yG
yG
yG
yG
rr
uq
uq
uq
dG
dG
dG
dG
dG
dG
dG
dG
dG
dG
dG
dG
dG
dG
dG
dG
dG
dG
dG
dG
HN
xs
"}
(55,1,1) = {"
xs
HN
HN
HN
HN
HN
HN
HN
HN
HN
HN
HN
HN
HN
HN
HN
HN
HN
HN
HN
HN
HN
uq
uq
uq
xW
yG
yG
yG
yG
Hv
yG
yG
yG
xW
uq
uq
uq
HN
HN
HN
HN
HN
HN
HN
HN
HN
HN
HN
HN
HN
HN
HN
HN
HN
HN
HN
HN
HN
xs
"}
(56,1,1) = {"
xs
xs
xs
xs
xs
xs
xs
xs
xs
xs
xs
xs
xs
xs
xs
xs
xs
xs
xs
xs
xs
xs
xs
xs
xs
ES
xs
xs
xs
xs
lW
xs
xs
xs
ES
xs
xs
xs
xs
xs
xs
xs
xs
xs
xs
xs
xs
xs
xs
xs
xs
xs
xs
xs
xs
xs
xs
xs
xs
xs
"}
