//MAP CONVERTED BY dmm2tgm.py THIS HEADER COMMENT PREVENTS RECONVERSION, DO NOT REMOVE
"b" = (
/obj/effect/spawner/structure/window/reinforced,
/turf/open/floor/plating,
/area/violence)
"h" = (
/obj/effect/landmark/start/combatant/blue,
/turf/open/floor/plasteel/bluespace,
/area/violence)
"j" = (
/turf/open/floor/plasteel/bluespace,
/area/violence)
"n" = (
/obj/effect/spawner/structure/window/reinforced,
/obj/machinery/door/poddoor/multi_tile/four_tile_hor{
	resistance_flags = 115
	},
/turf/open/floor/plating,
/area/violence)
"o" = (
/obj/effect/spawner/structure/window/reinforced,
/obj/machinery/door/poddoor/multi_tile/four_tile_ver{
	resistance_flags = 115
	},
/turf/open/floor/plating,
/area/violence)
"p" = (
/obj/effect/landmark/start/combatant/red,
/turf/open/floor/plasteel/bluespace,
/area/violence)
"s" = (
/turf/open/floor/light/colour_cycle/dancefloor_a,
/area/violence)
"v" = (
/turf/closed/indestructible/black,
/area/violence)
"x" = (
/obj/effect/turf_decal/box/red/corners{
	dir = 4
	},
/turf/open/floor/plasteel/bluespace,
/area/violence)
"A" = (
/obj/effect/turf_decal/box/red/corners{
	dir = 1
	},
/turf/open/floor/plasteel/bluespace,
/area/violence)
"C" = (
/obj/structure/mystery_box/guns,
/turf/open/floor/light/colour_cycle/dancefloor_b,
/area/violence)
"E" = (
/obj/effect/turf_decal/box/red,
/obj/effect/landmark/bomb_plant_location,
/turf/open/floor/plasteel/bluespace,
/area/violence)
"H" = (
/turf/closed/wall/r_wall,
/area/violence)
"J" = (
/obj/effect/turf_decal/box/red/corners,
/turf/open/floor/plasteel/bluespace,
/area/violence)
"M" = (
/obj/effect/turf_decal/box/red/corners{
	dir = 8
	},
/turf/open/floor/plasteel/bluespace,
/area/violence)
"O" = (
/turf/open/floor/light/colour_cycle/dancefloor_b,
/area/violence)
"S" = (
/obj/effect/baseturf_helper/dune,
/turf/closed/indestructible/black,
/area/violence)
"T" = (
/turf/open/water/xen_acid,
/area/violence)
"U" = (
/turf/closed/wall/mineral/titanium,
/area/violence)

(1,1,1) = {"
S
v
v
v
v
v
v
v
v
v
v
v
v
v
v
v
v
v
v
v
v
v
v
v
v
v
v
v
v
v
v
v
v
v
v
v
v
v
v
v
"}
(2,1,1) = {"
v
U
U
U
U
U
H
H
H
H
U
U
U
U
H
H
H
H
U
U
U
U
H
H
H
H
U
U
U
U
U
U
U
U
U
U
U
U
U
v
"}
(3,1,1) = {"
v
U
T
T
T
T
j
j
j
j
T
T
T
T
j
j
j
j
T
T
T
T
j
j
j
j
T
T
T
T
T
T
T
T
T
T
T
T
U
v
"}
(4,1,1) = {"
v
U
T
T
T
T
T
T
T
T
T
T
T
T
T
T
T
T
T
T
T
T
T
T
T
T
T
T
T
T
T
T
T
T
T
T
T
T
U
v
"}
(5,1,1) = {"
v
U
T
T
T
T
T
T
T
T
T
T
T
T
T
T
T
T
T
T
T
T
T
T
T
T
T
T
T
T
T
T
T
T
T
T
T
T
U
v
"}
(6,1,1) = {"
v
U
T
T
T
T
T
T
T
T
T
T
T
T
T
T
T
T
T
T
T
T
T
T
T
T
T
T
T
H
H
H
H
H
H
T
T
T
U
v
"}
(7,1,1) = {"
v
H
j
T
T
T
j
j
j
j
T
T
T
T
j
j
j
j
T
T
T
T
j
j
j
j
T
T
T
n
p
p
p
p
H
T
T
T
U
v
"}
(8,1,1) = {"
v
H
j
T
T
T
j
H
H
j
T
T
T
T
j
H
H
j
T
T
T
T
j
H
H
j
T
T
T
b
p
p
p
p
H
T
T
T
U
v
"}
(9,1,1) = {"
v
H
j
T
T
T
j
H
H
j
T
T
T
T
j
H
H
j
T
T
T
T
j
H
H
j
T
T
T
b
p
p
p
p
H
T
T
T
U
v
"}
(10,1,1) = {"
v
H
j
T
T
T
j
j
j
j
T
T
T
T
j
j
j
j
T
T
T
T
j
j
j
j
T
T
T
b
p
p
p
p
H
T
T
T
U
v
"}
(11,1,1) = {"
v
U
T
T
T
T
T
T
T
T
T
T
T
T
T
T
T
T
T
T
T
T
T
T
T
T
T
T
T
b
b
b
b
o
H
T
T
T
U
v
"}
(12,1,1) = {"
v
U
T
T
T
T
T
T
T
T
T
T
T
T
T
T
T
T
T
T
T
T
T
T
T
T
T
T
T
T
T
T
T
T
T
T
T
T
U
v
"}
(13,1,1) = {"
v
U
T
T
T
T
T
T
T
T
T
T
T
T
T
T
T
T
T
T
T
T
T
T
T
T
T
T
T
T
T
T
T
T
T
T
T
T
U
v
"}
(14,1,1) = {"
v
U
T
T
T
T
T
T
T
T
T
T
T
T
T
T
T
T
T
T
T
T
T
T
T
T
T
T
T
T
T
T
T
T
T
T
T
T
U
v
"}
(15,1,1) = {"
v
U
T
T
T
T
T
T
T
T
T
T
T
T
T
T
T
T
T
T
T
T
T
T
T
T
T
T
T
T
T
T
T
T
T
T
T
T
U
v
"}
(16,1,1) = {"
v
H
j
T
T
T
j
j
j
j
T
T
T
T
j
j
j
j
H
s
O
H
j
j
j
j
T
T
T
T
j
j
j
j
T
T
T
j
H
v
"}
(17,1,1) = {"
v
H
j
T
T
T
j
H
H
j
T
T
T
T
j
j
j
j
b
O
s
H
j
j
j
j
T
T
T
T
j
H
H
j
T
T
T
j
H
v
"}
(18,1,1) = {"
v
H
j
T
T
T
j
H
H
j
T
T
T
T
j
j
j
j
b
s
O
H
j
j
j
j
T
T
T
T
j
H
H
j
T
T
T
j
H
v
"}
(19,1,1) = {"
v
H
j
T
T
T
j
j
j
j
T
T
T
T
j
j
j
j
b
O
s
H
j
j
j
j
T
T
T
T
j
j
j
j
T
T
T
j
H
v
"}
(20,1,1) = {"
v
H
j
T
T
T
j
j
j
j
T
T
T
T
j
j
j
j
H
s
O
H
j
j
j
j
T
T
T
T
j
j
j
j
T
T
T
j
H
v
"}
(21,1,1) = {"
v
H
j
T
T
T
j
j
j
j
T
T
T
T
j
j
j
j
H
C
s
H
j
j
j
j
T
T
T
T
j
j
j
j
T
T
T
j
H
v
"}
(22,1,1) = {"
v
H
j
T
T
T
j
j
j
j
T
T
T
T
j
j
j
j
H
s
O
b
j
j
j
j
T
T
T
T
j
j
j
j
T
T
T
j
H
v
"}
(23,1,1) = {"
v
H
j
T
T
T
j
H
H
j
T
T
T
T
J
j
x
j
H
O
s
b
j
j
j
j
T
T
T
T
j
H
H
j
T
T
T
j
H
v
"}
(24,1,1) = {"
v
H
j
T
T
T
j
H
H
j
T
T
T
T
j
E
j
j
H
s
O
b
j
j
j
j
T
T
T
T
j
H
H
j
T
T
T
j
H
v
"}
(25,1,1) = {"
v
H
j
T
T
T
j
j
j
j
T
T
T
T
M
j
A
j
H
O
s
H
j
j
j
j
T
T
T
T
j
j
j
j
T
T
T
j
H
v
"}
(26,1,1) = {"
v
U
T
T
T
T
T
T
T
T
T
T
T
T
T
T
T
T
T
T
T
T
T
T
T
T
T
T
T
T
T
T
T
T
T
T
T
T
U
v
"}
(27,1,1) = {"
v
U
T
T
T
T
T
T
T
T
T
T
T
T
T
T
T
T
T
T
T
T
T
T
T
T
T
T
T
T
T
T
T
T
T
T
T
T
U
v
"}
(28,1,1) = {"
v
U
T
T
T
T
T
T
T
T
T
T
T
T
T
T
T
T
T
T
T
T
T
T
T
T
T
T
T
T
T
T
T
T
T
T
T
T
U
v
"}
(29,1,1) = {"
v
U
T
T
T
T
T
T
T
T
T
T
T
T
T
T
T
T
T
T
T
T
T
T
T
T
T
T
T
T
T
T
T
T
T
T
T
T
U
v
"}
(30,1,1) = {"
v
U
T
T
T
H
b
b
b
o
b
T
T
T
T
T
T
T
T
T
T
T
T
T
T
T
T
T
T
T
T
T
T
T
T
T
T
T
U
v
"}
(31,1,1) = {"
v
U
T
T
T
H
h
h
h
h
n
T
T
T
j
j
j
j
T
T
T
T
j
j
j
j
T
T
T
T
j
j
j
j
T
T
T
j
H
v
"}
(32,1,1) = {"
v
U
T
T
T
H
h
h
h
h
b
T
T
T
j
H
H
j
T
T
T
T
j
H
H
j
T
T
T
T
j
H
H
j
T
T
T
j
H
v
"}
(33,1,1) = {"
v
U
T
T
T
H
h
h
h
h
b
T
T
T
j
H
H
j
T
T
T
T
j
H
H
j
T
T
T
T
j
H
H
j
T
T
T
j
H
v
"}
(34,1,1) = {"
v
U
T
T
T
H
h
h
h
h
b
T
T
T
j
j
j
j
T
T
T
T
j
j
j
j
T
T
T
T
j
j
j
j
T
T
T
j
H
v
"}
(35,1,1) = {"
v
U
T
T
T
H
H
H
H
H
H
T
T
T
T
T
T
T
T
T
T
T
T
T
T
T
T
T
T
T
T
T
T
T
T
T
T
T
U
v
"}
(36,1,1) = {"
v
U
T
T
T
T
T
T
T
T
T
T
T
T
T
T
T
T
T
T
T
T
T
T
T
T
T
T
T
T
T
T
T
T
T
T
T
T
U
v
"}
(37,1,1) = {"
v
U
T
T
T
T
T
T
T
T
T
T
T
T
T
T
T
T
T
T
T
T
T
T
T
T
T
T
T
T
T
T
T
T
T
T
T
T
U
v
"}
(38,1,1) = {"
v
U
T
T
T
T
T
T
T
T
T
T
T
T
j
j
j
j
T
T
T
T
j
j
j
j
T
T
T
T
j
j
j
j
T
T
T
T
U
v
"}
(39,1,1) = {"
v
U
U
U
U
U
U
U
U
U
U
U
U
U
H
H
H
H
U
U
U
U
H
H
H
H
U
U
U
U
H
H
H
H
U
U
U
U
U
v
"}
(40,1,1) = {"
v
v
v
v
v
v
v
v
v
v
v
v
v
v
v
v
v
v
v
v
v
v
v
v
v
v
v
v
v
v
v
v
v
v
v
v
v
v
v
v
"}
