//MAP CONVERTED BY dmm2tgm.py THIS HEADER COMMENT PREVENTS RECONVERSION, DO NOT REMOVE
"aD" = (
/obj/effect/spawner/random/trash/cigbutt,
/turf/open/floor/pod/dark,
/area/violence)
"aX" = (
/obj/effect/landmark/bomb_plant_location,
/obj/effect/spawner/random/trash/graffiti,
/turf/open/floor/pod/dark,
/area/violence)
"et" = (
/obj/item/flasher_portable_item,
/turf/open/floor/pod/dark,
/area/violence)
"ju" = (
/obj/machinery/door/airlock/highsecurity,
/obj/effect/mapping_helpers/airlock/access/all,
/obj/effect/mine/gas/n2o,
/turf/open/floor/pod/dark,
/area/violence)
"kJ" = (
/obj/structure/deployable_barricade/plasteel{
	dir = 4
	},
/turf/open/floor/pod/dark,
/area/violence)
"ld" = (
/obj/effect/baseturf_helper/dune,
/turf/closed/indestructible/reinforced,
/area/violence)
"lp" = (
/turf/closed/indestructible/fakeglass,
/area/violence)
"ml" = (
/turf/closed/indestructible/reinforced,
/area/violence)
"mZ" = (
/obj/item/grenade/clusterbuster/cleaner,
/obj/structure/table/rolling,
/turf/open/floor/pod/dark,
/area/violence)
"of" = (
/obj/machinery/door/poddoor/multi_tile/three_tile_hor{
	resistance_flags = 115
	},
/turf/open/floor/pod/dark,
/area/violence)
"oG" = (
/obj/machinery/door/airlock/highsecurity,
/obj/structure/barricade/wooden/snowed,
/turf/open/floor/pod/dark,
/area/violence)
"pq" = (
/obj/effect/spawner/random/contraband/prison,
/turf/open/floor/pod/dark,
/area/violence)
"qF" = (
/obj/machinery/door/airlock/highsecurity,
/obj/effect/mapping_helpers/airlock/access/all,
/obj/effect/mine/stun,
/turf/open/floor/pod/dark,
/area/violence)
"rY" = (
/obj/effect/mine/pickup/speed,
/turf/open/floor/pod/dark,
/area/violence)
"sk" = (
/turf/open/floor/pod/dark,
/area/violence)
"so" = (
/obj/effect/mob_spawn/human/corpse/scientist,
/turf/open/floor/pod/dark,
/area/violence)
"vz" = (
/obj/effect/turf_decal/box/red/corners,
/turf/open/floor/pod/dark,
/area/violence)
"vH" = (
/obj/machinery/door/airlock/highsecurity,
/obj/effect/mapping_helpers/airlock/access/all,
/turf/open/floor/pod/dark,
/area/violence)
"xl" = (
/obj/effect/spawner/random/trash,
/obj/effect/spawner/random/trash,
/turf/open/floor/pod/dark,
/area/violence)
"AI" = (
/obj/effect/mob_spawn/human/corpse/russian,
/turf/open/floor/pod/dark,
/area/violence)
"Cz" = (
/obj/effect/mapping_helpers/airlock/access/all,
/obj/machinery/door/airlock/highsecurity,
/turf/open/floor/pod/dark,
/area/violence)
"CF" = (
/obj/effect/temp_visual/cult/rune_spawn,
/turf/open/floor/pod/dark,
/area/violence)
"Di" = (
/obj/effect/turf_decal/box/red,
/obj/effect/landmark/bomb_plant_location,
/turf/open/floor/pod/dark,
/area/violence)
"DB" = (
/obj/structure/barricade/sandbags,
/turf/open/floor/pod/dark,
/area/violence)
"Fy" = (
/obj/item/grenade/spawnergrenade/syndiesoap,
/obj/structure/table/rolling,
/turf/open/floor/pod/dark,
/area/violence)
"FK" = (
/obj/machinery/door/airlock/highsecurity,
/turf/open/floor/pod/dark,
/area/violence)
"Ga" = (
/obj/machinery/door/poddoor,
/turf/open/floor/pod/dark,
/area/violence)
"Gc" = (
/obj/effect/spawner/random/medical/injector,
/obj/structure/table/rolling,
/turf/open/floor/pod/dark,
/area/violence)
"IS" = (
/obj/machinery/door/poddoor/multi_tile/four_tile_ver{
	resistance_flags = 115
	},
/turf/open/floor/pod/dark,
/area/violence)
"JO" = (
/obj/effect/turf_decal/box/red/corners{
	dir = 4
	},
/turf/open/floor/pod/dark,
/area/violence)
"Kf" = (
/obj/machinery/door/poddoor/ert,
/turf/open/floor/pod/dark,
/area/violence)
"Ld" = (
/obj/effect/mapping_helpers/airlock/access/all,
/obj/machinery/door/airlock/highsecurity,
/turf/open/floor/clockwork,
/area/violence)
"MW" = (
/obj/effect/turf_decal/box/red/corners{
	dir = 1
	},
/turf/open/floor/pod/dark,
/area/violence)
"PN" = (
/obj/machinery/door/poddoor/multi_tile/four_tile_hor{
	resistance_flags = 115
	},
/turf/open/floor/pod/dark,
/area/violence)
"Qo" = (
/obj/effect/spawner/random/trash,
/turf/open/floor/pod/dark,
/area/violence)
"QL" = (
/obj/structure/deployable_barricade/plasteel{
	dir = 8
	},
/turf/open/floor/pod/dark,
/area/violence)
"Te" = (
/obj/machinery/door/airlock/highsecurity,
/obj/effect/mapping_helpers/airlock/access/all,
/obj/effect/mine/sound/bwoink,
/turf/open/floor/pod/dark,
/area/violence)
"Vq" = (
/obj/effect/landmark/start/combatant/red,
/turf/open/floor/pod/dark,
/area/violence)
"VQ" = (
/turf/closed/wall/rust,
/area/violence)
"Xp" = (
/obj/effect/mine/pickup/healing,
/turf/open/floor/pod/dark,
/area/violence)
"XS" = (
/turf/open/lava/plasma/ice_moon,
/area/violence)
"ZO" = (
/turf/open/floor/plating/asteroid/dirty/fake_lava_v2,
/area/violence)
"ZQ" = (
/obj/effect/landmark/start/combatant/blue,
/turf/open/floor/pod/dark,
/area/violence)

(1,1,1) = {"
ld
ml
ml
ml
ml
ml
ml
ml
ml
ml
ml
ml
ml
ml
ml
ml
ml
ml
ml
ml
ml
ml
ml
ml
ml
ml
ml
ml
ml
ml
ml
ml
"}
(2,1,1) = {"
ml
VQ
rY
sk
sk
sk
sk
sk
sk
sk
rY
sk
sk
sk
sk
sk
sk
sk
sk
sk
sk
rY
sk
sk
sk
sk
sk
sk
sk
rY
VQ
ml
"}
(3,1,1) = {"
ml
VQ
oG
VQ
VQ
VQ
VQ
VQ
VQ
VQ
oG
VQ
VQ
VQ
sk
sk
sk
IS
VQ
VQ
VQ
oG
VQ
VQ
VQ
VQ
VQ
VQ
VQ
oG
VQ
ml
"}
(4,1,1) = {"
ml
VQ
sk
sk
Gc
VQ
XS
so
sk
sk
sk
sk
pq
Ga
ZQ
ZQ
ZQ
ZQ
Kf
pq
sk
sk
sk
sk
so
XS
VQ
Gc
sk
sk
VQ
ml
"}
(5,1,1) = {"
ml
VQ
Fy
sk
Gc
VQ
XS
sk
sk
mZ
sk
sk
sk
of
ZQ
ZQ
ZQ
ZQ
of
sk
sk
sk
mZ
sk
sk
XS
VQ
Gc
sk
Fy
VQ
ml
"}
(6,1,1) = {"
ml
VQ
sk
sk
sk
oG
sk
sk
sk
sk
sk
sk
sk
sk
ZQ
ZQ
ZQ
ZQ
sk
sk
sk
sk
sk
sk
sk
sk
oG
sk
sk
sk
VQ
ml
"}
(7,1,1) = {"
ml
VQ
sk
sk
Gc
VQ
XS
sk
sk
so
sk
sk
sk
sk
ZQ
ZQ
ZQ
ZQ
sk
sk
sk
sk
so
sk
sk
XS
VQ
Gc
sk
sk
VQ
ml
"}
(8,1,1) = {"
ml
VQ
sk
sk
Gc
VQ
XS
sk
sk
sk
sk
pq
sk
Ga
ZQ
ZQ
ZQ
ZQ
Kf
sk
pq
sk
sk
sk
sk
XS
VQ
Gc
sk
sk
VQ
ml
"}
(9,1,1) = {"
ml
VQ
VQ
FK
VQ
VQ
lp
lp
lp
VQ
VQ
VQ
VQ
VQ
ZQ
ZQ
ZQ
ZQ
VQ
VQ
VQ
VQ
VQ
lp
lp
lp
VQ
VQ
FK
VQ
VQ
ml
"}
(10,1,1) = {"
ml
VQ
sk
sk
sk
VQ
sk
sk
sk
sk
sk
sk
sk
PN
ZQ
ZQ
ZQ
ZQ
PN
sk
sk
sk
sk
sk
sk
sk
VQ
sk
sk
sk
VQ
ml
"}
(11,1,1) = {"
ml
VQ
sk
sk
sk
VQ
sk
DB
sk
sk
sk
DB
sk
sk
ZQ
ZQ
ZQ
ZQ
sk
sk
DB
sk
sk
sk
DB
sk
VQ
sk
sk
sk
VQ
ml
"}
(12,1,1) = {"
ml
VQ
DB
Xp
DB
VQ
sk
DB
sk
Xp
sk
DB
sk
sk
ZQ
ZQ
ZQ
ZQ
sk
sk
DB
sk
Xp
sk
DB
sk
VQ
DB
Xp
DB
VQ
ml
"}
(13,1,1) = {"
ml
VQ
sk
sk
sk
VQ
sk
DB
DB
DB
DB
DB
sk
sk
ZQ
ZQ
ZQ
ZQ
sk
sk
DB
DB
DB
DB
DB
sk
VQ
sk
sk
sk
VQ
ml
"}
(14,1,1) = {"
ml
VQ
sk
sk
sk
VQ
sk
sk
sk
sk
sk
sk
sk
VQ
sk
sk
sk
IS
VQ
sk
sk
sk
sk
sk
sk
sk
VQ
sk
sk
sk
VQ
ml
"}
(15,1,1) = {"
ml
VQ
DB
sk
DB
VQ
XS
XS
XS
sk
XS
XS
XS
VQ
ZO
rY
rY
ZO
VQ
XS
XS
XS
sk
XS
XS
XS
VQ
DB
sk
DB
VQ
ml
"}
(16,1,1) = {"
ml
VQ
sk
sk
sk
VQ
VQ
VQ
VQ
vH
VQ
VQ
VQ
VQ
ZO
sk
sk
ZO
VQ
VQ
VQ
VQ
vH
VQ
VQ
VQ
VQ
sk
sk
sk
VQ
ml
"}
(17,1,1) = {"
ml
VQ
sk
sk
sk
VQ
sk
sk
sk
sk
sk
sk
Qo
VQ
ZO
sk
sk
ZO
VQ
sk
sk
sk
sk
sk
sk
Qo
VQ
sk
sk
sk
VQ
ml
"}
(18,1,1) = {"
ml
VQ
DB
sk
DB
VQ
sk
Qo
sk
sk
sk
sk
sk
VQ
ZO
sk
sk
ZO
VQ
sk
Qo
sk
sk
sk
sk
sk
VQ
DB
sk
DB
VQ
ml
"}
(19,1,1) = {"
ml
VQ
sk
sk
sk
VQ
sk
sk
sk
aD
sk
Qo
sk
VQ
ZO
sk
sk
ZO
VQ
sk
sk
sk
aD
sk
Qo
sk
VQ
sk
sk
sk
VQ
ml
"}
(20,1,1) = {"
ml
VQ
sk
sk
sk
VQ
Qo
sk
sk
sk
sk
sk
sk
VQ
ZO
sk
sk
ZO
VQ
Qo
sk
sk
sk
sk
sk
sk
VQ
sk
sk
sk
VQ
ml
"}
(21,1,1) = {"
ml
VQ
DB
sk
DB
VQ
VQ
VQ
VQ
Te
VQ
VQ
VQ
VQ
VQ
sk
sk
VQ
VQ
VQ
VQ
VQ
Te
VQ
VQ
VQ
VQ
DB
sk
DB
VQ
ml
"}
(22,1,1) = {"
ml
VQ
sk
sk
XS
lp
XS
sk
sk
sk
sk
sk
sk
sk
sk
sk
sk
sk
sk
sk
sk
sk
sk
sk
sk
XS
lp
XS
sk
sk
VQ
ml
"}
(23,1,1) = {"
ml
VQ
sk
sk
XS
lp
sk
sk
DB
sk
DB
sk
DB
sk
sk
sk
sk
sk
sk
DB
sk
DB
sk
DB
sk
sk
lp
XS
sk
sk
VQ
ml
"}
(24,1,1) = {"
ml
VQ
sk
sk
XS
lp
sk
sk
sk
sk
aD
sk
sk
sk
kJ
kJ
kJ
kJ
sk
sk
sk
aD
sk
sk
sk
sk
lp
XS
sk
sk
VQ
ml
"}
(25,1,1) = {"
ml
VQ
sk
sk
sk
lp
sk
sk
DB
sk
DB
sk
DB
sk
vz
sk
JO
sk
sk
DB
sk
DB
sk
DB
sk
sk
lp
sk
sk
sk
VQ
ml
"}
(26,1,1) = {"
ml
VQ
VQ
FK
VQ
lp
DB
sk
sk
sk
sk
sk
sk
sk
sk
Di
sk
sk
sk
sk
sk
sk
sk
sk
sk
DB
lp
VQ
FK
VQ
VQ
ml
"}
(27,1,1) = {"
ml
VQ
sk
sk
sk
lp
sk
sk
VQ
VQ
VQ
VQ
VQ
VQ
VQ
sk
MW
VQ
VQ
VQ
VQ
VQ
VQ
VQ
sk
sk
lp
sk
sk
sk
VQ
ml
"}
(28,1,1) = {"
ml
VQ
sk
sk
sk
lp
sk
DB
VQ
XS
sk
sk
XS
VQ
et
sk
sk
et
VQ
XS
sk
sk
XS
VQ
DB
sk
lp
sk
sk
sk
VQ
ml
"}
(29,1,1) = {"
ml
VQ
sk
sk
sk
lp
sk
sk
VQ
sk
Qo
sk
sk
sk
sk
sk
sk
sk
sk
sk
sk
Qo
sk
VQ
sk
sk
lp
sk
sk
sk
VQ
ml
"}
(30,1,1) = {"
ml
VQ
sk
sk
sk
lp
DB
sk
VQ
sk
sk
sk
sk
sk
sk
sk
sk
sk
sk
sk
sk
sk
sk
VQ
sk
DB
lp
sk
sk
sk
VQ
ml
"}
(31,1,1) = {"
ml
VQ
sk
sk
VQ
lp
sk
sk
qF
sk
sk
VQ
sk
sk
lp
lp
lp
sk
sk
VQ
sk
sk
sk
ju
sk
sk
lp
VQ
sk
sk
VQ
ml
"}
(32,1,1) = {"
ml
VQ
sk
sk
rY
Cz
sk
DB
VQ
VQ
VQ
VQ
aX
lp
lp
CF
lp
lp
aX
VQ
VQ
VQ
VQ
VQ
DB
sk
Ld
rY
sk
sk
VQ
ml
"}
(33,1,1) = {"
ml
VQ
sk
sk
VQ
lp
sk
sk
ju
sk
sk
VQ
sk
sk
lp
lp
lp
sk
sk
VQ
sk
sk
sk
qF
sk
sk
lp
VQ
sk
sk
VQ
ml
"}
(34,1,1) = {"
ml
VQ
sk
sk
sk
lp
DB
sk
VQ
sk
sk
sk
sk
sk
sk
sk
sk
sk
sk
sk
sk
sk
sk
VQ
sk
DB
lp
sk
sk
sk
VQ
ml
"}
(35,1,1) = {"
ml
VQ
sk
sk
sk
lp
sk
sk
VQ
sk
Qo
sk
sk
sk
sk
sk
sk
sk
sk
sk
sk
Qo
sk
VQ
sk
sk
lp
sk
sk
sk
VQ
ml
"}
(36,1,1) = {"
ml
VQ
sk
sk
sk
lp
sk
DB
VQ
XS
sk
sk
XS
VQ
et
sk
sk
et
VQ
XS
sk
sk
XS
VQ
DB
sk
lp
sk
sk
sk
VQ
ml
"}
(37,1,1) = {"
ml
VQ
sk
sk
sk
lp
sk
sk
VQ
VQ
VQ
VQ
VQ
VQ
VQ
sk
sk
VQ
VQ
VQ
VQ
VQ
VQ
VQ
sk
sk
lp
sk
sk
sk
VQ
ml
"}
(38,1,1) = {"
ml
VQ
VQ
FK
VQ
lp
DB
sk
sk
sk
sk
sk
sk
sk
sk
sk
sk
sk
sk
sk
sk
sk
sk
sk
sk
DB
lp
VQ
FK
VQ
VQ
ml
"}
(39,1,1) = {"
ml
VQ
sk
sk
sk
lp
sk
sk
DB
sk
DB
sk
DB
sk
sk
sk
sk
sk
sk
DB
sk
DB
sk
DB
sk
sk
lp
sk
sk
sk
VQ
ml
"}
(40,1,1) = {"
ml
VQ
sk
sk
XS
lp
sk
sk
sk
sk
aD
sk
sk
sk
QL
QL
QL
QL
sk
sk
sk
aD
sk
sk
sk
sk
lp
XS
sk
sk
VQ
ml
"}
(41,1,1) = {"
ml
VQ
sk
sk
XS
lp
sk
sk
DB
sk
DB
sk
DB
sk
sk
sk
sk
sk
sk
DB
sk
DB
sk
DB
sk
sk
lp
XS
sk
sk
VQ
ml
"}
(42,1,1) = {"
ml
VQ
sk
sk
XS
lp
XS
sk
sk
sk
sk
sk
sk
sk
sk
sk
sk
sk
sk
sk
sk
sk
sk
sk
sk
XS
lp
XS
sk
sk
VQ
ml
"}
(43,1,1) = {"
ml
VQ
DB
sk
DB
VQ
VQ
VQ
VQ
Te
VQ
VQ
VQ
VQ
VQ
sk
sk
VQ
VQ
VQ
VQ
VQ
Te
VQ
VQ
VQ
VQ
DB
sk
DB
VQ
ml
"}
(44,1,1) = {"
ml
VQ
sk
sk
sk
VQ
Qo
sk
sk
sk
sk
sk
sk
VQ
ZO
sk
sk
ZO
VQ
Qo
sk
sk
sk
sk
sk
sk
VQ
sk
sk
sk
VQ
ml
"}
(45,1,1) = {"
ml
VQ
sk
sk
sk
VQ
sk
sk
sk
aD
sk
Qo
sk
VQ
ZO
sk
sk
ZO
VQ
sk
sk
sk
aD
sk
Qo
sk
VQ
sk
sk
sk
VQ
ml
"}
(46,1,1) = {"
ml
VQ
DB
sk
DB
VQ
sk
xl
sk
sk
sk
sk
sk
VQ
ZO
sk
sk
ZO
VQ
sk
Qo
sk
sk
sk
sk
sk
VQ
DB
sk
DB
VQ
ml
"}
(47,1,1) = {"
ml
VQ
sk
sk
sk
VQ
sk
sk
sk
sk
sk
sk
Qo
VQ
ZO
sk
sk
ZO
VQ
sk
sk
sk
sk
sk
sk
Qo
VQ
sk
sk
sk
VQ
ml
"}
(48,1,1) = {"
ml
VQ
sk
sk
sk
VQ
VQ
VQ
VQ
vH
VQ
VQ
VQ
VQ
ZO
sk
sk
ZO
VQ
VQ
VQ
VQ
vH
VQ
VQ
VQ
VQ
sk
sk
sk
VQ
ml
"}
(49,1,1) = {"
ml
VQ
DB
sk
DB
VQ
XS
XS
XS
sk
XS
XS
XS
VQ
ZO
rY
rY
ZO
VQ
XS
XS
XS
sk
XS
XS
XS
VQ
DB
sk
DB
VQ
ml
"}
(50,1,1) = {"
ml
VQ
sk
sk
sk
VQ
sk
sk
sk
sk
sk
sk
sk
VQ
sk
sk
sk
IS
VQ
sk
sk
sk
sk
sk
sk
sk
VQ
sk
sk
sk
VQ
ml
"}
(51,1,1) = {"
ml
VQ
sk
sk
sk
VQ
sk
DB
DB
DB
DB
DB
sk
PN
Vq
Vq
Vq
Vq
PN
sk
DB
DB
DB
DB
DB
sk
VQ
sk
sk
sk
VQ
ml
"}
(52,1,1) = {"
ml
VQ
DB
Xp
DB
VQ
sk
DB
sk
Xp
sk
DB
sk
sk
Vq
Vq
Vq
Vq
sk
sk
DB
sk
Xp
sk
DB
sk
VQ
DB
Xp
DB
VQ
ml
"}
(53,1,1) = {"
ml
VQ
sk
sk
sk
VQ
sk
DB
sk
sk
sk
DB
sk
sk
Vq
Vq
Vq
Vq
sk
sk
DB
sk
sk
sk
DB
sk
VQ
sk
sk
sk
VQ
ml
"}
(54,1,1) = {"
ml
VQ
sk
sk
sk
VQ
sk
sk
sk
sk
sk
sk
sk
sk
Vq
Vq
Vq
Vq
sk
sk
sk
sk
sk
sk
sk
sk
VQ
sk
sk
sk
VQ
ml
"}
(55,1,1) = {"
ml
VQ
VQ
FK
VQ
VQ
lp
lp
lp
VQ
VQ
VQ
VQ
VQ
Vq
Vq
Vq
Vq
VQ
VQ
VQ
VQ
VQ
lp
lp
lp
VQ
VQ
FK
VQ
VQ
ml
"}
(56,1,1) = {"
ml
VQ
sk
sk
Gc
VQ
XS
sk
sk
sk
sk
pq
sk
Kf
Vq
Vq
Vq
Vq
Kf
sk
pq
sk
sk
sk
sk
XS
VQ
Gc
sk
sk
VQ
ml
"}
(57,1,1) = {"
ml
VQ
sk
sk
Gc
VQ
XS
sk
sk
AI
sk
sk
sk
of
Vq
Vq
Vq
Vq
of
sk
sk
sk
AI
sk
sk
XS
VQ
Gc
sk
sk
VQ
ml
"}
(58,1,1) = {"
ml
VQ
sk
sk
sk
oG
sk
sk
sk
sk
sk
sk
sk
sk
Vq
Vq
Vq
Vq
sk
sk
sk
sk
sk
sk
sk
sk
oG
sk
sk
sk
VQ
ml
"}
(59,1,1) = {"
ml
VQ
Fy
sk
Gc
VQ
XS
sk
sk
mZ
sk
sk
sk
sk
Vq
Vq
Vq
Vq
sk
sk
sk
sk
mZ
sk
sk
XS
VQ
Gc
sk
Fy
VQ
ml
"}
(60,1,1) = {"
ml
VQ
sk
sk
Gc
VQ
XS
AI
sk
sk
sk
sk
pq
Kf
Vq
Vq
Vq
Vq
Kf
pq
sk
sk
sk
sk
AI
XS
VQ
Gc
sk
sk
VQ
ml
"}
(61,1,1) = {"
ml
VQ
oG
VQ
VQ
VQ
VQ
VQ
VQ
VQ
oG
VQ
VQ
VQ
sk
sk
sk
IS
VQ
VQ
VQ
oG
VQ
VQ
VQ
VQ
VQ
VQ
VQ
oG
VQ
ml
"}
(62,1,1) = {"
ml
VQ
rY
sk
sk
sk
sk
sk
sk
sk
rY
sk
sk
sk
sk
sk
sk
sk
sk
sk
sk
rY
sk
sk
sk
sk
sk
sk
sk
rY
VQ
ml
"}
(63,1,1) = {"
ml
ml
ml
ml
ml
ml
ml
ml
ml
ml
ml
ml
ml
ml
ml
ml
ml
ml
ml
ml
ml
ml
ml
ml
ml
ml
ml
ml
ml
ml
ml
ml
"}
(64,1,1) = {"
ml
ml
ml
ml
ml
ml
ml
ml
ml
ml
ml
ml
ml
ml
ml
ml
ml
ml
ml
ml
ml
ml
ml
ml
ml
ml
ml
ml
ml
ml
ml
ml
"}
