//MAP CONVERTED BY dmm2tgm.py THIS HEADER COMMENT PREVENTS RECONVERSION, DO NOT REMOVE
"aA" = (
/obj/effect/gibspawner/xeno,
/turf/open/floor/dune/sandstone,
/area/violence)
"bl" = (
/obj/structure/deployable_barricade/sandbags{
	dir = 8
	},
/turf/open/floor/dune/desert,
/area/violence)
"bT" = (
/turf/open/floor/dune/desertrocks,
/area/violence)
"bZ" = (
/obj/structure/flora/desert/large_cactus,
/turf/open/floor/dune/sandstone,
/area/violence)
"cy" = (
/obj/structure/flora/desert/cactus,
/turf/open/floor/dune,
/area/violence)
"dB" = (
/obj/effect/turf_decal/weather/side/corner{
	dir = 4
	},
/turf/open/floor/dune/desert,
/area/violence)
"dQ" = (
/obj/structure/flora/desert/large_cactus,
/turf/open/floor/dune/scorched_sand,
/area/violence)
"dW" = (
/obj/structure/deployable_barricade/sandbags{
	dir = 1
	},
/turf/open/floor/dune/desert,
/area/violence)
"dY" = (
/obj/structure/flora/desert/cactus,
/turf/open/floor/dune/desert,
/area/violence)
"eu" = (
/obj/structure/deployable_barricade/sandbags{
	dir = 8
	},
/turf/open/floor/dune/grass,
/area/violence)
"eC" = (
/turf/open/floor/dune/scorched_sand,
/area/violence)
"eW" = (
/obj/effect/landmark/start/combatant/red,
/turf/open/floor/dune/desertrocks,
/area/violence)
"fd" = (
/obj/structure/deployable_barricade/sandbags{
	dir = 4
	},
/turf/open/floor/dune/grass,
/area/violence)
"fe" = (
/obj/structure/flora/desert/large_cactus,
/turf/open/floor/dune/sandy,
/area/violence)
"ft" = (
/obj/structure/flora/desert/large_cactus,
/obj/effect/turf_decal/weather/side/corner,
/turf/open/floor/dune,
/area/violence)
"fO" = (
/obj/effect/turf_decal/weather/side/corner{
	dir = 4
	},
/obj/structure/deployable_barricade/sandbags{
	dir = 1
	},
/turf/open/floor/dune,
/area/violence)
"ii" = (
/obj/effect/turf_decal/weather/side{
	dir = 6
	},
/turf/open/floor/dune,
/area/violence)
"jT" = (
/obj/structure/flora/desert/large_cactus,
/obj/effect/turf_decal/weather/side{
	dir = 10
	},
/turf/open/floor/dune,
/area/violence)
"jX" = (
/obj/effect/turf_decal/weather/side/corner{
	dir = 8
	},
/turf/open/floor/dune/desert,
/area/violence)
"ko" = (
/obj/effect/turf_decal/box/red/corners{
	dir = 1
	},
/turf/open/floor/dune,
/area/violence)
"kX" = (
/obj/structure/deployable_barricade/sandbags{
	dir = 1
	},
/turf/open/floor/dune,
/area/violence)
"ls" = (
/obj/effect/baseturf_helper/dune,
/turf/closed/indestructible/sandstone,
/area/violence)
"lU" = (
/obj/effect/decal/cleanable/generic,
/turf/open/floor/dune/sandstone,
/area/violence)
"mb" = (
/obj/structure/deployable_barricade/sandbags,
/obj/structure/deployable_barricade/sandbags{
	dir = 8
	},
/turf/open/floor/dune/desertrocks,
/area/violence)
"mf" = (
/obj/structure/deployable_barricade/sandbags,
/turf/open/floor/dune/sandstone,
/area/violence)
"mi" = (
/obj/structure/flora/desert/large_cactus,
/obj/effect/turf_decal/weather/side{
	dir = 8
	},
/turf/open/floor/dune,
/area/violence)
"mG" = (
/obj/effect/turf_decal/weather/side{
	dir = 4
	},
/turf/open/floor/dune,
/area/violence)
"mL" = (
/obj/structure/flora/desert/cactus,
/obj/effect/turf_decal/weather/side{
	dir = 1
	},
/turf/open/floor/dune,
/area/violence)
"mX" = (
/turf/open/floor/dune,
/area/violence)
"nZ" = (
/obj/effect/decal/cleanable/plastic,
/turf/open/floor/dune,
/area/violence)
"of" = (
/obj/effect/turf_decal/weather/side{
	dir = 1
	},
/turf/open/floor/dune/grass,
/area/violence)
"pl" = (
/obj/effect/turf_decal/weather/side{
	dir = 1
	},
/turf/open/floor/dune,
/area/violence)
"pD" = (
/obj/effect/turf_decal/weather/side/corner,
/turf/open/floor/dune,
/area/violence)
"qz" = (
/obj/effect/turf_decal/weather/side{
	dir = 9
	},
/turf/open/floor/dune,
/area/violence)
"rX" = (
/turf/closed/indestructible/sandstone,
/area/violence)
"sj" = (
/obj/structure/deployable_barricade/sandbags{
	dir = 1
	},
/obj/structure/deployable_barricade/sandbags{
	dir = 4
	},
/turf/open/floor/dune/desertrocks,
/area/violence)
"uj" = (
/turf/open/floor/dune/sandstone,
/area/violence)
"us" = (
/obj/effect/turf_decal/weather/side{
	dir = 5
	},
/turf/open/floor/dune/desert,
/area/violence)
"vi" = (
/obj/effect/turf_decal/weather/side,
/turf/open/floor/dune/desert,
/area/violence)
"vs" = (
/obj/structure/flora/desert/cactus,
/obj/effect/turf_decal/weather/side/corner,
/turf/open/floor/dune,
/area/violence)
"vB" = (
/obj/effect/turf_decal/box/red/corners,
/turf/open/floor/dune,
/area/violence)
"vL" = (
/obj/effect/turf_decal/weather/side{
	dir = 1
	},
/turf/open/floor/dune/desert,
/area/violence)
"wm" = (
/obj/structure/deployable_barricade/sandbags{
	dir = 4
	},
/turf/open/floor/dune,
/area/violence)
"wE" = (
/obj/effect/gibspawner/xeno,
/turf/open/floor/dune,
/area/violence)
"xc" = (
/obj/structure/flora/desert/large_cactus,
/obj/effect/turf_decal/weather/side{
	dir = 1
	},
/turf/open/floor/dune,
/area/violence)
"xh" = (
/obj/effect/turf_decal/weather/side/corner{
	dir = 1
	},
/turf/open/floor/dune,
/area/violence)
"yf" = (
/obj/effect/turf_decal/weather/side,
/obj/effect/turf_decal/weather/side/corner{
	dir = 4
	},
/turf/open/floor/dune,
/area/violence)
"yD" = (
/obj/effect/turf_decal/weather/side,
/turf/open/floor/dune,
/area/violence)
"zn" = (
/obj/structure/deployable_barricade/sandbags,
/obj/structure/deployable_barricade/sandbags{
	dir = 4
	},
/turf/open/floor/dune/desertrocks,
/area/violence)
"zv" = (
/obj/structure/deployable_barricade/sandbags{
	dir = 1
	},
/turf/open/floor/dune/sandy,
/area/violence)
"At" = (
/obj/effect/turf_decal/weather/side{
	dir = 8
	},
/turf/open/floor/dune,
/area/violence)
"AA" = (
/obj/effect/turf_decal/weather/side{
	dir = 4
	},
/obj/effect/turf_decal/weather/side/corner{
	dir = 8
	},
/turf/open/floor/dune,
/area/violence)
"Bd" = (
/obj/effect/decal/cleanable/vomit/old,
/turf/open/floor/dune/sandy,
/area/violence)
"Bk" = (
/obj/effect/turf_decal/weather/side{
	dir = 6
	},
/turf/open/floor/dune/desertrocks,
/area/violence)
"Bl" = (
/obj/structure/deployable_barricade/sandbags,
/turf/open/floor/dune/desert,
/area/violence)
"Bv" = (
/obj/structure/deployable_barricade/sandbags,
/turf/open/floor/dune/desertrocks,
/area/violence)
"BT" = (
/obj/effect/turf_decal/weather/side{
	dir = 9
	},
/turf/open/floor/dune/desert,
/area/violence)
"Da" = (
/obj/effect/turf_decal/weather/side/corner{
	dir = 8
	},
/turf/open/floor/dune/grass,
/area/violence)
"Dm" = (
/obj/structure/flora/desert/large_cactus,
/turf/open/floor/dune,
/area/violence)
"DJ" = (
/turf/open/floor/dune/desert,
/area/violence)
"DM" = (
/obj/structure/flora/desert/cactus,
/turf/open/floor/dune/sandy,
/area/violence)
"Ec" = (
/obj/effect/decal/cleanable/plasma,
/turf/open/floor/dune,
/area/violence)
"Ex" = (
/obj/effect/turf_decal/weather/side{
	dir = 10
	},
/turf/open/floor/dune,
/area/violence)
"Fi" = (
/turf/open/floor/dune/sandy,
/area/violence)
"FG" = (
/obj/structure/deployable_barricade/sandbags,
/turf/open/floor/dune/sandy,
/area/violence)
"FT" = (
/obj/effect/decal/cleanable/plasma,
/turf/open/floor/dune/sandy,
/area/violence)
"FZ" = (
/obj/effect/turf_decal/weather/side/corner{
	dir = 4
	},
/turf/open/floor/dune/grass,
/area/violence)
"Hv" = (
/obj/structure/flora/desert/large_cactus,
/turf/open/floor/dune/desert,
/area/violence)
"Hy" = (
/obj/effect/turf_decal/weather/side{
	dir = 4
	},
/obj/effect/turf_decal/weather/side{
	dir = 8
	},
/turf/open/floor/dune,
/area/violence)
"Ii" = (
/obj/machinery/door/poddoor/multi_tile/three_tile_ver{
	resistance_flags = 115
	},
/turf/open/floor/dune/desertrocks,
/area/violence)
"Im" = (
/obj/structure/flora/desert/cactus,
/turf/open/floor/dune/sandstone,
/area/violence)
"Iu" = (
/obj/effect/landmark/start/combatant/blue,
/turf/open/floor/dune/desertrocks,
/area/violence)
"IB" = (
/obj/effect/decal/cleanable/shreds,
/turf/open/floor/dune,
/area/violence)
"Jk" = (
/obj/effect/turf_decal/weather/side{
	dir = 8
	},
/turf/open/floor/dune/grass,
/area/violence)
"JC" = (
/obj/effect/turf_decal/box/red/corners{
	dir = 4
	},
/turf/open/floor/dune,
/area/violence)
"LG" = (
/obj/structure/deployable_barricade/sandbags{
	dir = 8
	},
/turf/open/floor/dune,
/area/violence)
"LX" = (
/obj/effect/turf_decal/weather/side{
	dir = 4
	},
/turf/open/floor/dune/desert,
/area/violence)
"LZ" = (
/obj/structure/flora/desert/cactus,
/turf/open/floor/dune/scorched_sand,
/area/violence)
"Mk" = (
/obj/structure/deployable_barricade/sandbags,
/turf/open/floor/dune,
/area/violence)
"MV" = (
/obj/effect/turf_decal/weather/side{
	dir = 6
	},
/obj/effect/turf_decal/weather/side{
	dir = 1
	},
/turf/open/floor/dune,
/area/violence)
"NI" = (
/obj/structure/flora/desert/large_cactus,
/turf/open/floor/dune/grass,
/area/violence)
"NN" = (
/obj/structure/deployable_barricade/sandbags{
	dir = 1
	},
/turf/open/floor/dune/desertrocks,
/area/violence)
"Oj" = (
/obj/structure/flora/desert/large_cactus,
/obj/effect/turf_decal/weather/side,
/turf/open/floor/dune,
/area/violence)
"Pg" = (
/obj/effect/turf_decal/weather/side/corner{
	dir = 4
	},
/turf/open/floor/dune,
/area/violence)
"Pw" = (
/obj/effect/turf_decal/weather/side{
	dir = 6
	},
/turf/open/floor/dune/desert,
/area/violence)
"Qj" = (
/obj/structure/deployable_barricade/sandbags{
	dir = 1
	},
/turf/open/floor/dune/scorched_sand,
/area/violence)
"Qw" = (
/obj/item/binoculars,
/obj/effect/mapping_helpers/component_injector/areabound,
/turf/open/floor/dune/sandy,
/area/violence)
"Rk" = (
/obj/effect/turf_decal/weather/side/corner,
/turf/open/floor/dune/desert,
/area/violence)
"Rp" = (
/obj/structure/deployable_barricade/sandbags{
	dir = 1
	},
/obj/structure/deployable_barricade/sandbags{
	dir = 8
	},
/turf/open/floor/dune/desertrocks,
/area/violence)
"Rq" = (
/obj/effect/turf_decal/weather/side/corner{
	dir = 8
	},
/turf/open/floor/dune,
/area/violence)
"SY" = (
/obj/effect/turf_decal/weather/side{
	dir = 5
	},
/turf/open/floor/dune/grass,
/area/violence)
"TF" = (
/obj/effect/turf_decal/weather/side{
	dir = 5
	},
/turf/open/floor/dune,
/area/violence)
"Um" = (
/turf/open/floor/dune/grass,
/area/violence)
"Uo" = (
/obj/effect/decal/cleanable/generic,
/turf/open/floor/dune,
/area/violence)
"Vp" = (
/obj/effect/decal/cleanable/plasma,
/turf/open/floor/dune/desert,
/area/violence)
"VO" = (
/obj/effect/turf_decal/box/red/corners{
	dir = 8
	},
/turf/open/floor/dune,
/area/violence)
"VY" = (
/obj/structure/flora/desert/cactus,
/obj/effect/turf_decal/weather/side/corner,
/obj/effect/turf_decal/weather/side/corner{
	dir = 8
	},
/turf/open/floor/dune,
/area/violence)
"WM" = (
/obj/effect/landmark/bomb_plant_location,
/obj/effect/turf_decal/box/red,
/turf/open/floor/dune,
/area/violence)
"Yg" = (
/obj/item/binoculars,
/obj/effect/mapping_helpers/component_injector/areabound,
/turf/open/floor/dune/desert,
/area/violence)
"YI" = (
/obj/effect/turf_decal/weather/side{
	dir = 9
	},
/turf/open/floor/dune/grass,
/area/violence)
"ZK" = (
/obj/effect/turf_decal/weather/side{
	dir = 1
	},
/obj/structure/deployable_barricade/sandbags{
	dir = 1
	},
/turf/open/floor/dune,
/area/violence)

(1,1,1) = {"
ls
rX
rX
rX
rX
rX
rX
rX
rX
rX
rX
rX
rX
rX
rX
rX
rX
rX
rX
rX
rX
rX
rX
rX
rX
rX
rX
rX
rX
rX
rX
rX
rX
rX
rX
rX
rX
rX
rX
rX
rX
rX
rX
rX
rX
rX
rX
rX
rX
rX
rX
rX
rX
rX
rX
rX
rX
rX
rX
rX
"}
(2,1,1) = {"
rX
Iu
Iu
Iu
rX
vi
DJ
DJ
DJ
DJ
DJ
mX
mX
mX
mX
mX
mX
mX
mX
mX
mX
mX
mX
Pg
TF
Fi
Fi
Fi
Fi
uj
uj
uj
yD
mX
mX
mX
mX
mX
pl
eC
LZ
eC
eC
eC
eC
yD
mX
mX
mX
mX
mX
mX
mX
mX
pl
rX
eW
eW
eW
rX
"}
(3,1,1) = {"
rX
Iu
Iu
Iu
rX
vi
DJ
DJ
DJ
DJ
mX
mX
mX
mX
mX
mX
mX
Mk
mX
mX
mX
mX
mX
Um
FZ
TF
Fi
Fi
Fi
Fi
fe
uj
yD
mX
mX
mX
mX
mX
pl
eC
eC
eC
eC
eC
eC
yD
mX
mX
mX
mX
mX
mX
mX
mX
pl
rX
eW
eW
eW
rX
"}
(4,1,1) = {"
rX
Iu
Iu
Iu
rX
vi
DJ
DJ
DJ
DJ
mX
mX
mX
mX
mX
mX
mX
Mk
mX
cy
mX
mX
mX
mX
Um
FZ
SY
Fi
Fi
Fi
Fi
uj
Ex
xh
mX
mX
mX
Rq
qz
eC
eC
eC
eC
eC
ii
vs
mX
mX
mX
mX
mX
Um
Um
mX
pl
rX
eW
eW
eW
rX
"}
(5,1,1) = {"
rX
bT
bT
Ii
rX
vi
dY
DJ
DJ
mX
mX
mX
mX
mX
mX
mX
mX
Mk
mX
mX
mX
mX
mX
Um
Um
Um
of
Fi
Fi
Fi
Fi
uj
uj
yD
mX
mX
cy
pl
eC
eC
eC
eC
eC
eC
yD
mX
mX
mX
mX
Um
Um
Um
Um
mX
pl
rX
bT
bT
Ii
rX
"}
(6,1,1) = {"
rX
bT
bT
bT
Bv
vi
DJ
DJ
DJ
mX
mX
mX
mX
mX
mX
mX
mX
Mk
mX
mX
mX
mX
mX
Um
Um
Um
of
Fi
Fi
Fi
Fi
Fi
uj
yD
mX
mX
mX
pl
eC
eC
eC
eC
eC
eC
yD
mX
mX
Um
Um
Um
Um
Um
Um
mX
pl
NN
bT
bT
bT
rX
"}
(7,1,1) = {"
rX
bT
bT
bT
Bv
vi
DJ
DJ
DJ
DJ
mX
mX
mX
mX
mX
mX
mX
Mk
mX
Dm
mX
mX
mX
Um
Um
Um
FZ
SY
Fi
Fi
Fi
Fi
uj
yD
mX
mX
mX
xc
eC
eC
eC
eC
eC
eC
yD
mX
mX
Um
Um
Um
Um
mX
mX
mX
mL
NN
bT
bT
bT
rX
"}
(8,1,1) = {"
rX
bT
bT
bT
Bv
vi
DJ
DJ
DJ
DJ
mX
mX
mX
mX
mX
mX
mX
Mk
mX
mX
mX
mX
mX
mX
Um
Um
Um
FZ
SY
Fi
Fi
Fi
Im
Ex
At
xh
Rq
qz
eC
eC
eC
eC
ii
mG
pD
mX
mX
Um
Um
Um
Um
mX
mX
mX
pl
NN
bT
bT
bT
rX
"}
(9,1,1) = {"
rX
bT
bT
bT
zn
vi
DJ
DJ
DJ
DJ
DJ
mX
mX
mX
mX
Uo
mX
Mk
mX
mX
mX
mX
mX
mX
mX
mX
Um
Um
of
Fi
Fi
Fi
uj
uj
uj
yD
pl
eC
eC
eC
eC
eC
yD
mX
mX
mX
mX
Um
Um
Um
Um
mX
Dm
mX
pl
sj
bT
bT
bT
rX
"}
(10,1,1) = {"
rX
mG
mG
mG
LX
Rk
DJ
DJ
DJ
DJ
dY
mX
mX
mX
mX
mX
mX
Mk
mX
mX
mX
mX
mX
mX
mX
mX
mX
mX
FZ
SY
fe
Fi
Fi
uj
uj
Ex
qz
eC
eC
eC
eC
LZ
yD
mX
mX
mX
mX
mX
Um
Um
Um
Um
mX
mX
Pg
mG
AA
Hy
Hy
rX
"}
(11,1,1) = {"
rX
mX
mX
mX
mX
DJ
DJ
DJ
Hv
DJ
DJ
DJ
mX
mX
Dm
mX
mX
mX
mX
mX
mX
mX
mX
cy
mX
mX
mX
Um
Um
of
Fi
Fi
Fi
uj
uj
uj
uj
eC
eC
eC
eC
eC
yD
mX
Um
Um
Um
Um
Um
Um
Um
Um
mX
mX
mX
Rq
qz
Fi
Fi
rX
"}
(12,1,1) = {"
rX
mX
mX
cy
mX
DJ
DJ
DJ
DJ
DJ
DJ
DJ
mX
mX
mX
mX
cy
mX
DJ
DJ
Dm
mX
mX
mX
mX
mX
mX
Um
Um
of
Fi
Fi
Fi
fe
Fi
uj
eC
eC
eC
eC
eC
eC
yD
mX
Um
Um
Um
Um
Um
Um
Um
Um
mX
mX
cy
pl
Fi
Fi
Fi
rX
"}
(13,1,1) = {"
rX
mX
mX
mX
mX
mX
DJ
DJ
DJ
DJ
DJ
DJ
mX
mX
mX
mX
mX
DJ
DJ
DJ
mX
mX
mX
mX
mX
mX
mX
mX
mX
Pg
TF
Fi
Fi
Fi
Fi
Fi
uj
uj
uj
eC
ii
mG
ft
mX
Um
Um
Um
Um
Um
Um
Um
mX
mX
mX
mX
pl
Fi
Fi
Fi
rX
"}
(14,1,1) = {"
rX
mX
mX
mX
mX
mX
DJ
DJ
DJ
DJ
DJ
DJ
DJ
mX
mX
mX
DJ
DJ
DJ
DJ
DJ
DJ
mX
mX
mX
Dm
mX
mX
mX
mX
Pg
TF
Fi
Fi
Fi
Fi
uj
uj
uj
eC
Oj
mX
mX
mX
fd
fd
fd
fd
fd
Um
Um
mX
mX
Rq
At
qz
Fi
Fi
Fi
rX
"}
(15,1,1) = {"
rX
mX
mX
mX
mX
mX
mX
DJ
DJ
DJ
DJ
DJ
DJ
DJ
mX
mX
DJ
DJ
DJ
DJ
DJ
DJ
DJ
mX
mX
mX
mX
mX
mX
mX
mX
Pg
TF
zv
Fi
Fi
Fi
uj
uj
eC
yD
mX
mX
mX
mX
Um
Um
Um
Um
Um
Um
Um
Um
pl
Fi
Fi
Fi
Fi
Fi
rX
"}
(16,1,1) = {"
rX
mX
mX
NI
mX
mX
mX
mX
DJ
DJ
DJ
DJ
DJ
DJ
mX
mX
DJ
DJ
DJ
dY
DJ
DJ
DJ
mX
mX
mX
mX
mX
mX
mX
mX
cy
pl
zv
Fi
DM
Fi
uj
uj
uj
yD
mX
mX
cy
Um
Um
Um
Um
Um
Um
Um
Um
Da
qz
Fi
Fi
Fi
Fi
Fi
rX
"}
(17,1,1) = {"
rX
mX
Um
Um
mX
mX
mX
mX
DJ
DJ
DJ
DJ
DJ
DJ
mX
mX
mX
DJ
DJ
DJ
DJ
DJ
Hv
DJ
DJ
mX
mX
cy
mX
mX
mX
mX
pl
Qj
Fi
Fi
Fi
Fi
uj
uj
yD
mX
mX
mX
Um
Um
Um
Um
cy
Um
Um
Um
of
Fi
Fi
Fi
Fi
Fi
Fi
rX
"}
(18,1,1) = {"
rX
mX
Um
Um
mX
mX
Dm
mX
mX
DJ
DJ
dY
DJ
DJ
DJ
mX
mX
DJ
dY
DJ
DJ
DJ
DJ
DJ
DJ
mX
mX
mX
mX
mX
mX
Rq
qz
Qj
Fi
Fi
Fi
Fi
uj
uj
Ex
xh
mX
mX
mX
Um
Um
Um
Um
Um
Um
Um
pl
Fi
Fi
Fi
Fi
Fi
Fi
rX
"}
(19,1,1) = {"
rX
mX
Um
Um
mX
mX
mX
mX
mX
DJ
DJ
DJ
DJ
DJ
DJ
mX
mX
mX
DJ
DJ
DJ
DJ
DJ
DJ
DJ
DJ
mX
mX
mX
mX
mX
pl
eC
eC
Fi
Fi
Fi
FT
uj
uj
uj
yD
mX
nZ
mX
Um
Um
Um
Um
Um
Um
Da
qz
Fi
Fi
Fi
Fi
Fi
Pw
rX
"}
(20,1,1) = {"
rX
mX
Um
Um
Um
mX
mX
mX
mX
DJ
DJ
DJ
DJ
DJ
DJ
DJ
mX
mX
mX
DJ
DJ
DJ
DJ
DJ
DJ
DJ
mX
mX
mX
mX
mX
pl
eC
eC
dQ
Fi
Fi
Fi
Fi
Im
uj
yD
mX
mX
mX
Um
Um
Um
Um
Da
Jk
qz
Fi
Fi
Fi
Fi
Fi
Pw
Rk
rX
"}
(21,1,1) = {"
rX
Um
Um
Um
Um
mX
mX
mX
mX
mX
DJ
DJ
DJ
DJ
DJ
DJ
DJ
mX
mX
mX
DJ
DJ
DJ
DJ
DJ
DJ
DJ
mX
mX
mX
mX
pl
eC
eC
eC
Fi
Fi
Fi
Fi
uj
uj
yD
mX
mX
cy
mX
mX
mX
Da
YI
Fi
Fi
Fi
Fi
Fi
Fi
Fi
vi
DJ
rX
"}
(22,1,1) = {"
rX
Um
Um
Um
Um
mX
mX
mX
mX
mX
DJ
DJ
DJ
DJ
DJ
DJ
DJ
mX
mX
mX
mX
wE
DJ
DJ
DJ
DJ
DJ
DJ
mX
mX
mX
pl
eC
eC
eC
fe
Fi
Fi
Fi
uj
uj
yD
mX
mX
mX
mX
mX
Rq
qz
Fi
Fi
Fi
Fi
Fi
Fi
Fi
Pw
Rk
DJ
rX
"}
(23,1,1) = {"
rX
Um
Um
Um
Um
mX
mX
mX
LG
LG
bl
bl
DJ
DJ
Hv
DJ
DJ
mX
mX
mX
mX
mX
DJ
DJ
DJ
Hv
DJ
DJ
mX
mX
Rq
qz
eC
eC
eC
eC
Fi
Fi
Fi
uj
uj
yD
mX
mX
Dm
mX
mX
pl
Fi
Fi
fe
Fi
Fi
Fi
Fi
Pw
Rk
DJ
DJ
rX
"}
(24,1,1) = {"
rX
Um
Um
Um
Um
Um
cy
mX
mX
mX
mX
DJ
DJ
DJ
Bl
DJ
DJ
mX
mX
mX
mX
mX
mX
DJ
DJ
DJ
DJ
DJ
DJ
mX
pl
eC
eC
eC
eC
eC
uj
uj
Fi
uj
uj
Oj
mX
mX
mX
Rq
At
qz
Fi
Fi
Fi
Fi
Fi
Fi
Fi
vi
DJ
dY
DJ
rX
"}
(25,1,1) = {"
rX
Um
Um
Um
Um
Um
mX
mX
mX
mX
mX
DJ
DJ
DJ
Bl
DJ
DJ
DJ
mX
mX
mX
mX
mX
DJ
DJ
DJ
DJ
DJ
DJ
DJ
pl
eC
eC
eC
eC
eC
uj
uj
uj
uj
uj
yD
mX
mX
mX
pl
Fi
Fi
Fi
Fi
Fi
Fi
Fi
Fi
Fi
vi
DJ
DJ
DJ
rX
"}
(26,1,1) = {"
rX
Um
Um
Um
Um
Um
mX
mX
mX
mX
mX
DJ
Hv
DJ
Bl
DJ
DJ
DJ
mX
mX
mX
mX
mX
mX
DJ
DJ
DJ
DJ
DJ
DJ
pl
eC
eC
eC
eC
uj
uj
uj
uj
uj
uj
yD
mX
mX
Rq
qz
Fi
Fi
Fi
Fi
Fi
Fi
Fi
Fi
Pw
Rk
DJ
DJ
bT
rX
"}
(27,1,1) = {"
rX
Um
Um
Um
Um
Um
mX
mX
mX
mX
mX
mX
DJ
Yg
Bl
DJ
DJ
mX
mX
mX
cy
mX
mX
mX
DJ
DJ
DJ
DJ
DJ
Hv
pl
eC
eC
eC
LZ
uj
uj
uj
uj
uj
ii
VY
At
At
qz
Fi
Fi
Fi
Fi
Fi
Fi
Fi
fe
Pw
Rk
DJ
Hv
DJ
bT
rX
"}
(28,1,1) = {"
rX
Um
Um
Um
Um
Um
mX
Um
mX
vB
mX
JC
mX
DJ
Bl
Hv
DJ
mX
mX
mX
mX
mX
mX
mX
DJ
DJ
DJ
DJ
DJ
DJ
vL
eC
eC
eC
eC
uj
bZ
uj
uj
Fi
Ex
qz
Fi
Fi
Fi
Fi
Fi
Fi
DM
Fi
Fi
Fi
Pw
Rk
dY
DJ
DJ
DJ
DJ
rX
"}
(29,1,1) = {"
rX
Um
Um
Um
Um
Um
Um
Um
mX
mX
WM
mX
mX
DJ
DJ
DJ
DJ
DJ
mX
mX
mX
mX
mX
Dm
mX
DJ
DJ
DJ
DJ
dW
vL
eC
eC
eC
eC
uj
uj
uj
uj
Fi
Fi
Fi
uj
Fi
Fi
Fi
Fi
Fi
Fi
Fi
Fi
Fi
vi
DJ
DJ
DJ
DJ
DJ
DJ
rX
"}
(30,1,1) = {"
rX
Um
Um
Um
Um
Um
Um
Um
mX
VO
mX
ko
mX
DJ
DJ
DJ
DJ
DJ
DJ
DJ
mX
mX
mX
mX
mX
DJ
DJ
DJ
DJ
dW
dB
us
eC
eC
mf
uj
uj
uj
uj
uj
uj
uj
uj
Fi
Fi
Fi
Fi
Fi
Fi
Fi
Fi
Bk
Rk
DJ
DJ
DJ
DJ
DJ
DJ
rX
"}
(31,1,1) = {"
rX
Um
Um
Um
Um
Um
Um
Um
mX
mX
mX
mX
mX
mX
mX
DJ
DJ
DJ
DJ
DJ
mX
mX
mX
mX
mX
DJ
DJ
DJ
DJ
DJ
DJ
dB
us
Fi
mf
uj
lU
uj
uj
bZ
uj
uj
uj
uj
fe
Fi
Fi
Fi
Fi
Fi
ii
pD
DJ
DJ
DJ
DJ
DJ
DJ
DJ
rX
"}
(32,1,1) = {"
rX
mX
mX
mX
Um
Um
Um
Um
Um
mX
mX
mX
mX
mX
mX
DJ
DJ
DJ
Vp
DJ
DJ
mX
mX
mX
mX
mX
DJ
dY
DJ
DJ
DJ
DJ
vL
Fi
Fi
Fi
uj
uj
uj
uj
uj
uj
uj
uj
zv
Fi
Fi
Fi
ii
mG
pD
mX
mX
DJ
DJ
dY
DJ
DJ
DJ
rX
"}
(33,1,1) = {"
rX
mX
mX
mX
mX
Um
Um
Um
mX
mX
mX
mX
mX
mX
mX
DJ
DJ
DJ
DJ
DJ
DJ
mX
mX
mX
mX
mX
DJ
DJ
DJ
DJ
DJ
jX
BT
Fi
DM
Fi
uj
uj
uj
uj
uj
uj
uj
Fi
zv
Qw
Fi
Fi
yD
mX
mX
mX
mX
mX
DJ
DJ
DJ
DJ
DJ
rX
"}
(34,1,1) = {"
rX
mX
mX
mX
mX
mX
Um
mX
mX
nZ
mX
mX
mX
mX
mX
mX
DJ
DJ
DJ
dY
DJ
mX
mX
cy
mX
mX
DJ
DJ
DJ
DJ
Hv
vL
Fi
Fi
Fi
Fi
uj
uj
aA
uj
uj
Im
uj
Fi
zv
Bd
Fi
ii
pD
mX
mX
mX
mX
mX
mX
DJ
DJ
DJ
DJ
rX
"}
(35,1,1) = {"
rX
DJ
mX
cy
mX
mX
mX
mX
mX
mX
mX
mX
mX
mX
mX
mX
DJ
DJ
DJ
DJ
DJ
mX
mX
mX
mX
mX
mX
DJ
DJ
DJ
DJ
vL
Fi
Fi
Fi
Fi
uj
uj
uj
uj
uj
uj
uj
Fi
zv
Fi
ii
pD
cy
mX
mX
mX
mX
mX
cy
mX
DJ
DJ
DJ
rX
"}
(36,1,1) = {"
rX
DJ
mX
mX
mX
mX
mX
mX
mX
mX
mX
mX
mX
cy
mX
mX
mX
mX
DJ
DJ
mX
mX
mX
mX
mX
mX
mX
DJ
DJ
DJ
DJ
vL
Fi
Fi
uj
uj
uj
uj
uj
uj
uj
uj
uj
Fi
zv
Fi
yD
mX
mX
mX
mX
mX
mX
mX
mX
mX
DJ
DJ
DJ
rX
"}
(37,1,1) = {"
rX
DJ
DJ
mX
DJ
DJ
mX
mX
mX
mX
mX
mX
mX
mX
mX
mX
mX
mX
mX
mX
mX
mX
IB
mX
mX
mX
mX
DJ
DJ
DJ
jX
BT
Fi
Fi
Im
uj
uj
uj
uj
uj
uj
uj
uj
Fi
fe
Fi
yD
mX
mX
mX
mX
mX
mX
mX
mX
mX
mX
DJ
DJ
rX
"}
(38,1,1) = {"
rX
DJ
DJ
DJ
DJ
DJ
DJ
Dm
mX
mX
mX
mX
mX
mX
mX
mX
mX
mX
mX
Dm
mX
mX
mX
mX
mX
mX
mX
mX
dY
jX
BT
Fi
Fi
Fi
uj
uj
lU
uj
uj
uj
uj
uj
eC
Fi
Fi
ii
pD
mX
mX
mX
mX
Dm
mX
mX
mX
mX
mX
mX
DJ
rX
"}
(39,1,1) = {"
rX
DJ
DJ
DJ
DJ
DJ
DJ
mX
mX
mX
mX
mX
mX
mX
mX
mX
mX
mX
mX
mX
mX
mX
mX
mX
Dm
mX
mX
mX
dY
vL
Fi
Fi
Fi
Fi
Fi
Fi
Fi
Fi
uj
uj
uj
uj
eC
eC
Fi
yD
mX
mX
mX
mX
mX
mX
mX
mX
mX
mX
mX
mX
mX
rX
"}
(40,1,1) = {"
rX
DJ
DJ
DJ
DJ
DJ
DJ
mX
mX
mX
mX
mX
cy
mX
mX
mX
mX
mX
mX
mX
mX
mX
mX
mX
mX
mX
mX
mX
jX
BT
Fi
Fi
Fi
Fi
fe
Fi
Fi
Fi
Fi
uj
uj
uj
eC
eC
Fi
yD
mX
wm
wm
wm
wm
mX
mX
Um
Um
Um
mX
mX
Um
rX
"}
(41,1,1) = {"
rX
DJ
DJ
Hv
DJ
DJ
mX
mX
mX
Um
Um
Um
mX
mX
mX
mX
mX
mX
mX
mX
mX
mX
mX
Dm
mX
mX
mX
mX
pl
Fi
Fi
Fi
Fi
Fi
Fi
Fi
Fi
Fi
fe
uj
uj
uj
eC
eC
Fi
yD
mX
mX
mX
cy
mX
Dm
mX
Um
Um
mX
Um
Um
Um
rX
"}
(42,1,1) = {"
rX
DJ
DJ
DJ
DJ
mX
mX
mX
eu
eu
eu
eu
LG
LG
mX
mX
mX
cy
mX
mX
mX
mX
mX
mX
mX
mX
mX
Rq
qz
Fi
Fi
Fi
Fi
Fi
Fi
Fi
Fi
Fi
Fi
Fi
eC
eC
eC
eC
eC
yD
mX
mX
mX
mX
mX
mX
Um
Um
Um
Um
Um
Um
Um
rX
"}
(43,1,1) = {"
rX
DJ
DJ
DJ
mX
mX
mX
Um
Um
Um
Um
Um
mX
Um
mX
mX
mX
mX
mX
mX
mX
mX
mX
mX
mX
mX
mX
pl
Fi
Fi
Fi
Fi
Fi
Fi
Fi
Fi
Fi
Fi
Fi
fe
eC
eC
eC
eC
eC
yD
mX
mX
mX
Uo
mX
mX
Um
Um
Um
Um
Um
Um
Um
rX
"}
(44,1,1) = {"
rX
DJ
DJ
mX
mX
mX
mX
Um
Um
Um
Um
Um
Um
Um
Dm
mX
mX
mX
mX
mX
mX
mX
mX
mX
mX
Rq
At
qz
FG
Fi
Fi
Fi
DM
Fi
Fi
Fi
Fi
Fi
DM
Fi
Fi
eC
eC
eC
eC
jT
xh
mX
mX
mX
mX
mX
Um
Um
Um
Um
Um
Um
Um
rX
"}
(45,1,1) = {"
rX
DJ
mX
mX
mX
mX
mX
Um
Um
Um
Um
Um
Um
Um
Um
Um
mX
mX
mX
mX
mX
cy
mX
mX
cy
pl
Fi
Fi
FG
Fi
FT
Fi
Fi
Fi
Fi
Fi
Fi
Fi
Fi
Fi
Fi
eC
eC
eC
eC
eC
yD
mX
mX
mX
mX
mX
Um
Um
Um
Um
Um
Um
Um
rX
"}
(46,1,1) = {"
rX
mX
mX
mX
mX
mX
mX
Um
Um
Um
Um
Um
Um
Um
Um
Um
mX
mX
mX
mX
mX
mX
mX
mX
Rq
qz
Fi
Fi
FG
Fi
Fi
Fi
Fi
Fi
Fi
Fi
Fi
Fi
Fi
Fi
MV
eC
eC
eC
eC
eC
yD
mX
mX
mX
cy
mX
mX
Um
Um
Um
Um
mX
Um
rX
"}
(47,1,1) = {"
rX
mX
mX
mX
Dm
mX
mX
Um
Um
Um
Um
Um
Um
Um
Um
Um
mX
mX
mX
mX
mX
mX
mX
mX
pl
Fi
Fi
Fi
FG
Fi
Fi
Fi
Fi
Fi
Fi
Fi
Fi
Fi
Fi
Fi
yf
TF
eC
eC
eC
eC
Ex
xh
mX
mX
mX
mX
mX
Um
Um
Um
Um
Um
Um
rX
"}
(48,1,1) = {"
rX
mX
mX
mX
cy
mX
mX
Um
Um
Um
Um
Um
Um
Um
Um
Um
Um
mX
mX
mX
mX
mX
Rq
mi
qz
Fi
Fi
Fi
FG
Fi
Fi
Fi
Fi
Fi
Fi
fe
Fi
Fi
ii
mG
pD
pl
eC
eC
eC
eC
eC
yD
mX
mX
mX
mX
mX
mX
mX
Um
Um
Um
Um
rX
"}
(49,1,1) = {"
rX
mX
mX
mX
mX
mX
mX
Um
Um
Um
Um
Um
Um
Um
Um
Um
Um
Um
mX
mX
mX
Rq
qz
Fi
Fi
Fi
Fi
Fi
Fi
Fi
Fi
Fi
Fi
Fi
Fi
Fi
Fi
Fi
yD
mX
mX
pl
eC
eC
eC
eC
eC
yD
mX
mX
mX
mX
mX
mX
mX
mX
mX
mX
Um
rX
"}
(50,1,1) = {"
rX
mX
mX
mX
mX
mX
mX
mX
Um
Um
Um
Um
Um
Um
Um
Um
Um
Um
mX
mX
Rq
qz
Fi
Fi
Fi
Fi
Fi
Fi
Fi
Fi
Fi
fe
Fi
Fi
Fi
Fi
ii
mG
pD
mX
mX
pl
eC
dQ
eC
eC
eC
Ex
xh
mX
mX
mX
mX
mX
mX
mX
mX
mX
mX
rX
"}
(51,1,1) = {"
rX
At
At
At
At
xh
mX
mX
mX
mX
Um
Um
Um
Um
Um
Um
Um
Um
Rq
At
qz
Fi
Fi
Fi
Fi
Fi
Fi
Fi
Fi
Fi
Fi
Fi
Fi
Fi
ii
mG
pD
mX
mX
mX
mX
ZK
eC
eC
eC
eC
eC
eC
yD
mX
mX
Dm
mX
mX
Rq
At
At
At
At
rX
"}
(52,1,1) = {"
rX
bT
bT
bT
mb
yD
mX
mX
mX
mX
Um
Um
Um
Um
Um
Um
Um
Da
qz
Fi
Fi
Fi
Fi
Fi
Fi
Fi
Fi
Fi
Fi
Fi
Fi
Fi
Fi
ii
pD
mX
mX
mX
mX
mX
mX
ZK
eC
eC
eC
eC
eC
eC
Ex
xh
mX
mX
mX
mX
pl
Rp
bT
bT
bT
rX
"}
(53,1,1) = {"
rX
bT
bT
bT
Bv
yD
mX
mX
mX
mX
Um
Um
Um
Um
Um
Um
Um
of
Fi
Fi
Fi
fe
Fi
Fi
Fi
Fi
Fi
Fi
Fi
Fi
Fi
Fi
Fi
yD
mX
mX
mX
mX
mX
Ec
mX
fO
mG
TF
eC
eC
eC
eC
eC
yD
mX
cy
mX
mX
pl
NN
bT
bT
bT
rX
"}
(54,1,1) = {"
rX
bT
bT
bT
Bv
yD
mX
mX
mX
mX
mX
mX
Um
Um
Um
Um
Rq
qz
Fi
Fi
Fi
Fi
Fi
Fi
Fi
Fi
Fi
Fi
Fi
Fi
Fi
ii
mG
pD
mX
mX
mX
mX
cy
mX
mX
kX
mX
pl
eC
eC
eC
eC
eC
yD
mX
mX
mX
mX
pl
NN
bT
bT
bT
rX
"}
(55,1,1) = {"
rX
bT
bT
bT
Bv
yD
mX
mX
mX
mX
mX
mX
mX
Um
Da
Jk
qz
Fi
Fi
Fi
Fi
Fi
Fi
Fi
Fi
Fi
Fi
Fi
Fi
Fi
Fi
yD
mX
mX
mX
Dm
mX
mX
mX
mX
mX
kX
mX
pl
eC
eC
eC
eC
eC
yD
mX
mX
mX
mX
pl
NN
bT
bT
bT
rX
"}
(56,1,1) = {"
rX
bT
bT
Ii
rX
yD
mX
mX
cy
cy
mX
mX
mX
Rq
qz
Fi
Fi
Fi
Fi
Fi
Fi
DM
Fi
Fi
Fi
Fi
fe
Fi
Fi
Fi
Fi
yD
mX
mX
mX
mX
mX
mX
mX
mX
mX
kX
mX
Pg
TF
eC
eC
eC
eC
Ex
At
xh
mX
mX
pl
rX
bT
bT
Ii
rX
"}
(57,1,1) = {"
rX
Iu
Iu
Iu
rX
yD
mX
mX
mX
mX
mX
mX
Rq
qz
Fi
Fi
fe
Fi
Fi
Fi
Fi
Fi
Fi
Fi
Fi
Fi
Fi
Fi
Fi
Fi
Fi
Ex
xh
mX
mX
mX
mX
mX
mX
mX
mX
kX
mX
mX
Pg
TF
eC
eC
eC
eC
eC
yD
mX
mX
pl
rX
eW
eW
eW
rX
"}
(58,1,1) = {"
rX
Iu
Iu
Iu
rX
yD
mX
mX
mX
mX
Rq
At
qz
Fi
Fi
Fi
Fi
Fi
Fi
Fi
Fi
Fi
Fi
Fi
Fi
Fi
Fi
Fi
Fi
Fi
Fi
Fi
Ex
xh
mX
mX
mX
mX
mX
mX
mX
mX
mX
mX
mX
pl
eC
eC
eC
eC
eC
Ex
xh
mX
pl
rX
eW
eW
eW
rX
"}
(59,1,1) = {"
rX
Iu
Iu
Iu
rX
yD
mX
mX
mX
Rq
qz
Fi
Fi
Fi
Fi
Fi
Fi
Fi
Fi
Fi
Fi
Fi
Fi
Fi
Fi
Fi
Fi
Fi
Fi
Fi
Fi
Fi
Fi
Ex
xh
mX
mX
mX
mX
mX
mX
mX
mX
mX
mX
Pg
TF
eC
eC
eC
eC
eC
Ex
xh
pl
rX
eW
eW
eW
rX
"}
(60,1,1) = {"
rX
rX
rX
rX
rX
rX
rX
rX
rX
rX
rX
rX
rX
rX
rX
rX
rX
rX
rX
rX
rX
rX
rX
rX
rX
rX
rX
rX
rX
rX
rX
rX
rX
rX
rX
rX
rX
rX
rX
rX
rX
rX
rX
rX
rX
rX
rX
rX
rX
rX
rX
rX
rX
rX
rX
rX
rX
rX
rX
rX
"}
