//MAP CONVERTED BY dmm2tgm.py THIS HEADER COMMENT PREVENTS RECONVERSION, DO NOT REMOVE
"aJ" = (
/obj/structure/barricade/sandbags,
/turf/open/floor/pod/dark,
/area/violence)
"bR" = (
/obj/structure/barricade/sandbags,
/obj/structure/barricade/sandbags,
/obj/structure/barricade/sandbags,
/turf/open/floor/pod/dark,
/area/violence)
"bX" = (
/obj/singularity/academy,
/turf/open/floor/pod/dark,
/area/violence)
"ju" = (
/obj/machinery/door/airlock/highsecurity,
/obj/effect/mapping_helpers/airlock/access/all,
/obj/effect/mine/gas/n2o,
/turf/open/floor/pod/dark,
/area/violence)
"kJ" = (
/obj/effect/spawner/trap,
/turf/open/floor/pod/dark,
/area/violence)
"ld" = (
/turf/template_noop,
/area/template_noop)
"lp" = (
/turf/closed/indestructible/fakeglass,
/area/violence)
"ml" = (
/obj/effect/landmark/bomb_plant_location,
/obj/effect/turf_decal/box/red,
/turf/open/floor/pod/dark,
/area/violence)
"oG" = (
/obj/effect/turf_decal/box/red/corners{
	dir = 8
	},
/turf/open/floor/pod/dark,
/area/violence)
"qF" = (
/obj/machinery/door/airlock/highsecurity,
/obj/effect/mapping_helpers/airlock/access/all,
/obj/effect/mine/stun,
/turf/open/floor/pod/dark,
/area/violence)
"rY" = (
/obj/effect/mine/pickup/speed,
/turf/open/floor/pod/dark,
/area/violence)
"sk" = (
/turf/open/floor/pod/dark,
/area/violence)
"vH" = (
/obj/machinery/door/airlock/highsecurity,
/obj/effect/mapping_helpers/airlock/access/all,
/turf/open/floor/pod/dark,
/area/violence)
"Cz" = (
/obj/effect/mapping_helpers/airlock/access/all,
/obj/machinery/door/airlock/highsecurity,
/turf/open/floor/pod/dark,
/area/violence)
"CF" = (
/obj/effect/spawner/structure/window/reinforced/indestructable,
/turf/open/floor/pod/dark,
/area/violence)
"DB" = (
/obj/structure/barricade/sandbags,
/obj/structure/barricade/sandbags,
/turf/open/floor/pod/dark,
/area/violence)
"Fy" = (
/obj/effect/turf_decal/box/red/corners{
	dir = 1
	},
/turf/open/floor/pod/dark,
/area/violence)
"FK" = (
/turf/open/floor/plating/ice,
/area/violence)
"Gc" = (
/obj/effect/spawner/random/contraband/armory,
/obj/structure/table,
/turf/open/floor/pod/dark,
/area/violence)
"Ld" = (
/obj/effect/mapping_helpers/airlock/access/all,
/obj/machinery/door/airlock/highsecurity,
/turf/open/floor/clockwork,
/area/violence)
"PK" = (
/obj/effect/turf_decal/box/red/corners,
/turf/open/floor/pod/dark,
/area/violence)
"PN" = (
/obj/machinery/door/poddoor/ert,
/turf/open/floor/pod/dark,
/area/violence)
"Qo" = (
/obj/effect/turf_decal/box/red/corners{
	dir = 4
	},
/turf/open/floor/pod/dark,
/area/violence)
"Te" = (
/obj/machinery/door/airlock/highsecurity,
/obj/effect/mapping_helpers/airlock/access/all,
/obj/effect/mine/sound/bwoink,
/turf/open/floor/pod/dark,
/area/violence)
"Vq" = (
/obj/effect/landmark/start/combatant/red,
/turf/open/floor/pod/dark,
/area/violence)
"VQ" = (
/turf/closed/wall/rust,
/area/violence)
"Xp" = (
/obj/effect/mine/pickup/healing,
/turf/open/floor/pod/dark,
/area/violence)
"XS" = (
/turf/open/lava/plasma/ice_moon,
/area/violence)
"ZO" = (
/turf/open/floor/plating/asteroid/dirty/fake_lava_v2,
/area/violence)
"ZQ" = (
/obj/effect/landmark/start/combatant/blue,
/turf/open/floor/pod/dark,
/area/violence)

(1,1,1) = {"
ld
ld
ld
ld
ld
ld
ld
ld
ld
ld
ld
ld
ld
ld
ld
ld
ld
ld
ld
ld
ld
ld
ld
ld
ld
ld
ld
ld
ld
ld
ld
ld
"}
(2,1,1) = {"
ld
ld
ld
ld
ld
ld
ld
ld
ld
ld
ld
ld
ld
ld
ld
ld
ld
ld
ld
ld
ld
ld
ld
ld
ld
ld
ld
ld
ld
ld
ld
ld
"}
(3,1,1) = {"
ld
ld
ld
ld
ld
ld
ld
ld
ld
ld
ld
ld
ld
ld
ld
ld
ld
ld
ld
ld
ld
ld
ld
ld
ld
ld
ld
ld
ld
ld
ld
ld
"}
(4,1,1) = {"
ld
ld
ld
ld
ld
ld
ld
ld
ld
ld
ld
ld
ld
ld
ld
ld
ld
ld
ld
ld
ld
ld
ld
ld
ld
ld
ld
ld
ld
ld
ld
ld
"}
(5,1,1) = {"
ld
ld
ld
ld
ld
ld
ld
ld
ld
ld
ld
ld
ld
ld
ld
ld
ld
ld
ld
ld
ld
ld
ld
ld
ld
ld
ld
ld
ld
ld
ld
ld
"}
(6,1,1) = {"
ld
ld
ld
ld
ld
ld
ld
ld
ld
ld
ld
ld
ld
ld
ld
ld
ld
ld
ld
ld
ld
ld
ld
ld
ld
ld
ld
ld
ld
ld
ld
ld
"}
(7,1,1) = {"
ld
ld
ld
ld
ld
ld
ld
ld
ld
ld
ld
ld
ld
ld
ld
ld
ld
ld
ld
ld
ld
ld
ld
ld
ld
ld
ld
ld
ld
ld
ld
ld
"}
(8,1,1) = {"
ld
ld
ld
ld
ld
ld
ld
ld
ld
ld
ld
ld
ld
ld
ld
ld
ld
ld
ld
ld
ld
ld
ld
ld
ld
ld
ld
ld
ld
ld
ld
ld
"}
(9,1,1) = {"
ld
ld
ld
ld
ld
VQ
lp
lp
lp
VQ
VQ
VQ
VQ
VQ
lp
lp
lp
lp
VQ
VQ
VQ
VQ
VQ
lp
lp
lp
VQ
ld
ld
ld
ld
ld
"}
(10,1,1) = {"
ld
ld
ld
ld
ld
VQ
sk
sk
sk
sk
sk
sk
sk
PN
ZQ
ZQ
ZQ
ZQ
PN
sk
sk
sk
sk
sk
sk
sk
VQ
ld
ld
ld
ld
ld
"}
(11,1,1) = {"
ld
ld
ld
ld
ld
VQ
sk
aJ
sk
sk
sk
aJ
sk
PN
ZQ
ZQ
ZQ
ZQ
PN
sk
aJ
sk
sk
sk
aJ
sk
VQ
ld
ld
ld
ld
ld
"}
(12,1,1) = {"
ld
ld
ld
ld
ld
VQ
sk
aJ
sk
Xp
sk
aJ
sk
PN
ZQ
ZQ
ZQ
ZQ
PN
sk
aJ
sk
Xp
sk
aJ
sk
VQ
ld
ld
ld
ld
ld
"}
(13,1,1) = {"
ld
ld
ld
ld
ld
VQ
sk
DB
aJ
aJ
aJ
DB
sk
PN
ZQ
ZQ
ZQ
ZQ
PN
sk
DB
aJ
aJ
aJ
bR
sk
VQ
ld
ld
ld
ld
ld
"}
(14,1,1) = {"
ld
ld
ld
ld
ld
VQ
sk
sk
sk
sk
sk
sk
sk
VQ
PN
PN
PN
PN
VQ
sk
sk
sk
sk
sk
sk
sk
VQ
ld
ld
ld
ld
ld
"}
(15,1,1) = {"
ld
ld
ld
ld
ld
VQ
XS
XS
XS
sk
XS
XS
XS
VQ
ZO
rY
rY
ZO
VQ
XS
XS
XS
sk
XS
XS
XS
VQ
ld
ld
ld
ld
ld
"}
(16,1,1) = {"
ld
ld
ld
ld
ld
VQ
VQ
VQ
VQ
vH
VQ
VQ
VQ
VQ
ZO
sk
sk
ZO
VQ
VQ
VQ
VQ
vH
VQ
VQ
VQ
VQ
ld
ld
ld
ld
ld
"}
(17,1,1) = {"
ld
ld
ld
ld
ld
VQ
bX
sk
kJ
sk
kJ
sk
bX
VQ
ZO
sk
sk
ZO
VQ
bX
sk
kJ
sk
kJ
sk
bX
VQ
ld
ld
ld
ld
ld
"}
(18,1,1) = {"
ld
ld
ld
ld
ld
VQ
sk
sk
sk
sk
sk
sk
sk
VQ
ZO
sk
sk
ZO
VQ
sk
sk
sk
sk
sk
sk
sk
VQ
ld
ld
ld
ld
ld
"}
(19,1,1) = {"
ld
ld
ld
ld
ld
VQ
sk
sk
sk
sk
sk
sk
sk
VQ
ZO
sk
sk
ZO
VQ
sk
sk
sk
sk
sk
sk
sk
VQ
ld
ld
ld
ld
ld
"}
(20,1,1) = {"
ld
ld
ld
ld
ld
VQ
bX
sk
kJ
sk
kJ
sk
bX
VQ
ZO
sk
sk
ZO
VQ
bX
sk
kJ
sk
kJ
sk
bX
VQ
ld
ld
ld
ld
ld
"}
(21,1,1) = {"
ld
ld
ld
ld
ld
VQ
VQ
VQ
VQ
Te
VQ
VQ
VQ
VQ
VQ
sk
sk
VQ
VQ
VQ
VQ
VQ
Te
VQ
VQ
VQ
VQ
ld
ld
ld
ld
ld
"}
(22,1,1) = {"
ld
ld
ld
ld
ld
lp
XS
sk
sk
sk
sk
sk
sk
sk
bX
sk
sk
bX
sk
sk
sk
sk
sk
sk
sk
XS
lp
ld
ld
ld
ld
ld
"}
(23,1,1) = {"
ld
ld
ld
ld
ld
lp
sk
sk
aJ
sk
aJ
sk
aJ
sk
sk
sk
sk
sk
sk
aJ
sk
aJ
sk
aJ
sk
sk
lp
ld
ld
ld
ld
ld
"}
(24,1,1) = {"
ld
ld
ld
ld
ld
lp
sk
sk
sk
FK
sk
FK
sk
sk
sk
kJ
kJ
sk
sk
sk
FK
sk
FK
sk
sk
sk
lp
ld
ld
ld
ld
ld
"}
(25,1,1) = {"
ld
ld
ld
ld
ld
lp
sk
sk
aJ
sk
aJ
sk
aJ
sk
sk
sk
sk
sk
sk
aJ
sk
aJ
sk
aJ
sk
sk
lp
ld
ld
ld
ld
ld
"}
(26,1,1) = {"
ld
ld
ld
ld
ld
lp
aJ
sk
sk
sk
sk
sk
sk
sk
bX
sk
sk
bX
sk
sk
sk
sk
sk
sk
sk
aJ
lp
ld
ld
ld
ld
ld
"}
(27,1,1) = {"
ld
ld
ld
ld
ld
lp
sk
sk
VQ
VQ
VQ
VQ
VQ
VQ
VQ
sk
sk
VQ
VQ
VQ
VQ
VQ
VQ
VQ
sk
sk
lp
ld
ld
ld
ld
ld
"}
(28,1,1) = {"
ld
ld
ld
ld
ld
lp
sk
aJ
VQ
XS
sk
sk
XS
VQ
sk
sk
sk
sk
VQ
XS
sk
sk
XS
VQ
aJ
sk
lp
ld
ld
ld
ld
ld
"}
(29,1,1) = {"
ld
ld
ld
ld
ld
lp
sk
sk
VQ
sk
sk
sk
sk
VQ
PK
sk
Qo
sk
VQ
sk
sk
sk
sk
VQ
sk
sk
lp
ld
ld
ld
ld
ld
"}
(30,1,1) = {"
ld
ld
ld
ld
ld
lp
aJ
sk
VQ
sk
Gc
Gc
sk
VQ
VQ
ml
sk
VQ
VQ
sk
Gc
Gc
sk
VQ
sk
aJ
lp
ld
ld
ld
ld
ld
"}
(31,1,1) = {"
ld
ld
ld
ld
ld
lp
sk
sk
qF
sk
sk
sk
sk
vH
oG
sk
Fy
sk
vH
sk
sk
sk
sk
ju
sk
sk
lp
ld
ld
ld
ld
ld
"}
(32,1,1) = {"
ld
ld
ld
ld
ld
Cz
sk
aJ
VQ
VQ
VQ
VQ
VQ
VQ
sk
CF
CF
sk
VQ
VQ
VQ
VQ
VQ
VQ
aJ
sk
Ld
ld
ld
ld
ld
ld
"}
(33,1,1) = {"
ld
ld
ld
ld
ld
lp
sk
sk
ju
sk
sk
sk
sk
vH
sk
sk
sk
sk
vH
sk
sk
sk
sk
qF
sk
sk
lp
ld
ld
ld
ld
ld
"}
(34,1,1) = {"
ld
ld
ld
ld
ld
lp
aJ
sk
VQ
sk
Gc
Gc
sk
VQ
VQ
sk
sk
VQ
VQ
sk
Gc
Gc
sk
VQ
sk
aJ
lp
ld
ld
ld
ld
ld
"}
(35,1,1) = {"
ld
ld
ld
ld
ld
lp
sk
sk
VQ
sk
sk
sk
sk
VQ
sk
sk
sk
sk
VQ
sk
sk
sk
sk
VQ
sk
sk
lp
ld
ld
ld
ld
ld
"}
(36,1,1) = {"
ld
ld
ld
ld
ld
lp
sk
aJ
VQ
XS
sk
sk
XS
VQ
sk
sk
sk
sk
VQ
XS
sk
sk
XS
VQ
aJ
sk
lp
ld
ld
ld
ld
ld
"}
(37,1,1) = {"
ld
ld
ld
ld
ld
lp
sk
sk
VQ
VQ
VQ
VQ
VQ
VQ
VQ
sk
sk
VQ
VQ
VQ
VQ
VQ
VQ
VQ
sk
sk
lp
ld
ld
ld
ld
ld
"}
(38,1,1) = {"
ld
ld
ld
ld
ld
lp
aJ
sk
sk
sk
sk
sk
sk
sk
bX
sk
sk
bX
sk
sk
sk
sk
sk
sk
sk
aJ
lp
ld
ld
ld
ld
ld
"}
(39,1,1) = {"
ld
ld
ld
ld
ld
lp
sk
sk
aJ
sk
aJ
sk
aJ
sk
sk
sk
sk
sk
sk
aJ
sk
aJ
sk
aJ
sk
sk
lp
ld
ld
ld
ld
ld
"}
(40,1,1) = {"
ld
ld
ld
ld
ld
lp
sk
sk
sk
FK
sk
FK
sk
sk
sk
kJ
kJ
sk
sk
sk
FK
sk
FK
sk
sk
sk
lp
ld
ld
ld
ld
ld
"}
(41,1,1) = {"
ld
ld
ld
ld
ld
lp
sk
sk
aJ
sk
aJ
sk
aJ
sk
sk
sk
sk
sk
sk
aJ
sk
aJ
sk
aJ
sk
sk
lp
ld
ld
ld
ld
ld
"}
(42,1,1) = {"
ld
ld
ld
ld
ld
lp
XS
sk
sk
sk
sk
sk
sk
sk
bX
sk
sk
bX
sk
sk
sk
sk
sk
sk
sk
XS
lp
ld
ld
ld
ld
ld
"}
(43,1,1) = {"
ld
ld
ld
ld
ld
VQ
VQ
VQ
VQ
Te
VQ
VQ
VQ
VQ
VQ
sk
sk
VQ
VQ
VQ
VQ
VQ
Te
VQ
VQ
VQ
VQ
ld
ld
ld
ld
ld
"}
(44,1,1) = {"
ld
ld
ld
ld
ld
VQ
bX
sk
kJ
sk
kJ
sk
bX
VQ
ZO
sk
sk
ZO
VQ
bX
sk
kJ
sk
kJ
sk
bX
VQ
ld
ld
ld
ld
ld
"}
(45,1,1) = {"
ld
ld
ld
ld
ld
VQ
sk
sk
sk
sk
sk
sk
sk
VQ
ZO
sk
sk
ZO
VQ
sk
sk
sk
sk
sk
sk
sk
VQ
ld
ld
ld
ld
ld
"}
(46,1,1) = {"
ld
ld
ld
ld
ld
VQ
sk
sk
sk
sk
sk
sk
sk
VQ
ZO
sk
sk
ZO
VQ
sk
sk
sk
sk
sk
sk
sk
VQ
ld
ld
ld
ld
ld
"}
(47,1,1) = {"
ld
ld
ld
ld
ld
VQ
bX
sk
kJ
sk
kJ
sk
bX
VQ
ZO
sk
sk
ZO
VQ
bX
sk
kJ
sk
kJ
sk
bX
VQ
ld
ld
ld
ld
ld
"}
(48,1,1) = {"
ld
ld
ld
ld
ld
VQ
VQ
VQ
VQ
vH
VQ
VQ
VQ
VQ
ZO
sk
sk
ZO
VQ
VQ
VQ
VQ
vH
VQ
VQ
VQ
VQ
ld
ld
ld
ld
ld
"}
(49,1,1) = {"
ld
ld
ld
ld
ld
VQ
XS
XS
XS
sk
XS
XS
XS
VQ
ZO
rY
rY
ZO
VQ
XS
XS
XS
sk
XS
XS
XS
VQ
ld
ld
ld
ld
ld
"}
(50,1,1) = {"
ld
ld
ld
ld
ld
VQ
sk
sk
sk
sk
sk
sk
sk
VQ
PN
PN
PN
PN
VQ
sk
sk
sk
sk
sk
sk
sk
VQ
ld
ld
ld
ld
ld
"}
(51,1,1) = {"
ld
ld
ld
ld
ld
VQ
sk
DB
aJ
aJ
aJ
DB
sk
PN
Vq
Vq
Vq
Vq
PN
sk
DB
aJ
aJ
aJ
DB
sk
VQ
ld
ld
ld
ld
ld
"}
(52,1,1) = {"
ld
ld
ld
ld
ld
VQ
sk
aJ
sk
Xp
sk
aJ
sk
PN
Vq
Vq
Vq
Vq
PN
sk
aJ
sk
Xp
sk
aJ
sk
VQ
ld
ld
ld
ld
ld
"}
(53,1,1) = {"
ld
ld
ld
ld
ld
VQ
sk
DB
sk
sk
sk
DB
sk
PN
Vq
Vq
Vq
Vq
PN
sk
DB
sk
sk
sk
DB
sk
VQ
ld
ld
ld
ld
ld
"}
(54,1,1) = {"
ld
ld
ld
ld
ld
VQ
sk
sk
sk
sk
sk
sk
sk
PN
Vq
Vq
Vq
Vq
PN
sk
sk
sk
sk
sk
sk
sk
VQ
ld
ld
ld
ld
ld
"}
(55,1,1) = {"
ld
ld
ld
ld
ld
VQ
lp
lp
lp
VQ
VQ
VQ
VQ
VQ
lp
lp
lp
lp
VQ
VQ
VQ
VQ
VQ
lp
lp
lp
VQ
ld
ld
ld
ld
ld
"}
(56,1,1) = {"
ld
ld
ld
ld
ld
ld
ld
ld
ld
ld
ld
ld
ld
ld
ld
ld
ld
ld
ld
ld
ld
ld
ld
ld
ld
ld
ld
ld
ld
ld
ld
ld
"}
(57,1,1) = {"
ld
ld
ld
ld
ld
ld
ld
ld
ld
ld
ld
ld
ld
ld
ld
ld
ld
ld
ld
ld
ld
ld
ld
ld
ld
ld
ld
ld
ld
ld
ld
ld
"}
(58,1,1) = {"
ld
ld
ld
ld
ld
ld
ld
ld
ld
ld
ld
ld
ld
ld
ld
ld
ld
ld
ld
ld
ld
ld
ld
ld
ld
ld
ld
ld
ld
ld
ld
ld
"}
(59,1,1) = {"
ld
ld
ld
ld
ld
ld
ld
ld
ld
ld
ld
ld
ld
ld
ld
ld
ld
ld
ld
ld
ld
ld
ld
ld
ld
ld
ld
ld
ld
ld
ld
ld
"}
(60,1,1) = {"
ld
ld
ld
ld
ld
ld
ld
ld
ld
ld
ld
ld
ld
ld
ld
ld
ld
ld
ld
ld
ld
ld
ld
ld
ld
ld
ld
ld
ld
ld
ld
ld
"}
(61,1,1) = {"
ld
ld
ld
ld
ld
ld
ld
ld
ld
ld
ld
ld
ld
ld
ld
ld
ld
ld
ld
ld
ld
ld
ld
ld
ld
ld
ld
ld
ld
ld
ld
ld
"}
(62,1,1) = {"
ld
ld
ld
ld
ld
ld
ld
ld
ld
ld
ld
ld
ld
ld
ld
ld
ld
ld
ld
ld
ld
ld
ld
ld
ld
ld
ld
ld
ld
ld
ld
ld
"}
(63,1,1) = {"
ld
ld
ld
ld
ld
ld
ld
ld
ld
ld
ld
ld
ld
ld
ld
ld
ld
ld
ld
ld
ld
ld
ld
ld
ld
ld
ld
ld
ld
ld
ld
ld
"}
(64,1,1) = {"
ld
ld
ld
ld
ld
ld
ld
ld
ld
ld
ld
ld
ld
ld
ld
ld
ld
ld
ld
ld
ld
ld
ld
ld
ld
ld
ld
ld
ld
ld
ld
ld
"}
