//MAP CONVERTED BY dmm2tgm.py THIS HEADER COMMENT PREVENTS RECONVERSION, DO NOT REMOVE
"a" = (
/turf/closed/dz/normal/cyber,
/area/violence)
"b" = (
/obj/machinery/door/poddoor/multi_tile/three_tile_hor{
	resistance_flags = 115
	},
/turf/open/floor/dz/cyber,
/area/violence)
"c" = (
/obj/effect/particle_cyberspess,
/turf/open/floor/dz/cyber,
/area/violence)
"d" = (
/obj/machinery/power/emitter/energycannon{
	dir = 4
	},
/turf/closed/dz/normal/cyber,
/area/violence)
"e" = (
/obj/effect/turf_decal/box/red/corners,
/turf/open/floor/dz/cyber,
/area/violence)
"f" = (
/obj/effect/landmark/start/combatant/blue,
/turf/open/floor/dz/green,
/area/violence)
"g" = (
/turf/template_noop,
/area/template_noop)
"h" = (
/turf/closed/dz/normal/cyber/ice/blue,
/area/violence)
"j" = (
/obj/effect/mapping_helpers/turf_rotation,
/turf/open/floor/dz/hot_plates,
/area/violence)
"l" = (
/obj/effect/baseturf_helper/dune,
/turf/closed/dz/normal/cyber,
/area/violence)
"o" = (
/obj/effect/turf_decal/box/red/corners{
	dir = 1
	},
/turf/open/floor/dz/cyber,
/area/violence)
"q" = (
/turf/closed/dz/normal/cyber/ice/green,
/area/violence)
"r" = (
/obj/effect/turf_decal/box/red/corners{
	dir = 8
	},
/turf/open/floor/dz/cyber,
/area/violence)
"s" = (
/obj/effect/mapping_helpers/turf_rotation{
	timer = 5
	},
/turf/open/floor/dz/corruption,
/area/violence)
"v" = (
/turf/open/floor/dz/cyber,
/area/violence)
"w" = (
/turf/closed/dz/normal/cyber/ice/yellow,
/area/violence)
"y" = (
/turf/closed/dz/normal/cyber/ice/black,
/area/violence)
"z" = (
/obj/effect/landmark/start/combatant/blue,
/obj/effect/particle_cyberspess,
/turf/open/floor/dz/green,
/area/violence)
"A" = (
/obj/effect/landmark/start/combatant/red,
/obj/effect/particle_cyberspess,
/turf/open/floor/dz/green,
/area/violence)
"B" = (
/obj/structure/sign/dz,
/turf/closed/dz/normal/cyber,
/area/violence)
"C" = (
/obj/structure/sign/dz/end,
/turf/closed/dz/normal/cyber,
/area/violence)
"D" = (
/obj/effect/powerup/health,
/turf/open/floor/dz/cyber,
/area/violence)
"E" = (
/obj/effect/powerup/health/full,
/obj/effect/particle_cyberspess,
/turf/closed/dz/normal/cyber/ice/blue,
/area/violence)
"G" = (
/obj/effect/powerup/ammo,
/turf/open/floor/dz/cyber,
/area/violence)
"H" = (
/obj/effect/landmark/start/combatant/red,
/turf/open/floor/dz/green,
/area/violence)
"I" = (
/obj/machinery/door/poddoor/multi_tile/three_tile_ver{
	resistance_flags = 115
	},
/turf/open/floor/dz/cyber,
/area/violence)
"K" = (
/obj/effect/landmark/bomb_plant_location,
/obj/effect/turf_decal/box/red,
/turf/open/floor/dz/cyber,
/area/violence)
"L" = (
/obj/machinery/power/emitter/energycannon{
	dir = 8
	},
/turf/closed/dz/normal/cyber,
/area/violence)
"M" = (
/turf/closed/dz/normal/cyber/ice/red,
/area/violence)
"O" = (
/obj/effect/landmark/start/combatant/blue,
/turf/open/floor/dz/trippy_green,
/area/violence)
"P" = (
/obj/structure/sign/dz/middle,
/turf/closed/dz/normal/cyber,
/area/violence)
"Q" = (
/obj/effect/landmark/start/combatant/red,
/turf/open/floor/dz/trippy_green,
/area/violence)
"W" = (
/obj/effect/turf_decal/box/red/corners{
	dir = 4
	},
/turf/open/floor/dz/cyber,
/area/violence)
"Z" = (
/obj/lab_monitor{
	what_pic = "survive"
	},
/turf/closed/dz/normal/cyber,
/area/violence)

(1,1,1) = {"
l
a
a
a
a
a
a
a
a
a
a
a
a
a
a
g
g
g
g
g
g
g
g
g
g
g
g
g
g
g
g
g
g
g
g
g
g
g
g
a
a
a
a
a
a
a
a
a
a
a
a
a
a
a
"}
(2,1,1) = {"
a
h
h
h
h
h
h
M
j
j
j
j
j
j
a
a
a
a
d
a
a
a
a
a
a
a
a
a
a
a
a
a
a
a
a
a
a
a
a
a
j
j
j
j
j
j
M
h
h
h
h
h
h
a
"}
(3,1,1) = {"
a
h
D
v
v
v
v
M
j
j
j
j
j
j
j
q
v
v
v
v
w
j
j
j
j
j
j
j
j
j
j
j
j
w
v
v
v
v
q
j
j
j
j
j
j
j
M
v
v
v
v
D
h
a
"}
(4,1,1) = {"
a
h
v
c
v
v
v
M
j
j
j
j
j
j
j
q
v
v
v
v
w
j
j
j
j
j
j
j
j
j
j
j
j
w
v
v
v
v
q
j
j
j
j
j
j
j
M
v
v
v
c
v
h
a
"}
(5,1,1) = {"
a
h
v
v
v
v
v
M
j
j
j
j
j
j
j
q
v
v
v
v
w
j
j
j
j
j
j
j
j
j
j
j
j
w
v
v
v
v
q
j
j
j
j
j
j
j
M
v
v
v
v
v
h
a
"}
(6,1,1) = {"
a
h
v
v
v
v
v
M
j
j
j
j
j
j
j
q
v
v
v
v
w
j
j
j
j
j
j
j
j
j
j
j
j
w
v
v
v
v
q
j
j
j
j
j
j
j
M
v
v
v
v
v
h
a
"}
(7,1,1) = {"
a
h
v
v
v
v
v
M
j
j
j
j
j
j
j
q
v
v
v
v
w
j
j
j
j
j
j
j
j
j
j
j
j
w
v
v
v
v
q
j
j
j
j
j
j
j
M
v
v
v
v
v
h
a
"}
(8,1,1) = {"
a
h
v
v
v
v
v
M
j
j
j
j
j
j
j
a
v
v
v
v
Z
a
a
a
a
a
y
y
a
a
a
a
a
Z
v
v
v
v
a
j
j
j
j
j
j
j
M
v
v
v
v
v
h
a
"}
(9,1,1) = {"
a
h
v
v
v
v
v
a
j
j
j
j
j
j
j
a
D
v
v
v
a
s
s
s
s
s
s
s
s
s
s
s
s
a
v
v
v
G
a
j
j
j
j
j
j
j
a
v
v
v
v
v
h
a
"}
(10,1,1) = {"
a
a
a
v
v
I
a
a
a
j
j
j
j
j
j
a
v
v
v
v
a
s
s
s
s
s
s
s
s
s
s
s
s
a
v
v
v
v
a
j
j
j
j
j
j
a
a
a
v
v
I
a
a
a
"}
(11,1,1) = {"
a
Q
Q
Q
Q
Q
Q
Q
a
j
j
j
j
j
j
a
v
v
v
v
a
s
s
y
y
y
h
h
y
y
y
s
s
a
v
v
v
v
a
j
j
j
j
j
j
a
O
O
O
O
O
O
O
a
"}
(12,1,1) = {"
a
Q
H
H
H
H
H
Q
Z
j
j
j
j
j
j
a
v
v
v
v
a
s
s
y
h
h
h
h
h
h
y
s
s
a
v
v
v
v
a
j
j
j
j
j
j
Z
O
f
f
f
f
f
O
a
"}
(13,1,1) = {"
B
Q
H
H
H
H
H
Q
b
j
j
j
j
j
j
M
v
v
v
v
y
s
s
y
h
h
h
h
h
h
y
s
s
y
e
v
W
v
M
j
j
j
j
j
j
b
O
f
f
f
f
f
O
B
"}
(14,1,1) = {"
P
Q
H
H
A
H
H
Q
v
j
j
j
j
j
j
M
v
c
v
v
y
s
s
h
h
h
E
h
h
h
h
s
s
y
v
K
c
v
M
j
j
j
j
j
j
v
O
f
f
z
f
f
O
P
"}
(15,1,1) = {"
C
Q
H
H
H
H
H
Q
v
j
j
j
j
j
j
M
v
v
v
v
y
s
s
y
h
h
h
h
h
h
y
s
s
y
r
v
o
v
M
j
j
j
j
j
j
v
O
f
f
f
f
f
O
C
"}
(16,1,1) = {"
a
Q
H
H
H
H
H
Q
Z
j
j
j
j
j
j
a
v
v
v
v
a
s
s
y
h
h
h
h
h
h
y
s
s
a
v
v
v
v
a
j
j
j
j
j
j
Z
O
f
f
f
f
f
O
a
"}
(17,1,1) = {"
a
Q
Q
Q
Q
Q
Q
Q
a
j
j
j
j
j
j
a
v
v
v
v
a
s
s
y
y
y
h
h
y
y
y
s
s
a
v
v
v
v
a
j
j
j
j
j
j
a
O
O
O
O
O
O
O
a
"}
(18,1,1) = {"
a
a
a
v
v
I
a
a
a
j
j
j
j
j
j
a
v
v
v
v
a
s
s
s
s
s
s
s
s
s
s
s
s
a
v
v
v
v
a
j
j
j
j
j
j
a
a
a
v
v
I
a
a
a
"}
(19,1,1) = {"
a
h
v
v
v
v
v
a
j
j
j
j
j
j
j
a
G
v
v
v
a
s
s
s
s
s
s
s
s
s
s
s
s
a
v
v
v
D
a
j
j
j
j
j
j
j
a
v
v
v
v
v
h
a
"}
(20,1,1) = {"
a
h
v
v
v
v
v
M
j
j
j
j
j
j
j
a
v
v
v
v
Z
a
a
a
a
a
y
y
a
a
a
a
a
Z
v
v
v
v
a
j
j
j
j
j
j
j
M
v
v
v
v
v
h
a
"}
(21,1,1) = {"
a
h
v
v
v
v
v
M
j
j
j
j
j
j
j
q
v
v
v
v
w
j
j
j
j
j
j
j
j
j
j
j
j
w
v
v
v
v
q
j
j
j
j
j
j
j
M
v
v
v
v
v
h
a
"}
(22,1,1) = {"
a
h
v
v
v
v
v
M
j
j
j
j
j
j
j
q
v
v
v
v
w
j
j
j
j
j
j
j
j
j
j
j
j
w
v
v
v
v
q
j
j
j
j
j
j
j
M
v
v
v
v
v
h
a
"}
(23,1,1) = {"
a
h
v
v
v
v
v
M
j
j
j
j
j
j
j
q
v
v
v
v
w
j
j
j
j
j
j
j
j
j
j
j
j
w
v
v
v
v
q
j
j
j
j
j
j
j
M
v
v
v
v
v
h
a
"}
(24,1,1) = {"
a
h
v
c
v
v
v
M
j
j
j
j
j
j
j
q
v
v
v
v
w
j
j
j
j
j
j
j
j
j
j
j
j
w
v
v
v
v
q
j
j
j
j
j
j
j
M
v
v
v
c
v
h
a
"}
(25,1,1) = {"
a
h
D
v
v
v
v
M
j
j
j
j
j
j
j
q
v
v
v
v
w
j
j
j
j
j
j
j
j
j
j
j
j
w
v
v
v
v
q
j
j
j
j
j
j
j
M
v
v
v
v
D
h
a
"}
(26,1,1) = {"
a
h
h
h
h
h
h
M
j
j
j
j
j
j
a
a
a
a
a
a
a
a
a
a
a
a
a
a
a
a
a
a
a
a
a
L
a
a
a
a
j
j
j
j
j
j
M
h
h
h
h
h
h
a
"}
(27,1,1) = {"
a
a
a
a
a
a
a
a
a
a
a
a
a
a
a
g
g
g
g
g
g
g
g
g
g
g
g
g
g
g
g
g
g
g
g
g
g
g
g
a
a
a
a
a
a
a
a
a
a
a
a
a
a
a
"}
