//MAP CONVERTED BY dmm2tgm.py THIS HEADER COMMENT PREVENTS RECONVERSION, DO NOT REMOVE
"as" = (
/obj/structure/fence/door{
	dir = 4
	},
/turf/open/indestructible/labfloor,
/area/violence)
"aS" = (
/obj/structure/sign/departments/science/alt,
/turf/closed/wall/rospilovo/beton,
/area/violence)
"bq" = (
/obj/structure/table/wood,
/turf/open/floor/mineral/plastitanium/red,
/area/violence)
"cw" = (
/obj/structure/sign/plaques/robust,
/turf/closed/wall/rospilovo/beton,
/area/violence)
"cP" = (
/obj/structure/sign/poster/official/science,
/turf/closed/wall/rospilovo/beton,
/area/violence)
"cT" = (
/obj/structure/table/wood,
/turf/open/floor/wood,
/area/violence)
"dm" = (
/obj/structure/grille,
/obj/effect/spawner/structure/window,
/obj/structure/barricade/wooden/crude,
/turf/open/floor/wood,
/area/violence)
"dq" = (
/obj/structure/table/wood,
/obj/item/seeds/tomato/killer,
/turf/open/floor/wood,
/area/violence)
"ek" = (
/obj/structure/sign/poster/contraband/syndicate_pistol,
/turf/closed/wall/rospilovo/beton,
/area/violence)
"eI" = (
/obj/structure/headpike,
/obj/effect/decal/cleanable/blood,
/obj/item/food/meat/slab/human,
/obj/effect/gibspawner,
/turf/open/floor/wood,
/area/violence)
"eR" = (
/turf/closed/indestructible/iron,
/area/violence)
"eT" = (
/obj/structure/table/wood,
/obj/item/modular_computer/laptop/preset/civilian{
	icon_state = "laptop-off"
	},
/turf/open/floor/wood,
/area/violence)
"fb" = (
/obj/structure/sign/poster/contraband/lusty_xenomorph,
/turf/closed/wall/rospilovo/beton,
/area/violence)
"gn" = (
/turf/open/floor/wood,
/area/violence)
"hq" = (
/obj/structure/table/wood,
/obj/item/reagent_containers/food/drinks/soda_cans/monkey_energy,
/turf/open/floor/wood,
/area/violence)
"hz" = (
/obj/item/clothing/suit/toggle/labcoat/science,
/obj/structure/table/reinforced,
/turf/open/indestructible/labfloor,
/area/violence)
"hB" = (
/turf/open/floor/plasteel/shuttle/red/syndicate,
/area/violence)
"iJ" = (
/obj/structure/grille/rospilovo/wood{
	icon_state = "zabor_povorot_up"
	},
/turf/open/floor/grass/rospilovo,
/area/violence)
"jU" = (
/turf/open/floor/mineral/plastitanium/red,
/area/violence)
"kr" = (
/obj/structure/table/wood,
/obj/effect/spawner/random/entertainment/drugs,
/turf/open/floor/wood,
/area/violence)
"kI" = (
/obj/effect/turf_decal/box/red/corners{
	dir = 4
	},
/turf/open/floor/rospilovo/plitka,
/area/violence)
"ld" = (
/obj/item/reagent_containers/food/drinks/waterbottle/large/empty,
/obj/structure/water_source/puddle,
/turf/open/floor/grass/rospilovo,
/area/violence)
"lk" = (
/obj/effect/spawner/random/decoration/carpet,
/turf/open/floor/wood,
/area/violence)
"lq" = (
/turf/open/floor/plasteel/cult,
/area/violence)
"lC" = (
/obj/item/melee/cultblade/dagger,
/turf/open/floor/plasteel/cult,
/area/violence)
"lU" = (
/obj/effect/landmark/start/combatant/blue,
/turf/open/floor/beton,
/area/violence)
"lW" = (
/obj/structure/fence{
	dir = 4
	},
/turf/open/indestructible/labfloor,
/area/violence)
"mI" = (
/obj/structure/fence/corner{
	dir = 1
	},
/turf/open/indestructible/labfloor,
/area/violence)
"nh" = (
/obj/machinery/door/window/left,
/turf/open/floor/rospilovo/plitka/old,
/area/violence)
"nG" = (
/obj/structure/bed,
/obj/item/bedsheet/red,
/turf/open/floor/wood,
/area/violence)
"ov" = (
/turf/open/floor/rospilovo/plitka,
/area/violence)
"oQ" = (
/obj/structure/sign/poster/contraband/busty_backdoor_xeno_babes_6,
/turf/closed/wall/rospilovo/beton,
/area/violence)
"pB" = (
/mob/living/simple_animal/hostile/gorilla{
	health = 0
	},
/turf/open/indestructible/labfloor,
/area/violence)
"pX" = (
/obj/effect/rune/narsie,
/turf/open/floor/plasteel/cult,
/area/violence)
"qW" = (
/obj/effect/decal/hammerandsickle,
/turf/open/floor/mineral/plastitanium/red,
/area/violence)
"rm" = (
/turf/open/floor/grass/gensgrass/dirty,
/area/violence)
"rA" = (
/obj/machinery/door/airlock/grunge,
/obj/effect/mapping_helpers/airlock/access/any,
/turf/open/floor/rospilovo/plitka/old,
/area/violence)
"rD" = (
/obj/item/food/meat/slab/monkey,
/turf/open/floor/wood,
/area/violence)
"rN" = (
/obj/structure/window{
	dir = 8
	},
/turf/open/floor/rospilovo/plitka/old,
/area/violence)
"tt" = (
/turf/closed/wall/rospilovo/beton,
/area/violence)
"tA" = (
/obj/effect/turf_decal/arrows/red,
/turf/open/floor/wood,
/area/violence)
"tF" = (
/obj/structure/bed,
/obj/item/bedsheet/purple,
/turf/open/indestructible/labfloor,
/area/violence)
"vR" = (
/obj/item/cum_jar,
/turf/open/floor/wood,
/area/violence)
"wS" = (
/obj/structure/closet/syndicate,
/turf/open/floor/plasteel/shuttle/red/syndicate,
/area/violence)
"wT" = (
/obj/effect/decal/cleanable/blood/gibs/old,
/obj/structure/bed,
/obj/item/bedsheet/brown,
/turf/open/floor/wood,
/area/violence)
"wX" = (
/obj/item/documents/syndicate,
/turf/open/floor/plasteel/shuttle/red/syndicate,
/area/violence)
"yr" = (
/obj/structure/grille/rospilovo/wood{
	icon_state = "zabor_povorot_upr"
	},
/turf/open/floor/grass/rospilovo,
/area/violence)
"ys" = (
/obj/structure/table/wood,
/obj/item/food/meat/slab/pig,
/turf/open/floor/wood,
/area/violence)
"yw" = (
/obj/effect/turf_decal/box/red/corners{
	dir = 8
	},
/turf/open/floor/rospilovo/plitka,
/area/violence)
"zf" = (
/turf/open/floor/rospilovo/plitka/old,
/area/violence)
"zw" = (
/obj/structure/table/wood,
/obj/effect/spawner/random/contraband/armory,
/turf/open/floor/plasteel/shuttle/red/syndicate,
/area/violence)
"zC" = (
/obj/structure/barricade/sandbags,
/turf/open/floor/rospilovo/plitka,
/area/violence)
"zQ" = (
/obj/structure/sign/calendar,
/turf/closed/wall/rospilovo/beton,
/area/violence)
"Ak" = (
/obj/structure/grille/rospilovo/wood{
	icon_state = "zabor_povorot_downr"
	},
/turf/open/floor/grass/rospilovo,
/area/violence)
"Aw" = (
/obj/structure/flora/ausbushes/brflowers,
/turf/open/floor/grass/gensgrass/dirty,
/area/violence)
"AA" = (
/obj/structure/fluff/empty_sleeper/syndicate,
/turf/open/floor/plasteel/shuttle/red/syndicate,
/area/violence)
"AJ" = (
/obj/effect/turf_decal/box/red/corners{
	dir = 1
	},
/turf/open/floor/rospilovo/plitka,
/area/violence)
"AR" = (
/obj/effect/decal/remains/human,
/turf/open/floor/wood,
/area/violence)
"BA" = (
/obj/structure/grille/rospilovo/wood{
	icon_state = "zabor_horizontal2"
	},
/turf/open/floor/grass/rospilovo,
/area/violence)
"BL" = (
/obj/structure/closet/secure_closet/freezer/fridge/open,
/turf/open/floor/wood,
/area/violence)
"BU" = (
/obj/structure/window{
	dir = 8
	},
/obj/structure/window{
	dir = 8
	},
/obj/structure/toilet{
	dir = 1
	},
/turf/open/floor/rospilovo/plitka/old,
/area/violence)
"Cd" = (
/obj/structure/water_source/puddle,
/obj/item/reagent_containers/food/drinks/waterbottle/large/empty,
/turf/open/floor/grass/rospilovo,
/area/violence)
"Cl" = (
/obj/structure/flora/ausbushes/rospilovo/ppflowers,
/turf/open/floor/grass/gensgrass/dirty,
/area/violence)
"CB" = (
/obj/structure/grille/rospilovo/wood{
	icon_state = "zabor_3"
	},
/turf/open/floor/grass/rospilovo,
/area/violence)
"CE" = (
/obj/structure/closet/crate/grave,
/turf/open/floor/grass/rospilovo,
/area/violence)
"CF" = (
/obj/machinery/hydroponics/soil,
/turf/open/floor/grass/gensgrass/dirty,
/area/violence)
"CL" = (
/obj/structure/table/wood,
/obj/item/reagent_containers/food/drinks/beer,
/turf/open/floor/wood,
/area/violence)
"CN" = (
/obj/effect/decal/cleanable/blood/tracks,
/turf/open/floor/rospilovo/plitka,
/area/violence)
"CS" = (
/obj/structure/sign/poster/contraband/communist_state,
/turf/closed/wall/rospilovo/beton,
/area/violence)
"Dp" = (
/obj/item/storage/toolbox/syndicate,
/turf/open/floor/plasteel/shuttle/red/syndicate,
/area/violence)
"DC" = (
/obj/structure/grille/rospilovo/wood{
	icon_state = "zabor_povorot_down"
	},
/turf/open/floor/grass/rospilovo,
/area/violence)
"DY" = (
/obj/effect/turf_decal/arrows/red{
	dir = 8
	},
/turf/open/floor/wood,
/area/violence)
"Ed" = (
/obj/effect/decal/cleanable/blood/tracks{
	dir = 10
	},
/turf/open/floor/wood,
/area/violence)
"Ez" = (
/obj/structure/flora/ausbushes/brflowers,
/obj/structure/flora/ausbushes/brflowers,
/turf/open/floor/grass/gensgrass/dirty,
/area/violence)
"EV" = (
/obj/effect/decal/cleanable/blood/tracks{
	dir = 8
	},
/turf/open/floor/wood,
/area/violence)
"EY" = (
/obj/item/kirbyplants,
/turf/open/floor/wood,
/area/violence)
"Fc" = (
/obj/structure/bed,
/obj/item/bedsheet/hos,
/turf/open/floor/mineral/plastitanium/red,
/area/violence)
"Ff" = (
/obj/structure/rospilovo/shitok,
/turf/closed/wall/rospilovo/beton,
/area/violence)
"FL" = (
/turf/open/floor/grass/rospilovo,
/area/violence)
"Gz" = (
/obj/structure/table/reinforced,
/obj/structure/microscope,
/turf/open/indestructible/labfloor,
/area/violence)
"GL" = (
/obj/structure/window{
	dir = 8
	},
/obj/structure/toilet{
	dir = 1
	},
/obj/effect/spawner/random/contraband/armory,
/turf/open/floor/rospilovo/plitka/old,
/area/violence)
"GO" = (
/obj/structure/sign/plaques/robust/bronze,
/turf/closed/wall/rospilovo/beton,
/area/violence)
"GQ" = (
/obj/machinery/door/airlock/grunge,
/obj/effect/mapping_helpers/airlock/access/any,
/turf/open/floor/wood,
/area/violence)
"He" = (
/obj/machinery/door/airlock/grunge,
/turf/open/floor/rospilovo/plitka,
/area/violence)
"Hx" = (
/obj/structure/grille,
/obj/effect/spawner/structure/window,
/turf/open/floor/wood,
/area/violence)
"Ii" = (
/turf/closed/indestructible/black,
/area/violence)
"IH" = (
/obj/structure/flora/ausbushes/rospilovo/brflowers,
/turf/open/floor/grass/gensgrass/dirty,
/area/violence)
"IY" = (
/obj/structure/grille,
/obj/effect/spawner/structure/window,
/obj/structure/curtain/bounty{
	icon_state = "bounty-closed"
	},
/turf/open/floor/wood,
/area/violence)
"Ke" = (
/obj/structure/grille/rospilovo/wood,
/turf/open/floor/grass/rospilovo,
/area/violence)
"Ko" = (
/obj/effect/gibspawner,
/turf/open/floor/rospilovo/plitka,
/area/violence)
"KE" = (
/obj/effect/turf_decal/arrows/red{
	dir = 4
	},
/turf/open/floor/wood,
/area/violence)
"Lp" = (
/obj/structure/grille/rospilovo/wood{
	icon_state = "zabor_horizontal"
	},
/turf/open/floor/grass/rospilovo,
/area/violence)
"LR" = (
/obj/item/seeds/wheat,
/turf/open/floor/grass/rospilovo,
/area/violence)
"Mj" = (
/turf/open/floor/beton,
/area/violence)
"ML" = (
/obj/structure/table/wood,
/obj/structure/madman_computer,
/turf/open/floor/wood,
/area/violence)
"MR" = (
/turf/open/space/basic,
/area/violence)
"MY" = (
/obj/effect/decal/cleanable/blood,
/turf/open/floor/wood,
/area/violence)
"OX" = (
/obj/machinery/door/poddoor/multi_tile/four_tile_ver,
/turf/open/floor/grass/rospilovo,
/area/violence)
"OY" = (
/obj/structure/table/wood,
/obj/effect/spawner/random/contraband/armory,
/turf/open/floor/mineral/plastitanium/red,
/area/violence)
"Pc" = (
/obj/structure/table/wood,
/obj/effect/spawner/random/contraband/armory,
/turf/open/floor/wood,
/area/violence)
"Pj" = (
/obj/effect/decal/cleanable/cum,
/turf/open/floor/wood,
/area/violence)
"Pw" = (
/obj/structure/sign/poster/contraband/kss13,
/turf/closed/wall/rospilovo/beton,
/area/violence)
"PQ" = (
/obj/effect/decal/cleanable/blood/tracks{
	dir = 4
	},
/turf/open/floor/wood,
/area/violence)
"QV" = (
/obj/structure/sign/poster/contraband/syndicate_recruitment,
/turf/closed/wall/rospilovo/beton,
/area/violence)
"QW" = (
/obj/item/food/meat/slab/mouse,
/turf/open/floor/wood,
/area/violence)
"Ro" = (
/obj/structure/window{
	dir = 8
	},
/obj/structure/toilet{
	dir = 1
	},
/turf/open/floor/rospilovo/plitka/old,
/area/violence)
"Rx" = (
/obj/structure/bed,
/obj/item/bedsheet/cosmos,
/turf/open/floor/wood,
/area/violence)
"SE" = (
/obj/effect/landmark/bomb_plant_location,
/obj/effect/turf_decal/stripes/red/box,
/turf/open/floor/wood,
/area/violence)
"Tc" = (
/obj/structure/bed/maint,
/turf/open/floor/wood,
/area/violence)
"Tr" = (
/obj/machinery/door/airlock/grunge,
/obj/effect/mapping_helpers/airlock/access/any,
/obj/effect/decal/cleanable/blood/tracks,
/turf/open/floor/wood,
/area/violence)
"TJ" = (
/turf/open/indestructible/labfloor,
/area/violence)
"Vu" = (
/obj/structure/flora/ausbushes/ppflowers,
/turf/open/floor/grass/gensgrass/dirty,
/area/violence)
"VP" = (
/obj/structure/bed,
/obj/item/bedsheet/cult,
/turf/open/floor/plasteel/cult,
/area/violence)
"VT" = (
/obj/machinery/door/airlock/grunge,
/obj/effect/mapping_helpers/airlock/access/any,
/turf/open/floor/rospilovo/plitka,
/area/violence)
"Wk" = (
/obj/structure/table/wood,
/obj/item/toy/cards/deck/syndicate,
/turf/open/floor/plasteel/shuttle/red/syndicate,
/area/violence)
"Wy" = (
/obj/structure/table/reinforced,
/obj/item/clothing/glasses/science,
/turf/open/indestructible/labfloor,
/area/violence)
"WD" = (
/obj/effect/landmark/bomb_plant_location,
/obj/effect/turf_decal/box/red,
/turf/open/floor/rospilovo/plitka,
/area/violence)
"Ys" = (
/obj/effect/landmark/start/combatant/red,
/turf/open/floor/beton,
/area/violence)
"YJ" = (
/obj/structure/sign/plaques/robust/bronze/duo,
/turf/closed/wall/rospilovo/beton,
/area/violence)
"ZP" = (
/obj/structure/closet,
/turf/open/floor/mineral/plastitanium/red,
/area/violence)

(1,1,1) = {"
Ii
Ii
Ii
Ii
Ii
Ii
Ii
Ii
Ii
Ii
Ii
Ii
Ii
Ii
Ii
Ii
Ii
Ii
Ii
Ii
Ii
Ii
Ii
Ii
Ii
Ii
Ii
Ii
Ii
Ii
Ii
Ii
Ii
Ii
Ii
Ii
Ii
Ii
Ii
Ii
Ii
Ii
Ii
Ii
Ii
Ii
Ii
Ii
Ii
Ii
Ii
Ii
Ii
Ii
Ii
Ii
"}
(2,1,1) = {"
Ii
FL
FL
FL
FL
FL
FL
FL
FL
FL
FL
FL
FL
FL
FL
FL
FL
FL
FL
FL
FL
FL
FL
FL
FL
FL
FL
FL
FL
FL
FL
FL
FL
FL
FL
FL
FL
FL
FL
FL
FL
FL
FL
FL
FL
FL
FL
FL
FL
FL
FL
FL
FL
FL
FL
Ii
"}
(3,1,1) = {"
Ii
FL
FL
FL
FL
FL
FL
FL
FL
FL
FL
FL
FL
FL
FL
FL
FL
FL
FL
FL
FL
FL
FL
FL
eR
eR
eR
eR
eR
eR
eR
eR
FL
FL
FL
FL
FL
FL
FL
FL
FL
FL
FL
FL
FL
FL
FL
FL
FL
FL
FL
FL
FL
FL
FL
Ii
"}
(4,1,1) = {"
Ii
FL
FL
FL
FL
FL
FL
FL
FL
FL
FL
FL
FL
FL
FL
FL
FL
FL
FL
FL
FL
FL
FL
FL
eR
Ys
Ys
Mj
Mj
Ys
Ys
eR
FL
FL
FL
FL
FL
FL
FL
FL
FL
FL
FL
FL
FL
FL
FL
FL
FL
FL
FL
FL
FL
FL
FL
Ii
"}
(5,1,1) = {"
Ii
FL
FL
FL
FL
FL
FL
FL
FL
FL
FL
FL
FL
FL
FL
FL
FL
FL
FL
FL
FL
FL
FL
FL
eR
Ys
Ys
Mj
Mj
Ys
Ys
eR
FL
FL
FL
FL
FL
FL
FL
FL
FL
FL
FL
FL
FL
FL
FL
FL
FL
FL
FL
FL
FL
FL
FL
Ii
"}
(6,1,1) = {"
Ii
FL
FL
FL
FL
FL
FL
FL
FL
FL
FL
FL
FL
FL
FL
FL
FL
FL
FL
FL
FL
FL
FL
FL
eR
Ys
Ys
Mj
Mj
Ys
Ys
eR
FL
FL
FL
FL
FL
FL
FL
FL
FL
FL
FL
FL
FL
FL
FL
FL
FL
FL
FL
FL
FL
FL
FL
Ii
"}
(7,1,1) = {"
Ii
FL
FL
FL
FL
FL
FL
FL
FL
FL
FL
FL
FL
FL
FL
FL
FL
FL
FL
FL
FL
FL
FL
FL
eR
Ys
Ys
Mj
Mj
Ys
Ys
eR
FL
FL
FL
FL
FL
FL
FL
FL
FL
FL
FL
FL
FL
FL
FL
FL
FL
FL
FL
FL
FL
FL
FL
Ii
"}
(8,1,1) = {"
Ii
FL
FL
FL
FL
FL
FL
FL
FL
FL
FL
FL
FL
FL
FL
FL
FL
FL
FL
FL
FL
FL
FL
FL
eR
eR
FL
FL
FL
OX
eR
eR
FL
FL
FL
FL
FL
FL
FL
FL
FL
FL
FL
FL
FL
FL
FL
FL
FL
FL
FL
FL
FL
FL
FL
Ii
"}
(9,1,1) = {"
Ii
FL
FL
FL
FL
FL
FL
FL
FL
FL
FL
FL
FL
FL
FL
FL
FL
FL
FL
FL
FL
FL
FL
FL
FL
FL
FL
rm
rm
FL
FL
FL
FL
FL
FL
FL
FL
FL
FL
FL
FL
FL
FL
FL
FL
FL
FL
FL
FL
FL
FL
FL
FL
FL
FL
Ii
"}
(10,1,1) = {"
Ii
FL
FL
FL
FL
FL
FL
Ak
Lp
Lp
Lp
Lp
Lp
yr
FL
FL
FL
FL
FL
FL
FL
FL
FL
FL
FL
FL
FL
rm
rm
FL
FL
FL
FL
FL
FL
FL
FL
FL
FL
FL
FL
FL
FL
FL
FL
FL
FL
FL
FL
FL
FL
FL
FL
FL
FL
Ii
"}
(11,1,1) = {"
Ii
FL
FL
FL
FL
FL
FL
FL
CF
FL
CF
LR
CF
BA
FL
FL
FL
FL
FL
FL
FL
FL
FL
FL
FL
FL
FL
rm
rm
rm
FL
FL
FL
FL
FL
FL
FL
FL
FL
FL
FL
FL
FL
FL
FL
FL
FL
FL
FL
FL
FL
FL
FL
FL
FL
Ii
"}
(12,1,1) = {"
Ii
FL
FL
FL
FL
FL
FL
Ke
CF
FL
CF
FL
CF
BA
FL
FL
FL
FL
FL
FL
FL
FL
FL
FL
FL
FL
FL
rm
rm
FL
FL
FL
FL
FL
FL
FL
FL
FL
FL
FL
FL
FL
FL
FL
FL
FL
FL
FL
FL
FL
FL
FL
FL
FL
FL
Ii
"}
(13,1,1) = {"
Ii
FL
FL
FL
FL
FL
FL
Ke
CF
FL
CF
FL
CF
BA
FL
FL
FL
FL
FL
FL
FL
FL
FL
FL
FL
FL
rm
rm
rm
FL
FL
FL
FL
FL
FL
FL
FL
FL
FL
FL
FL
FL
FL
FL
FL
FL
FL
FL
FL
FL
FL
FL
FL
FL
FL
Ii
"}
(14,1,1) = {"
Ii
FL
FL
FL
FL
FL
FL
Ke
CF
FL
CF
FL
CF
BA
FL
FL
FL
FL
FL
FL
FL
FL
FL
FL
FL
FL
FL
rm
rm
FL
FL
FL
FL
FL
FL
FL
FL
FL
FL
FL
FL
FL
FL
FL
FL
FL
FL
FL
FL
FL
FL
FL
FL
FL
FL
Ii
"}
(15,1,1) = {"
Ii
FL
FL
FL
FL
FL
FL
Ke
CF
FL
CF
FL
CF
BA
FL
FL
FL
FL
FL
FL
FL
FL
FL
FL
FL
FL
FL
rm
rm
FL
FL
FL
FL
FL
FL
FL
FL
FL
FL
FL
FL
FL
FL
FL
FL
FL
FL
FL
FL
FL
FL
FL
FL
FL
FL
Ii
"}
(16,1,1) = {"
Ii
FL
FL
FL
FL
FL
FL
Ke
ld
FL
FL
FL
FL
FL
FL
FL
FL
FL
FL
FL
FL
FL
FL
FL
FL
FL
FL
rm
rm
FL
FL
FL
FL
FL
FL
FL
FL
FL
FL
FL
FL
FL
FL
FL
FL
FL
FL
FL
FL
FL
FL
FL
FL
FL
FL
Ii
"}
(17,1,1) = {"
Ii
FL
FL
FL
FL
FL
FL
DC
Lp
Lp
Lp
Lp
Lp
iJ
FL
FL
FL
FL
FL
FL
FL
FL
FL
FL
FL
FL
FL
rm
rm
FL
FL
FL
FL
FL
FL
FL
FL
FL
FL
FL
FL
FL
FL
FL
FL
FL
FL
FL
FL
FL
FL
FL
FL
FL
FL
Ii
"}
(18,1,1) = {"
Ii
FL
FL
FL
FL
FL
FL
FL
FL
FL
FL
FL
FL
FL
FL
FL
FL
FL
FL
FL
FL
FL
FL
FL
FL
FL
FL
rm
rm
rm
FL
FL
FL
FL
FL
FL
FL
FL
FL
FL
FL
FL
FL
FL
FL
FL
FL
FL
FL
FL
FL
FL
FL
FL
FL
Ii
"}
(19,1,1) = {"
Ii
FL
FL
FL
FL
FL
FL
FL
FL
FL
FL
FL
FL
FL
FL
FL
FL
FL
FL
FL
FL
FL
FL
FL
FL
FL
FL
rm
rm
FL
FL
FL
FL
FL
FL
FL
FL
FL
FL
FL
FL
FL
FL
FL
FL
FL
FL
FL
FL
FL
FL
FL
FL
FL
FL
Ii
"}
(20,1,1) = {"
Ii
FL
FL
FL
FL
FL
FL
FL
FL
FL
FL
FL
FL
FL
FL
FL
FL
FL
FL
FL
FL
FL
FL
FL
FL
FL
rm
rm
rm
FL
FL
FL
FL
FL
FL
FL
FL
FL
FL
FL
FL
FL
FL
FL
FL
FL
FL
FL
FL
FL
FL
FL
FL
FL
FL
Ii
"}
(21,1,1) = {"
Ii
FL
FL
FL
FL
FL
FL
FL
FL
FL
FL
FL
FL
FL
FL
FL
FL
FL
FL
FL
FL
FL
FL
FL
FL
FL
FL
rm
rm
FL
FL
FL
FL
FL
FL
FL
FL
FL
FL
FL
FL
FL
FL
FL
FL
FL
FL
FL
FL
FL
FL
FL
FL
FL
FL
Ii
"}
(22,1,1) = {"
Ii
FL
FL
FL
FL
FL
FL
FL
FL
FL
FL
FL
FL
FL
FL
tt
tt
tt
tt
tt
tt
Hx
tt
tt
tt
tt
tt
VT
VT
tt
tt
tt
tt
tt
dm
tt
tt
tt
tt
tt
tt
FL
FL
FL
FL
FL
FL
FL
FL
FL
FL
FL
FL
FL
FL
Ii
"}
(23,1,1) = {"
Ii
FL
FL
FL
FL
FL
FL
FL
FL
FL
FL
FL
FL
FL
Aw
tt
hq
gn
EY
tt
ZP
jU
jU
GQ
ov
ov
ov
ov
ov
Ko
CN
CN
Tr
Ed
gn
wT
tt
wS
hB
AA
tt
Cl
FL
FL
FL
FL
FL
FL
FL
FL
FL
FL
FL
FL
FL
Ii
"}
(24,1,1) = {"
Ii
FL
FL
FL
FL
FL
FL
FL
FL
FL
FL
FL
FL
FL
Aw
IY
ML
gn
KE
CS
jU
jU
jU
tt
ov
ov
ov
ov
ov
ov
ov
ov
tt
EV
gn
rD
QV
zw
hB
hB
dm
Vu
FL
FL
FL
FL
FL
FL
FL
FL
FL
FL
FL
FL
FL
Ii
"}
(25,1,1) = {"
Ii
FL
FL
FL
FL
FL
FL
FL
FL
FL
FL
FL
FL
FL
Vu
IY
cT
tA
SE
zQ
jU
qW
jU
tt
ov
zC
tt
tt
tt
tt
zC
ov
tt
PQ
QW
gn
tt
Wk
hB
hB
dm
Aw
FL
FL
FL
FL
FL
FL
FL
FL
FL
FL
FL
FL
FL
Ii
"}
(26,1,1) = {"
Ii
FL
FL
FL
FL
FL
FL
FL
FL
FL
FL
FL
FL
FL
Aw
IY
Rx
gn
DY
tt
bq
jU
jU
tt
ov
ov
rA
zf
zf
tt
ov
ov
tt
EV
gn
ys
ek
hB
hB
Dp
dm
Ez
FL
FL
FL
FL
FL
FL
FL
FL
FL
FL
FL
FL
FL
Ii
"}
(27,1,1) = {"
Ii
FL
FL
FL
FL
FL
FL
FL
FL
FL
FL
FL
FL
FL
Aw
YJ
BL
gn
gn
tt
OY
jU
Fc
tt
ov
ov
tt
nh
Ro
tt
ov
ov
tt
eI
MY
dq
cw
hB
hB
wX
tt
Vu
FL
FL
FL
FL
FL
FL
FL
FL
FL
FL
FL
FL
FL
Ii
"}
(28,1,1) = {"
Ii
FL
FL
FL
FL
FL
FL
FL
FL
FL
FL
FL
FL
FL
FL
tt
tt
tt
GQ
tt
tt
tt
tt
tt
zC
ov
tt
nh
BU
tt
ov
zC
tt
tt
tt
tt
tt
GQ
tt
tt
tt
FL
FL
FL
FL
FL
FL
FL
FL
FL
FL
FL
FL
FL
FL
Ii
"}
(29,1,1) = {"
Ii
FL
FL
FL
FL
FL
FL
FL
FL
FL
FL
FL
FL
FL
FL
He
ov
ov
ov
ov
ov
zC
ov
ov
ov
ov
tt
nh
GL
tt
ov
ov
zC
ov
ov
ov
zC
ov
ov
ov
VT
FL
FL
FL
FL
FL
FL
FL
FL
FL
FL
FL
FL
FL
FL
Ii
"}
(30,1,1) = {"
Ii
FL
FL
FL
FL
FL
FL
FL
FL
FL
FL
FL
FL
FL
FL
He
ov
ov
ov
zC
ov
ov
ov
zC
ov
ov
tt
nh
GL
tt
ov
ov
ov
ov
zC
ov
ov
ov
ov
ov
VT
FL
FL
FL
FL
FL
FL
FL
FL
FL
FL
FL
FL
FL
FL
Ii
"}
(31,1,1) = {"
Ii
FL
FL
FL
FL
FL
FL
FL
FL
FL
FL
FL
FL
FL
FL
tt
tt
aS
GQ
tt
tt
tt
tt
tt
zC
ov
tt
nh
Ro
tt
ov
zC
tt
tt
tt
tt
tt
GQ
tt
tt
tt
FL
FL
FL
FL
FL
FL
FL
FL
FL
FL
FL
FL
FL
FL
Ii
"}
(32,1,1) = {"
Ii
FL
FL
FL
FL
FL
FL
FL
FL
FL
FL
FL
FL
FL
Aw
Pw
hz
Gz
TJ
GO
VP
lq
lC
tt
ov
ov
tt
nh
Ro
tt
ov
ov
fb
EY
Pj
eT
tt
gn
gn
gn
tt
Cl
FL
FL
FL
FL
FL
FL
FL
FL
FL
FL
FL
FL
FL
Ii
"}
(33,1,1) = {"
Ii
FL
FL
FL
FL
FL
FL
FL
FL
FL
FL
FL
FL
FL
Vu
dm
Wy
TJ
TJ
tt
lq
lq
lq
tt
ov
ov
rA
zf
rN
tt
ov
ov
oQ
gn
lk
Pc
tt
gn
gn
gn
tt
IH
FL
FL
FL
FL
FL
FL
FL
FL
FL
FL
FL
FL
FL
Ii
"}
(34,1,1) = {"
Ii
FL
FL
FL
FL
FL
FL
FL
FL
FL
FL
FL
FL
FL
Aw
dm
TJ
TJ
TJ
tt
lq
pX
lq
tt
ov
zC
tt
tt
tt
tt
zC
kI
tt
gn
lk
nG
Ff
gn
gn
Tc
tt
Cl
FL
FL
FL
FL
FL
FL
FL
FL
FL
FL
FL
FL
FL
Ii
"}
(35,1,1) = {"
Ii
FL
FL
FL
FL
FL
FL
FL
FL
FL
FL
FL
FL
FL
Aw
dm
TJ
mI
as
tt
lq
lq
lq
tt
ov
ov
ov
ov
ov
ov
WD
ov
tt
gn
lk
gn
tt
gn
AR
kr
tt
Cl
FL
FL
FL
FL
FL
FL
FL
FL
FL
FL
FL
FL
FL
Ii
"}
(36,1,1) = {"
Ii
FL
FL
FL
FL
FL
FL
FL
FL
FL
FL
FL
FL
FL
Vu
cP
tF
lW
pB
tt
lq
lq
lq
GQ
ov
ov
ov
ov
ov
yw
ov
AJ
GQ
gn
gn
vR
tt
CL
cT
kr
tt
IH
FL
FL
FL
FL
FL
FL
FL
FL
FL
FL
FL
FL
FL
Ii
"}
(37,1,1) = {"
Ii
FL
FL
FL
FL
FL
FL
FL
FL
FL
FL
FL
FL
FL
FL
tt
tt
tt
tt
tt
tt
dm
tt
tt
tt
tt
tt
VT
VT
tt
tt
tt
tt
tt
dm
tt
tt
tt
tt
tt
tt
FL
FL
FL
FL
FL
FL
FL
FL
FL
FL
FL
FL
FL
FL
Ii
"}
(38,1,1) = {"
Ii
FL
FL
FL
FL
FL
FL
FL
FL
FL
FL
FL
FL
FL
FL
FL
FL
FL
FL
FL
FL
FL
FL
FL
FL
FL
FL
rm
rm
FL
FL
FL
FL
FL
FL
FL
FL
FL
FL
FL
FL
FL
FL
FL
FL
FL
FL
FL
FL
FL
FL
FL
FL
FL
FL
Ii
"}
(39,1,1) = {"
Ii
FL
FL
FL
FL
FL
FL
FL
FL
FL
FL
FL
FL
FL
FL
FL
FL
FL
FL
FL
FL
FL
FL
FL
FL
FL
rm
rm
rm
FL
FL
FL
FL
FL
FL
FL
FL
FL
FL
FL
FL
FL
FL
FL
FL
FL
FL
FL
FL
FL
FL
FL
FL
FL
FL
Ii
"}
(40,1,1) = {"
Ii
FL
FL
FL
FL
FL
FL
FL
FL
FL
FL
FL
FL
FL
FL
FL
FL
FL
FL
FL
FL
FL
FL
FL
FL
FL
FL
rm
rm
FL
FL
FL
FL
FL
FL
FL
FL
FL
FL
FL
FL
FL
FL
FL
FL
FL
FL
FL
FL
FL
FL
FL
FL
FL
FL
Ii
"}
(41,1,1) = {"
Ii
FL
FL
FL
FL
FL
FL
FL
FL
FL
FL
FL
FL
FL
FL
FL
FL
FL
FL
FL
FL
FL
FL
FL
FL
FL
FL
rm
rm
rm
FL
FL
FL
FL
FL
FL
FL
FL
FL
FL
FL
FL
FL
FL
FL
FL
FL
FL
FL
FL
FL
FL
FL
FL
FL
Ii
"}
(42,1,1) = {"
Ii
FL
FL
FL
FL
FL
FL
FL
FL
FL
FL
FL
FL
FL
FL
FL
FL
FL
FL
FL
FL
FL
FL
FL
FL
FL
FL
rm
rm
FL
FL
FL
FL
FL
FL
FL
FL
FL
FL
FL
FL
FL
Ak
Lp
Lp
Lp
Lp
Lp
yr
FL
FL
FL
FL
FL
FL
Ii
"}
(43,1,1) = {"
Ii
FL
FL
FL
FL
FL
FL
FL
FL
FL
FL
FL
FL
FL
FL
FL
FL
FL
FL
FL
FL
FL
FL
FL
FL
FL
FL
rm
rm
rm
FL
FL
FL
FL
FL
FL
FL
FL
FL
FL
FL
FL
FL
FL
FL
FL
FL
Cd
CB
FL
FL
FL
FL
FL
FL
Ii
"}
(44,1,1) = {"
Ii
FL
FL
FL
FL
FL
FL
FL
FL
FL
FL
FL
FL
FL
FL
FL
FL
FL
FL
FL
FL
FL
FL
FL
FL
FL
FL
rm
rm
FL
FL
FL
FL
FL
FL
FL
FL
FL
FL
FL
FL
FL
BA
CF
FL
CF
FL
CF
CB
FL
FL
FL
FL
FL
FL
Ii
"}
(45,1,1) = {"
Ii
FL
FL
FL
FL
FL
FL
FL
FL
FL
FL
FL
FL
FL
FL
FL
FL
FL
FL
FL
FL
FL
FL
FL
FL
FL
FL
rm
rm
FL
FL
FL
FL
FL
FL
FL
FL
FL
FL
FL
FL
FL
BA
CF
FL
CF
FL
CF
CB
FL
FL
FL
FL
FL
FL
Ii
"}
(46,1,1) = {"
Ii
FL
FL
FL
FL
FL
FL
FL
FL
FL
FL
FL
FL
FL
FL
FL
FL
FL
FL
FL
FL
FL
FL
FL
FL
FL
rm
rm
rm
FL
FL
FL
FL
FL
FL
FL
FL
FL
FL
FL
FL
FL
BA
CF
FL
CF
FL
CF
CB
FL
FL
FL
FL
FL
FL
Ii
"}
(47,1,1) = {"
Ii
FL
FL
FL
FL
FL
FL
FL
FL
FL
FL
FL
FL
FL
FL
FL
FL
FL
FL
FL
FL
FL
FL
FL
FL
FL
FL
rm
rm
FL
FL
FL
FL
FL
FL
FL
FL
FL
FL
FL
FL
FL
BA
CF
FL
CF
FL
CF
CB
FL
FL
FL
FL
FL
FL
Ii
"}
(48,1,1) = {"
Ii
FL
FL
FL
FL
FL
FL
FL
CE
FL
FL
FL
FL
FL
FL
FL
FL
FL
FL
FL
FL
FL
FL
FL
FL
FL
FL
rm
rm
FL
FL
FL
FL
FL
FL
FL
FL
FL
FL
FL
FL
FL
BA
CF
LR
CF
FL
CF
FL
FL
FL
FL
FL
FL
FL
Ii
"}
(49,1,1) = {"
Ii
FL
FL
FL
FL
FL
FL
FL
FL
FL
FL
FL
FL
FL
FL
FL
FL
FL
FL
FL
FL
FL
FL
FL
FL
FL
FL
rm
rm
FL
FL
FL
FL
FL
FL
FL
FL
FL
FL
FL
FL
FL
DC
Lp
Lp
Lp
Lp
Lp
iJ
FL
FL
FL
FL
FL
FL
Ii
"}
(50,1,1) = {"
Ii
FL
FL
FL
FL
FL
FL
FL
FL
FL
FL
FL
FL
FL
FL
FL
FL
FL
FL
FL
FL
FL
FL
FL
FL
FL
FL
rm
rm
FL
FL
FL
FL
FL
FL
FL
FL
FL
FL
FL
FL
FL
FL
FL
FL
FL
FL
FL
FL
FL
FL
FL
FL
FL
FL
Ii
"}
(51,1,1) = {"
Ii
FL
FL
FL
FL
FL
FL
FL
FL
FL
FL
FL
FL
FL
FL
FL
FL
FL
FL
FL
FL
FL
FL
FL
eR
eR
FL
FL
FL
OX
eR
eR
FL
FL
FL
FL
FL
FL
FL
FL
FL
FL
FL
FL
FL
FL
FL
FL
FL
FL
FL
FL
FL
FL
FL
Ii
"}
(52,1,1) = {"
Ii
FL
FL
FL
FL
FL
FL
FL
FL
FL
FL
FL
FL
FL
FL
FL
FL
FL
FL
FL
FL
FL
FL
FL
eR
lU
lU
Mj
Mj
lU
lU
eR
FL
FL
FL
FL
FL
FL
FL
FL
FL
FL
FL
FL
FL
FL
FL
FL
FL
FL
FL
FL
FL
FL
FL
Ii
"}
(53,1,1) = {"
Ii
FL
FL
FL
FL
FL
FL
FL
FL
FL
FL
FL
FL
FL
FL
FL
FL
FL
FL
FL
FL
FL
FL
FL
eR
lU
lU
Mj
Mj
lU
lU
eR
FL
FL
FL
FL
FL
FL
FL
FL
FL
FL
FL
FL
FL
FL
FL
FL
FL
FL
FL
FL
FL
FL
FL
Ii
"}
(54,1,1) = {"
Ii
FL
FL
FL
FL
FL
FL
FL
FL
FL
FL
FL
FL
FL
FL
FL
FL
FL
FL
FL
FL
FL
FL
FL
eR
lU
lU
Mj
Mj
lU
lU
eR
FL
FL
FL
FL
FL
FL
FL
FL
FL
FL
FL
FL
FL
FL
FL
FL
FL
FL
FL
FL
FL
FL
FL
Ii
"}
(55,1,1) = {"
Ii
FL
FL
FL
FL
FL
FL
FL
FL
FL
FL
FL
FL
FL
FL
FL
FL
FL
FL
FL
FL
FL
FL
FL
eR
lU
lU
Mj
Mj
lU
lU
eR
FL
FL
FL
FL
FL
FL
FL
FL
FL
FL
FL
FL
FL
FL
FL
FL
FL
FL
FL
FL
FL
FL
FL
Ii
"}
(56,1,1) = {"
Ii
FL
FL
FL
FL
FL
FL
FL
FL
FL
FL
FL
FL
FL
FL
FL
FL
FL
FL
FL
FL
FL
FL
FL
eR
eR
eR
eR
eR
eR
eR
eR
FL
FL
FL
FL
FL
FL
FL
FL
FL
FL
FL
FL
FL
FL
FL
FL
FL
FL
FL
FL
FL
FL
FL
Ii
"}
(57,1,1) = {"
Ii
FL
FL
FL
FL
FL
FL
FL
FL
FL
FL
FL
FL
FL
FL
FL
FL
FL
FL
FL
FL
FL
FL
FL
MR
MR
MR
MR
MR
MR
MR
MR
FL
FL
FL
FL
FL
FL
FL
FL
FL
FL
FL
FL
FL
FL
FL
FL
FL
FL
FL
FL
FL
FL
FL
Ii
"}
(58,1,1) = {"
Ii
Ii
Ii
Ii
Ii
Ii
Ii
Ii
Ii
Ii
Ii
Ii
Ii
Ii
Ii
Ii
Ii
Ii
Ii
Ii
Ii
Ii
Ii
Ii
Ii
Ii
Ii
Ii
Ii
Ii
Ii
Ii
Ii
Ii
Ii
Ii
Ii
Ii
Ii
Ii
Ii
Ii
Ii
Ii
Ii
Ii
Ii
Ii
Ii
Ii
Ii
Ii
Ii
Ii
Ii
Ii
"}
