"a" = (/turf/template_noop,/area/template_noop)
"b" = (/turf/open/floor/mineral/titanium/blue,/area/template_noop)
"c" = (/obj/effect/spawner/structure/window/shuttle,/turf/open/floor/plating,/area/template_noop)
"h" = (/obj/structure/sign/mining,/turf/closed/wall/mineral/titanium/survival/pod,/area/template_noop)
"j" = (/obj/structure/fans,/turf/open/floor/pod,/area/template_noop)
"k" = (/obj/structure/sign/mining/survival,/turf/closed/wall/mineral/titanium/survival/pod,/area/template_noop)
"n" = (/obj/structure/table/survival_pod,/turf/open/floor/pod,/area/template_noop)
"q" = (/obj/structure/sign/mining/survival{dir = 8},/turf/closed/wall/mineral/titanium/survival/pod,/area/template_noop)
"s" = (/turf/closed/mineral/random/high_chance,/area/template_noop)
"t" = (/turf/open/floor/plating/foam,/area/template_noop)
"u" = (/turf/closed/mineral/random/low_chance,/area/template_noop)
"w" = (/turf/closed/wall/mineral/titanium/nodiagonal,/area/template_noop)
"z" = (/obj/structure/bed/pod,/obj/item/bedsheet/black,/turf/open/floor/pod,/area/template_noop)
"A" = (/obj/structure/fans/tiny,/obj/machinery/door/airlock/survival_pod/glass,/turf/open/floor/pod,/area/template_noop)
"G" = (/turf/open/floor/pod,/area/template_noop)
"H" = (/obj/structure/window/reinforced{dir = 1},/obj/structure/shuttle/engine/heater,/turf/open/floor/plating/airless,/area/template_noop)
"J" = (/obj/structure/sign/mining/survival{dir = 4},/turf/closed/wall/mineral/titanium/survival/pod,/area/template_noop)
"K" = (/obj/structure/tubes,/obj/structure/chair/comfy/black{dir = 8},/turf/open/floor/pod,/area/template_noop)
"L" = (/obj/structure/sign/mining/survival{dir = 1},/turf/closed/wall/mineral/titanium/survival/pod,/area/template_noop)
"N" = (/obj/machinery/stasis/survival_pod,/turf/open/floor/pod,/area/template_noop)
"P" = (/turf/open/floor/plating/asteroid,/area/template_noop)
"Q" = (/obj/item/gps/computer,/turf/open/floor/pod,/area/template_noop)
"S" = (/obj/structure/foamedmetal/iron,/turf/open/floor/plating/foam,/area/template_noop)
"T" = (/turf/closed/wall/mineral/titanium,/area/template_noop)
"V" = (/obj/machinery/smartfridge/survival_pod,/turf/open/floor/pod,/area/template_noop)
"X" = (/obj/structure/shuttle/engine/propulsion,/turf/open/floor/plating/airless,/area/template_noop)
"Y" = (/turf/closed/wall/mineral/titanium/survival/pod,/area/template_noop)

(1,1,1) = {"
aaaaaaaaaaaaaaaaaaaaaaaaaaaauuuaaaaaaaaaaaaaaaaaaaaaaaaaaaaaaaaa
aaaaaaaaaaaaaaauuuuaaaaaauuuuuuuuuaaaaaaaaauuuuuuuaaaaaaaaaaaaaa
aaaaaaaaaaaaauuuuuuuaaaauuussssuuuuaaaaaauuuuuuuuuuuuuaaaaaaaaaa
aaaaaaaaaaaaauuuuuuuaaauussssssssuuaaaauuuuuuuuuuuuuuuuuaaaaaaaa
aaaaaaaaaaaauuuuuuuuSSauussssssssuuaaauuuuuuuuuuuuuuuuuuaaaaaaaa
aaaaaaaaaaaauuuuuuuSSSuusssssssssuuaaauuuPPPPPPPPPPuuuuuuaaaaaaa
aaaaaaaaaaaauuuuuuuttSuusssssssssuuaauuuPPPPPPPPPPPPPuuuuuaaaaaa
aaaaaaaaaaaaauuuutttttuussssssssuuSSuuuPPPPPPPPPPPPPPPPuuuaaaaaa
aaaaaaaaaaaaaaSSStttttuussssssssuSSSuuPPPPPPPPPPPPPPPPPuuuuaaaaa
aaaaaaaaaauuuuuuSttttttutttttttttttSuuPPPPPPPPPPPPPPPPPPuuuuaaaa
aaaaaaaauuuuuuuuuutttttttttTcccTtttuuuPPPPPPPPPPPPPPPPPPuuuuaaaa
aaaaaauuuuuuuuuuuuuuttttttTwbbbwTttuuPPPPPPPPPPPPPPPPPPPPuuuaaaa
aaaaaauuuuYYLYYuuuuuuuttttcbbbbbcttuuPPPPPPPPPPPPPPPPPPPPuuuuaaa
aaaaauuuuuYjVQYuuuuuuuutttcbbbbbTttuPPPPPPPPPPPPPPPPPPPPPPuuuaaa
aaaaauuuuuqNGzJuuuPPPuuuttTTTTbTTttPPPPPPPPPPPPPPPPPPPPPPPuuuaaa
aaaaauuuuuYnGKYuPPPPPPuuutTbbbbbTttPPPPPPPPPPPPPPPPPPPPPPPuuuaaa
aaaaauuuuuYkAhYPPPPPPPuuutcbbbbbbttPPPPPPPPPPPPPPPPPPPPPPPuuuaaa
aaaaauuuuuPPPPPPPPPPPPPuutcbbbbbbttPPPPPPPPPPPPPPPPPPPPPPPuuuaaa
aaaaauuuuPPPPPPPPPPPPPPuutcbbbbbTtttPPPPPPPPPPPPPPPPPPPPPPuuuaaa
aaaaauuuuPPPPPPPPPPPPPPPutTbbbbbTtttPPPPPPPPPPPPPPPPPPPPPPuuuaaa
aaaaauuuuPPPPPPPPPPPPPPPPtTHHHHHTtttPPPPPPPPPPPPPPPPPPPPPPuuuaaa
aaaaaauuuPPPPPPPPPPPPPPPPtTXXXXXTtttPPPPPPPPPPPPPPPPPPPPPuuuaaaa
aaaaaauuuuPPPPPPPPPPPPPPPtttttttttttPPPPPPPPPPPPPPPPPPPPuuuuaaaa
aaaaaauuuuPPPPPPPPPPPPPPPPtttttttttttPPPPPPPPPPPPPPPPPuuuuuaaaaa
aaaaaauuuuuPPPPPPPPPPPPPuuuSSStttttttuuuuuuuPPPPPPuuuuuuuuaaaaaa
aaaaaaauuuuuPPPPPPPPPPPuuuuSSSSSSSSSSSuuuuuuuuuuuuuuuuuuuaaaaaaa
aaaaaaaauuuuPPPPPPPPPuuuuuaaaSSSSSSSSSuuuuuuuuuuuuuuuuaaaaaaaaaa
aaaaaaaauuuuuuPPPPPPuuuuuaaaaaaaaaaaaaaauuuuuuuuuuuaaaaaaaaaaaaa
aaaaaaaaauuuuuuuuuuuuuuuaaaaaaaaaaaaaaaaaaaaaaaaaaaaaaaaaaaaaaaa
aaaaaaaaaauuuuuuuuuuuuaaaaaaaaaaaaaaaaaaaaaaaaaaaaaaaaaaaaaaaaaa
aaaaaaaaaaaaauuuuuuaaaaaaaaaaaaaaaaaaaaaaaaaaaaaaaaaaaaaaaaaaaaa
aaaaaaaaaaaaaaaaaaaaaaaaaaaaaaaaaaaaaaaaaaaaaaaaaaaaaaaaaaaaaaaa
"}
