//MAP CONVERTED BY dmm2tgm.py THIS HEADER COMMENT PREVENTS RECONVERSION, DO NOT REMOVE
"aa" = (
/turf/template_noop,
/area/template_noop)
"ab" = (
/turf/closed/mineral/random/no_caves,
/area/ruin/space/has_grav/telepadovo)
"ac" = (
/turf/open/floor/plating/asteroid/airless,
/area/ruin/space/has_grav/telepadovo)
"ad" = (
/turf/closed/wall/partyhard,
/area/ruin/space/has_grav/telepadovo)
"af" = (
/obj/machinery/power/apc/auto_name/north,
/obj/structure/cable,
/turf/open/floor/partyhard/steel{
	icon_state = "mm-1"
	},
/area/ruin/space/has_grav/telepadovo)
"ag" = (
/obj/machinery/light{
	dir = 1
	},
/obj/machinery/autolathe/hacked,
/obj/item/stack/sheet/metal/five,
/obj/item/stack/sheet/glass,
/obj/item/stack/sheet/glass,
/obj/item/stack/sheet/glass,
/obj/item/stack/sheet/glass,
/obj/item/stack/sheet/glass,
/turf/open/floor/partyhard/steel{
	icon_state = "mm-1"
	},
/area/ruin/space/has_grav/telepadovo)
"ah" = (
/obj/structure/table,
/obj/item/storage/toolbox/syndicate,
/obj/item/gps/science,
/obj/item/gps/science,
/obj/item/gps/science,
/turf/open/floor/partyhard/steel{
	icon_state = "mm-1"
	},
/area/ruin/space/has_grav/telepadovo)
"ai" = (
/obj/structure/table,
/obj/item/storage/toolbox/mechanical,
/turf/open/floor/partyhard/steel{
	icon_state = "mm-1"
	},
/area/ruin/space/has_grav/telepadovo)
"aj" = (
/obj/structure/table,
/obj/item/storage/toolbox/electrical,
/turf/open/floor/partyhard/steel{
	icon_state = "mm-1"
	},
/area/ruin/space/has_grav/telepadovo)
"ak" = (
/obj/structure/cable,
/turf/open/floor/partyhard/steel{
	icon_state = "dd-3"
	},
/area/ruin/space/has_grav/telepadovo)
"al" = (
/turf/open/floor/partyhard/steel{
	icon_state = "dd-9"
	},
/area/ruin/space/has_grav/telepadovo)
"am" = (
/turf/open/floor/partyhard/steel{
	icon_state = "dd-4"
	},
/area/ruin/space/has_grav/telepadovo)
"an" = (
/obj/structure/cable,
/turf/open/floor/partyhard/steel{
	icon_state = "dd-7"
	},
/area/ruin/space/has_grav/telepadovo)
"ao" = (
/obj/machinery/power/port_gen/pacman,
/obj/structure/cable,
/obj/item/stack/sheet/mineral/plasma{
	amount = 30
	},
/turf/open/floor/partyhard/steel{
	icon_state = "dd-2"
	},
/area/ruin/space/has_grav/telepadovo)
"ap" = (
/turf/open/floor/partyhard/steel{
	icon_state = "dd-2"
	},
/area/ruin/space/has_grav/telepadovo)
"aq" = (
/obj/machinery/telepad,
/turf/open/floor/partyhard/steel{
	icon_state = "dd-2"
	},
/area/ruin/space/has_grav/telepadovo)
"ar" = (
/obj/machinery/computer/telescience{
	dir = 8
	},
/turf/open/floor/partyhard/steel{
	icon_state = "dd-8"
	},
/area/ruin/space/has_grav/telepadovo)
"as" = (
/turf/open/floor/partyhard/steel{
	icon_state = "dd-7"
	},
/area/ruin/space/has_grav/telepadovo)
"at" = (
/obj/machinery/computer/camera_advanced/syndie{
	dir = 8
	},
/turf/open/floor/partyhard/steel{
	icon_state = "dd-8"
	},
/area/ruin/space/has_grav/telepadovo)
"au" = (
/obj/effect/spawner/structure/window/reinforced/partyhard,
/turf/open/floor/partyhard/steel{
	icon_state = "st-6"
	},
/area/ruin/space/has_grav/telepadovo)
"av" = (
/turf/open/floor/partyhard/steel{
	icon_state = "st-12"
	},
/area/ruin/space/has_grav/telepadovo)
"aw" = (
/obj/item/flashlight,
/obj/structure/closet/cabinet,
/obj/item/radio,
/obj/item/crowbar/red,
/turf/open/floor/partyhard/steel{
	icon_state = "st-12"
	},
/area/ruin/space/has_grav/telepadovo)
"ax" = (
/turf/open/floor/partyhard/steel{
	icon_state = "dd-6"
	},
/area/ruin/space/has_grav/telepadovo)
"ay" = (
/turf/open/floor/partyhard/steel{
	icon_state = "dd-10"
	},
/area/ruin/space/has_grav/telepadovo)
"az" = (
/turf/open/floor/partyhard/steel{
	icon_state = "dd-5"
	},
/area/ruin/space/has_grav/telepadovo)
"aA" = (
/obj/machinery/sleeper/syndie/fullupgrade{
	dir = 8
	},
/turf/open/floor/partyhard/steel{
	icon_state = "st-12"
	},
/area/ruin/space/has_grav/telepadovo)
"aB" = (
/obj/machinery/light/small{
	dir = 4
	},
/obj/effect/mob_spawn/human/syndicate{
	desc = "Там кто-то есть. И он смотрит на меня не очень мило.";
	short_desc = "Я телепадовец";
	flavour_text = "Я заведующий этой космоостановкой. В мои обязанности входит переправка прибывающих агентов на станцию.";
	important_info = "И мне нельзя покидать это место, если только ему совсем не придут кранты.";
	dir = 8
	},
/turf/open/floor/partyhard/steel{
	icon_state = "st-12"
	},
/area/ruin/space/has_grav/telepadovo)
"aC" = (
/obj/machinery/door/airlock/hatch,
/turf/open/floor/partyhard/steel{
	icon_state = "st-6"
	},
/area/ruin/space/has_grav/telepadovo)
"aD" = (
/obj/machinery/vending/games,
/turf/open/floor/partyhard/steel{
	icon_state = "st-2"
	},
/area/ruin/space/has_grav/telepadovo)
"aE" = (
/turf/open/floor/partyhard/steel{
	icon_state = "st-2"
	},
/area/ruin/space/has_grav/telepadovo)
"aF" = (
/obj/machinery/light{
	dir = 1
	},
/turf/open/floor/partyhard/steel{
	icon_state = "st-2"
	},
/area/ruin/space/has_grav/telepadovo)
"aG" = (
/obj/machinery/newscaster{
	pixel_y = 32
	},
/turf/open/floor/partyhard/steel{
	icon_state = "st-2"
	},
/area/ruin/space/has_grav/telepadovo)
"aH" = (
/obj/effect/turf_decal/stripes/line{
	dir = 4
	},
/turf/open/floor/partyhard/steel{
	icon_state = "st-2"
	},
/area/ruin/space/has_grav/telepadovo)
"aI" = (
/obj/structure/table/wood/fancy/royalblack,
/obj/item/melee/baton/loaded/german,
/turf/open/floor/partyhard/steel{
	icon_state = "mm-1"
	},
/area/ruin/space/has_grav/telepadovo)
"aJ" = (
/obj/structure/extinguisher_cabinet{
	pixel_y = -32
	},
/turf/open/floor/partyhard/steel{
	icon_state = "st-2"
	},
/area/ruin/space/has_grav/telepadovo)
"aK" = (
/turf/open/floor/partyhard/steel{
	icon_state = "mm-1"
	},
/area/ruin/space/has_grav/telepadovo)
"aL" = (
/obj/structure/chair/comfy/black,
/turf/open/floor/partyhard/steel{
	icon_state = "st-2"
	},
/area/ruin/space/has_grav/telepadovo)
"aN" = (
/obj/structure/table/reinforced,
/obj/item/flashlight/lamp,
/turf/open/floor/partyhard/steel{
	icon_state = "st-7"
	},
/area/ruin/space/has_grav/telepadovo)
"aO" = (
/obj/machinery/light/small{
	dir = 1
	},
/turf/open/floor/partyhard/steel{
	icon_state = "st-7"
	},
/area/ruin/space/has_grav/telepadovo)
"aP" = (
/turf/open/floor/partyhard/steel{
	icon_state = "st-7"
	},
/area/ruin/space/has_grav/telepadovo)
"aQ" = (
/obj/structure/chair{
	dir = 4
	},
/turf/open/floor/partyhard/steel{
	icon_state = "st-2"
	},
/area/ruin/space/has_grav/telepadovo)
"aR" = (
/obj/structure/table/wood/fancy/royalblack,
/obj/item/reagent_containers/food/condiment/saltshaker,
/obj/item/reagent_containers/food/condiment/peppermill,
/turf/open/floor/partyhard/steel{
	icon_state = "st-2"
	},
/area/ruin/space/has_grav/telepadovo)
"aS" = (
/obj/structure/table/wood/fancy/royalblack,
/obj/item/reagent_containers/food/condiment/milk,
/obj/item/reagent_containers/food/condiment/soymilk,
/turf/open/floor/partyhard/steel{
	icon_state = "st-2"
	},
/area/ruin/space/has_grav/telepadovo)
"aT" = (
/obj/structure/table/wood/fancy/royalblack,
/obj/item/radio,
/turf/open/floor/partyhard/steel{
	icon_state = "st-2"
	},
/area/ruin/space/has_grav/telepadovo)
"aU" = (
/obj/structure/chair{
	dir = 8
	},
/obj/effect/turf_decal/stripes/corner{
	dir = 4
	},
/turf/open/floor/partyhard/steel{
	icon_state = "st-2"
	},
/area/ruin/space/has_grav/telepadovo)
"aV" = (
/obj/structure/table/reinforced,
/obj/item/paper_bin,
/obj/item/pen,
/turf/open/floor/partyhard/steel{
	icon_state = "st-7"
	},
/area/ruin/space/has_grav/telepadovo)
"aW" = (
/obj/structure/chair{
	dir = 8
	},
/turf/open/floor/partyhard/steel{
	icon_state = "st-7"
	},
/area/ruin/space/has_grav/telepadovo)
"aX" = (
/obj/structure/table/wood/fancy/royalblack,
/obj/item/reagent_containers/hypospray/combat/nanites,
/turf/open/floor/partyhard/steel{
	icon_state = "st-2"
	},
/area/ruin/space/has_grav/telepadovo)
"aY" = (
/obj/structure/table/wood/fancy/royalblack,
/turf/open/floor/partyhard/steel{
	icon_state = "st-2"
	},
/area/ruin/space/has_grav/telepadovo)
"ba" = (
/obj/structure/chair{
	dir = 8
	},
/turf/open/floor/partyhard/steel{
	icon_state = "st-2"
	},
/area/ruin/space/has_grav/telepadovo)
"bb" = (
/obj/structure/chair{
	dir = 1
	},
/obj/machinery/airalarm/syndicate{
	dir = 1;
	pixel_y = -23
	},
/turf/open/floor/partyhard/steel{
	icon_state = "st-2"
	},
/area/ruin/space/has_grav/telepadovo)
"bc" = (
/obj/machinery/light/small,
/obj/structure/chair{
	dir = 1
	},
/turf/open/floor/partyhard/steel{
	icon_state = "st-2"
	},
/area/ruin/space/has_grav/telepadovo)
"bd" = (
/obj/structure/chair{
	dir = 1
	},
/turf/open/floor/partyhard/steel{
	icon_state = "st-2"
	},
/area/ruin/space/has_grav/telepadovo)
"be" = (
/obj/machinery/vending/cigarette/syndicate,
/turf/open/floor/partyhard/steel{
	icon_state = "mm-1"
	},
/area/ruin/space/has_grav/telepadovo)
"bf" = (
/obj/machinery/light/small{
	dir = 1
	},
/obj/machinery/vending/cola/random,
/turf/open/floor/partyhard/steel{
	icon_state = "mm-1"
	},
/area/ruin/space/has_grav/telepadovo)
"bg" = (
/obj/machinery/vending/coffee,
/turf/open/floor/partyhard/steel{
	icon_state = "mm-1"
	},
/area/ruin/space/has_grav/telepadovo)
"bh" = (
/obj/structure/table/reinforced,
/obj/item/phone,
/turf/open/floor/partyhard/steel{
	icon_state = "mm-1"
	},
/area/ruin/space/has_grav/telepadovo)
"bi" = (
/obj/structure/chair{
	dir = 8
	},
/turf/open/floor/partyhard/steel{
	icon_state = "mm-1"
	},
/area/ruin/space/has_grav/telepadovo)
"bj" = (
/obj/machinery/status_display,
/turf/closed/wall/partyhard,
/area/ruin/space/has_grav/telepadovo)
"bk" = (
/obj/structure/chair{
	dir = 1
	},
/turf/open/floor/partyhard/steel{
	icon_state = "mm-1"
	},
/area/ruin/space/has_grav/telepadovo)
"bl" = (
/obj/structure/chair{
	dir = 1
	},
/obj/structure/extinguisher_cabinet{
	pixel_y = -32
	},
/turf/open/floor/partyhard/steel{
	icon_state = "mm-1"
	},
/area/ruin/space/has_grav/telepadovo)
"bm" = (
/obj/machinery/light/small,
/obj/structure/chair{
	dir = 1
	},
/turf/open/floor/partyhard/steel{
	icon_state = "mm-1"
	},
/area/ruin/space/has_grav/telepadovo)
"bn" = (
/obj/machinery/door/airlock/external,
/obj/structure/fans/tiny,
/obj/effect/mapping_helpers/airlock/cyclelink_helper,
/turf/open/floor/partyhard/steel{
	icon_state = "st-6"
	},
/area/ruin/space/has_grav/telepadovo)
"bo" = (
/obj/machinery/light/small{
	dir = 4
	},
/turf/open/floor/partyhard/steel{
	icon_state = "mm-1"
	},
/area/ruin/space/has_grav/telepadovo)
"bp" = (
/obj/machinery/door/airlock/external,
/obj/structure/fans/tiny,
/obj/effect/mapping_helpers/airlock/cyclelink_helper{
	dir = 1
	},
/turf/open/floor/partyhard/steel{
	icon_state = "st-6"
	},
/area/ruin/space/has_grav/telepadovo)
"bq" = (
/obj/machinery/portable_atmospherics/canister/air,
/turf/open/floor/partyhard/steel{
	icon_state = "mm-1"
	},
/area/ruin/space/has_grav/telepadovo)
"br" = (
/obj/machinery/portable_atmospherics/canister/oxygen,
/turf/open/floor/partyhard/steel{
	icon_state = "mm-1"
	},
/area/ruin/space/has_grav/telepadovo)
"bs" = (
/obj/machinery/portable_atmospherics/scrubber,
/turf/open/floor/partyhard/steel{
	icon_state = "mm-1"
	},
/area/ruin/space/has_grav/telepadovo)
"bt" = (
/obj/machinery/portable_atmospherics/pump,
/turf/open/floor/partyhard/steel{
	icon_state = "mm-1"
	},
/area/ruin/space/has_grav/telepadovo)
"bu" = (
/obj/machinery/ntnet_relay,
/turf/open/floor/partyhard/steel{
	icon_state = "mm-1"
	},
/area/ruin/space/has_grav/telepadovo)
"iP" = (
/obj/structure/table/wood/fancy/royalblack,
/obj/item/restraints/handcuffs/cable/zipties,
/turf/open/floor/partyhard/steel{
	icon_state = "mm-1"
	},
/area/ruin/space/has_grav/telepadovo)

(1,1,1) = {"
aa
aa
aa
aa
aa
aa
aa
aa
aa
aa
aa
aa
aa
aa
aa
aa
aa
aa
aa
aa
aa
aa
aa
aa
aa
"}
(2,1,1) = {"
aa
aa
ac
ac
aa
aa
aa
aa
aa
aa
aa
aa
aa
aa
aa
aa
aa
aa
ac
ac
ac
aa
aa
aa
aa
"}
(3,1,1) = {"
aa
aa
ac
ab
ab
ab
ab
aa
ab
ac
aa
aa
aa
aa
aa
ab
ab
ab
ab
ab
ab
ab
ab
aa
aa
"}
(4,1,1) = {"
aa
ac
ac
ab
ab
ab
ab
ab
ab
ab
aa
aa
aa
aa
aa
ab
ad
ad
bj
ad
ad
ad
ad
aa
aa
"}
(5,1,1) = {"
aa
ac
ab
ab
ab
ab
ab
ab
ab
ab
aa
ac
aa
aa
aa
ab
ad
be
aK
aK
bn
bo
bp
aa
aa
"}
(6,1,1) = {"
aa
ac
ab
ab
ab
ab
ab
ab
ab
ab
ab
ab
ab
aa
ab
ab
ad
bf
aK
bk
ad
ad
ad
aa
aa
"}
(7,1,1) = {"
aa
ac
ab
ab
ab
ab
ab
ab
ab
ab
ab
ab
ab
ab
ab
ab
ad
bg
aK
bk
ad
ab
aa
aa
aa
"}
(8,1,1) = {"
aa
aa
ab
ad
ad
ad
ad
ad
ad
ad
ad
ad
ad
ad
ad
ad
ad
bh
aK
bl
ad
ab
aa
aa
aa
"}
(9,1,1) = {"
aa
ab
ab
ad
bs
bt
br
bq
bq
bq
ad
aD
aE
aC
aK
aK
aC
aK
aK
bk
ad
ab
ab
aa
aa
"}
(10,1,1) = {"
ab
ab
ab
ad
af
ak
an
as
ax
aK
au
aE
aE
ad
aN
aV
ad
aK
aK
bm
ad
ab
ab
aa
aa
"}
(11,1,1) = {"
aa
ab
ab
ad
aK
al
ao
ap
ay
aK
ad
aE
aJ
ad
aO
aW
au
aK
aK
ad
ad
ab
ab
aa
aa
"}
(12,1,1) = {"
aa
aa
ab
ad
bu
al
ap
ap
ay
aK
aC
aE
aE
ad
aP
aP
au
bi
bi
ad
ab
ab
aa
aa
aa
"}
(13,1,1) = {"
aa
aa
ab
ad
ag
al
aq
ap
ay
aK
aC
aE
aE
ad
aC
ad
ad
ad
ad
ad
ab
ab
aa
aa
aa
"}
(14,1,1) = {"
aa
aa
ab
ad
ah
al
ap
ap
ay
aK
ad
aF
aE
aE
aQ
aQ
aE
ad
ab
ab
ab
ab
aa
aa
aa
"}
(15,1,1) = {"
aa
ab
ab
ad
ai
am
ar
at
az
aK
au
aE
aE
aE
aR
aX
bb
ad
ab
ab
ab
ab
aa
aa
aa
"}
(16,1,1) = {"
aa
ab
ab
ad
aj
aK
aK
aK
aK
aK
ad
aG
aE
aL
aS
aY
bc
ad
ab
ab
ab
ab
aa
aa
aa
"}
(17,1,1) = {"
aa
aa
ab
ad
ad
ad
ad
au
au
au
ad
aE
aE
aE
aT
aY
bd
ad
ab
ab
aa
aa
aa
aa
aa
"}
(18,1,1) = {"
aa
aa
ab
ab
ab
ab
ad
av
av
av
aC
aH
aH
aH
aU
ba
aE
ad
ab
aa
aa
aa
aa
aa
aa
"}
(19,1,1) = {"
aa
aa
ab
ab
ab
ab
ad
aw
aA
aB
ad
aI
iP
iP
ad
ad
ad
ad
ab
ab
aa
aa
aa
aa
aa
"}
(20,1,1) = {"
aa
aa
ab
ab
ab
ab
ad
ad
ad
ad
ad
ad
ad
ad
ad
ab
ab
ab
ab
ab
aa
aa
aa
aa
aa
"}
(21,1,1) = {"
aa
aa
ab
ab
ab
ab
ab
ab
ab
ab
ab
ab
ab
ab
ab
ab
ab
ab
ab
ab
aa
aa
aa
aa
aa
"}
(22,1,1) = {"
aa
aa
aa
ab
ab
aa
aa
ab
ab
ab
ab
ab
ab
ab
ab
ab
ab
ab
ab
aa
aa
aa
aa
aa
aa
"}
(23,1,1) = {"
aa
aa
aa
aa
aa
aa
aa
ab
aa
aa
aa
ab
ab
ab
ab
ab
ab
aa
aa
aa
aa
aa
aa
aa
aa
"}
(24,1,1) = {"
aa
aa
aa
aa
aa
aa
aa
aa
aa
aa
aa
aa
aa
ab
ab
ab
aa
aa
aa
aa
aa
aa
aa
aa
aa
"}
(25,1,1) = {"
aa
aa
aa
aa
aa
aa
aa
aa
aa
aa
aa
aa
aa
aa
aa
aa
aa
aa
aa
aa
aa
aa
aa
aa
aa
"}
