//MAP CONVERTED BY dmm2tgm.py THIS HEADER COMMENT PREVENTS RECONVERSION, DO NOT REMOVE
"ab" = (
/obj/structure/sign/warning/securearea{
	pixel_y = 32
	},
/obj/effect/turf_decal/stripes/line{
	dir = 9
	},
/obj/machinery/light{
	dir = 1
	},
/turf/open/floor/plasteel,
/area/engineering/main)
"ad" = (
/turf/closed/wall/r_wall,
/area/engineering/main)
"ae" = (
/obj/structure/disposalpipe/segment,
/obj/effect/turf_decal/stripes/line{
	dir = 1
	},
/obj/structure/cable,
/obj/machinery/atmospherics/pipe/smart/manifold4w/supply/hidden/layer4,
/obj/machinery/atmospherics/pipe/smart/manifold4w/scrubbers/hidden/layer2,
/turf/open/floor/plasteel,
/area/engineering/main)
"af" = (
/obj/machinery/atmospherics/components/unary/portables_connector/visible,
/turf/open/floor/plasteel/dark,
/area/engineering/main)
"ag" = (
/obj/machinery/light{
	dir = 1
	},
/obj/machinery/atmospherics/components/unary/portables_connector/visible,
/turf/open/floor/plasteel/dark,
/area/engineering/main)
"ah" = (
/obj/structure/table/reinforced,
/obj/item/tank/internals/emergency_oxygen/engi,
/obj/item/tank/internals/emergency_oxygen/engi,
/obj/item/clothing/mask/breath{
	pixel_x = 4
	},
/turf/open/floor/plasteel/dark,
/area/engineering/main)
"ai" = (
/obj/structure/disposalpipe/segment{
	dir = 4
	},
/obj/effect/turf_decal/stripes/line{
	dir = 8
	},
/turf/open/floor/plasteel,
/area/engineering/main)
"aj" = (
/obj/structure/disposalpipe/sorting/mail{
	sortType = 4
	},
/obj/structure/cable,
/obj/machinery/atmospherics/pipe/smart/manifold4w/supply/hidden/layer4{
	dir = 8
	},
/obj/machinery/atmospherics/pipe/smart/manifold4w/scrubbers/hidden/layer2{
	dir = 8
	},
/turf/open/floor/plasteel,
/area/engineering/main)
"ak" = (
/obj/effect/turf_decal/stripes/line{
	dir = 4
	},
/obj/structure/cable,
/obj/machinery/atmospherics/pipe/smart/manifold4w/supply/hidden/layer4{
	dir = 4
	},
/obj/machinery/atmospherics/pipe/smart/manifold4w/scrubbers/hidden/layer2{
	dir = 8
	},
/turf/open/floor/plasteel,
/area/engineering/main)
"al" = (
/obj/machinery/door/firedoor,
/obj/structure/cable,
/obj/machinery/door/airlock/engineering/glass{
	name = "Supermatter Engine Room";
	req_one_access_txt = "10;24"
	},
/obj/machinery/atmospherics/pipe/smart/manifold4w/supply/hidden/layer4{
	dir = 4
	},
/obj/machinery/atmospherics/pipe/smart/manifold4w/scrubbers/hidden/layer2{
	dir = 8
	},
/turf/open/floor/plasteel/dark,
/area/engineering/main)
"am" = (
/obj/structure/cable,
/obj/machinery/atmospherics/components/unary/vent_pump/on/layer4{
	dir = 8
	},
/obj/machinery/atmospherics/pipe/smart/manifold4w/scrubbers/hidden/layer2{
	dir = 8
	},
/turf/open/floor/plasteel/dark,
/area/engineering/main)
"an" = (
/obj/structure/cable,
/obj/machinery/atmospherics/pipe/smart/manifold4w/scrubbers/hidden/layer2{
	dir = 8
	},
/obj/machinery/atmospherics/pipe/color_adapter,
/turf/open/floor/plasteel/dark,
/area/engineering/main)
"ao" = (
/obj/structure/cable,
/obj/machinery/atmospherics/components/unary/vent_scrubber/on/layer2{
	dir = 8
	},
/turf/open/floor/plasteel/dark,
/area/engineering/main)
"ap" = (
/obj/effect/turf_decal/stripes/corner{
	dir = 1
	},
/turf/open/floor/plasteel,
/area/engineering/main)
"aq" = (
/obj/structure/disposalpipe/segment,
/obj/structure/cable,
/obj/machinery/atmospherics/pipe/smart/manifold4w/supply/hidden/layer4,
/obj/machinery/atmospherics/pipe/smart/manifold4w/scrubbers/hidden/layer2,
/turf/open/floor/plasteel,
/area/engineering/main)
"ar" = (
/obj/effect/turf_decal/stripes/line{
	dir = 4
	},
/turf/open/floor/plasteel,
/area/engineering/main)
"as" = (
/obj/structure/lattice,
/turf/open/space/basic,
/area/space/nearstation)
"at" = (
/obj/machinery/camera{
	c_tag = "Engineering Supermatter Fore";
	dir = 4;
	network = list("ss13","engine")
	},
/obj/machinery/firealarm{
	dir = 4;
	pixel_x = -26
	},
/obj/machinery/atmospherics/pipe/smart/manifold4w/yellow/visible,
/turf/open/floor/plasteel/dark,
/area/engineering/main)
"au" = (
/obj/machinery/atmospherics/pipe/smart/manifold4w/yellow/visible,
/turf/open/floor/plasteel/dark,
/area/engineering/main)
"ax" = (
/obj/machinery/meter,
/obj/machinery/atmospherics/pipe/smart/manifold4w/yellow/visible,
/turf/open/floor/plasteel/dark,
/area/engineering/main)
"ay" = (
/obj/structure/cable,
/obj/machinery/atmospherics/pipe/smart/manifold4w/yellow/visible,
/turf/open/floor/plasteel/dark,
/area/engineering/main)
"az" = (
/obj/effect/turf_decal/stripes/line,
/obj/structure/cable,
/obj/machinery/atmospherics/pipe/smart/manifold4w/supply/hidden/layer4{
	dir = 4
	},
/obj/machinery/atmospherics/pipe/smart/manifold4w/scrubbers/hidden/layer2{
	dir = 8
	},
/turf/open/floor/plasteel,
/area/engineering/main)
"aA" = (
/obj/structure/disposalpipe/segment,
/obj/effect/turf_decal/stripes/line,
/obj/structure/cable,
/obj/machinery/atmospherics/pipe/smart/manifold4w/supply/hidden/layer4{
	dir = 9
	},
/obj/machinery/atmospherics/pipe/smart/manifold4w/scrubbers/hidden/layer2{
	dir = 9
	},
/turf/open/floor/plasteel,
/area/engineering/main)
"aB" = (
/obj/effect/turf_decal/stripes/line{
	dir = 6
	},
/turf/open/floor/plasteel,
/area/engineering/main)
"aC" = (
/obj/machinery/atmospherics/components/unary/thermomachine/freezer{
	dir = 1
	},
/turf/open/floor/plasteel/dark,
/area/engineering/main)
"aD" = (
/obj/machinery/atmospherics/components/unary/vent_pump/siphon/monitored/engine_waste,
/obj/structure/lattice/catwalk,
/turf/open/space/basic,
/area/engineering/main)
"aE" = (
/obj/structure/disposalpipe/segment{
	dir = 4
	},
/turf/closed/wall/r_wall,
/area/engineering/main)
"aF" = (
/obj/structure/disposalpipe/segment{
	dir = 9
	},
/obj/effect/spawner/structure/window/plasma/reinforced,
/turf/open/floor/plating,
/area/engineering/main)
"aH" = (
/obj/machinery/door/firedoor,
/obj/machinery/door/airlock/engineering/glass{
	name = "Supermatter Engine Room";
	req_one_access_txt = "10;24"
	},
/obj/machinery/atmospherics/pipe/smart/manifold4w/yellow/visible,
/turf/open/floor/plasteel/dark,
/area/engineering/main)
"aI" = (
/obj/effect/spawner/structure/window/plasma/reinforced,
/turf/open/floor/plating/airless,
/area/engineering/main)
"aK" = (
/obj/effect/spawner/structure/window/plasma/reinforced,
/obj/machinery/atmospherics/pipe/smart/manifold4w/scrubbers/visible,
/turf/open/floor/plating,
/area/engineering/main)
"aL" = (
/obj/effect/turf_decal/stripes/line{
	dir = 9
	},
/obj/machinery/atmospherics/pipe/smart/manifold4w/scrubbers/hidden/layer2{
	dir = 1
	},
/turf/open/floor/engine,
/area/engineering/main)
"aM" = (
/obj/effect/turf_decal/stripes/line{
	dir = 1
	},
/obj/machinery/atmospherics/pipe/smart/manifold4w/scrubbers/hidden/layer2{
	dir = 8
	},
/turf/open/floor/engine,
/area/engineering/main)
"aN" = (
/obj/effect/turf_decal/stripes/line{
	dir = 1
	},
/obj/machinery/light{
	dir = 1
	},
/obj/machinery/atmospherics/pipe/smart/manifold4w/scrubbers/hidden/layer2{
	dir = 8
	},
/turf/open/floor/engine,
/area/engineering/main)
"aO" = (
/obj/effect/turf_decal/stripes/line{
	dir = 1
	},
/obj/machinery/atmospherics/components/binary/pump{
	name = "Mix to Gas"
	},
/obj/machinery/atmospherics/pipe/smart/manifold4w/scrubbers/hidden/layer2{
	dir = 8
	},
/turf/open/floor/engine,
/area/engineering/main)
"aP" = (
/obj/effect/turf_decal/stripes/line{
	dir = 1
	},
/obj/structure/cable,
/obj/machinery/atmospherics/components/binary/pump{
	dir = 1;
	name = "Gas to Mix"
	},
/obj/machinery/atmospherics/pipe/smart/manifold4w/scrubbers/hidden/layer2{
	dir = 8
	},
/turf/open/floor/engine,
/area/engineering/main)
"aU" = (
/obj/effect/turf_decal/stripes/line{
	dir = 10
	},
/obj/machinery/camera{
	c_tag = "Engineering Supermatter Starboard";
	dir = 4;
	network = list("ss13","engine")
	},
/obj/structure/cable,
/obj/machinery/atmospherics/pipe/smart/manifold4w/cyan/visible,
/turf/open/floor/engine,
/area/engineering/main)
"aW" = (
/obj/effect/turf_decal/stripes/line{
	dir = 1
	},
/obj/item/radio/intercom{
	pixel_y = 21
	},
/obj/machinery/atmospherics/pipe/smart/manifold4w/scrubbers/hidden/layer2{
	dir = 8
	},
/turf/open/floor/engine,
/area/engineering/main)
"aX" = (
/obj/effect/turf_decal/stripes/line{
	dir = 5
	},
/obj/machinery/meter,
/obj/machinery/atmospherics/pipe/smart/manifold4w/scrubbers/visible,
/obj/machinery/atmospherics/pipe/smart/manifold4w/scrubbers/hidden/layer2{
	dir = 8
	},
/turf/open/floor/engine,
/area/engineering/main)
"aY" = (
/obj/effect/spawner/structure/window/plasma/reinforced,
/obj/machinery/atmospherics/pipe/smart/manifold4w/scrubbers/hidden/layer2{
	dir = 8
	},
/turf/open/floor/plating,
/area/engineering/main)
"aZ" = (
/obj/machinery/atmospherics/pipe/smart/manifold4w/scrubbers/hidden/layer2{
	dir = 8
	},
/turf/open/floor/plasteel/dark,
/area/engineering/main)
"ba" = (
/obj/machinery/firealarm{
	pixel_y = 32
	},
/obj/machinery/atmospherics/components/unary/vent_scrubber/on/layer2{
	dir = 8
	},
/turf/open/floor/plasteel/dark,
/area/engineering/main)
"bb" = (
/obj/effect/turf_decal/stripes/line{
	dir = 8
	},
/obj/machinery/atmospherics/pipe/smart/manifold4w/scrubbers/hidden/layer2,
/turf/open/floor/engine,
/area/engineering/main)
"bc" = (
/obj/effect/turf_decal/stripes/corner,
/obj/structure/cable,
/obj/machinery/atmospherics/pipe/smart/manifold4w/cyan/visible,
/turf/open/floor/engine,
/area/engineering/main)
"bd" = (
/obj/effect/turf_decal/stripes/line,
/obj/structure/cable,
/obj/machinery/atmospherics/pipe/smart/manifold4w/cyan/visible,
/turf/open/floor/engine,
/area/engineering/main)
"be" = (
/obj/effect/turf_decal/stripes/line,
/obj/machinery/light,
/obj/structure/cable,
/obj/machinery/atmospherics/pipe/smart/manifold4w/cyan/visible,
/turf/open/floor/engine,
/area/engineering/main)
"bf" = (
/obj/effect/turf_decal/stripes/line,
/obj/machinery/atmospherics/components/binary/pump{
	dir = 8;
	name = "Mix Bypass"
	},
/turf/open/floor/engine,
/area/engineering/main)
"bg" = (
/obj/effect/turf_decal/stripes/line,
/obj/machinery/meter,
/obj/machinery/light,
/obj/structure/cable,
/obj/machinery/atmospherics/pipe/smart/manifold4w/cyan/visible,
/turf/open/floor/engine,
/area/engineering/main)
"bh" = (
/obj/effect/turf_decal/stripes/line{
	dir = 4
	},
/obj/structure/cable,
/obj/machinery/atmospherics/pipe/smart/manifold4w/scrubbers/visible,
/turf/open/floor/engine,
/area/engineering/main)
"bi" = (
/obj/effect/turf_decal/stripes/line{
	dir = 8
	},
/obj/machinery/atmospherics/components/unary/vent_scrubber/on/layer2{
	dir = 1
	},
/turf/open/floor/engine,
/area/engineering/main)
"bk" = (
/obj/effect/turf_decal/stripes/line{
	dir = 4
	},
/obj/structure/cable,
/obj/machinery/atmospherics/pipe/smart/manifold4w/cyan/visible,
/turf/open/floor/engine,
/area/engineering/main)
"bl" = (
/obj/effect/turf_decal/delivery,
/obj/machinery/atmospherics/components/binary/pump{
	dir = 8;
	name = "External Gas to Loop"
	},
/turf/open/floor/plasteel/dark,
/area/engineering/main)
"bm" = (
/obj/effect/turf_decal/bot{
	dir = 1
	},
/obj/machinery/portable_atmospherics/canister/nitrogen,
/obj/machinery/atmospherics/components/unary/portables_connector/visible{
	dir = 8
	},
/turf/open/floor/plasteel/dark,
/area/engineering/main)
"bn" = (
/obj/machinery/door/firedoor,
/obj/structure/cable,
/obj/machinery/door/airlock/engineering/glass{
	name = "Laser Room";
	req_one_access_txt = "10;24"
	},
/turf/open/floor/plating,
/area/engineering/main)
"bp" = (
/obj/machinery/status_display/evac,
/turf/closed/wall/r_wall,
/area/engineering/supermatter)
"bq" = (
/obj/machinery/door/poddoor/shutters/radiation/preopen{
	id = "engsm";
	name = "Radiation Chamber Shutters"
	},
/turf/open/floor/plating,
/area/engineering/supermatter)
"br" = (
/obj/structure/cable,
/obj/machinery/door/poddoor/shutters/radiation/preopen{
	id = "engsm";
	name = "Radiation Chamber Shutters"
	},
/turf/open/floor/plating,
/area/engineering/supermatter)
"bs" = (
/obj/effect/turf_decal/stripes/line{
	dir = 4
	},
/obj/machinery/atmospherics/components/trinary/filter/flipped/critical,
/turf/open/floor/engine,
/area/engineering/main)
"bt" = (
/obj/machinery/power/emitter/welded,
/obj/structure/cable,
/turf/open/floor/plating,
/area/engineering/main)
"bu" = (
/obj/structure/cable,
/turf/open/floor/plating,
/area/engineering/main)
"bv" = (
/obj/machinery/light{
	dir = 4
	},
/obj/structure/cable,
/turf/open/floor/plating,
/area/engineering/main)
"bw" = (
/obj/effect/turf_decal/stripes/line{
	dir = 8
	},
/turf/open/floor/engine,
/area/engineering/main)
"bx" = (
/obj/effect/turf_decal/stripes/line{
	dir = 4
	},
/obj/machinery/meter,
/obj/structure/cable,
/obj/machinery/atmospherics/pipe/smart/manifold4w/cyan/visible,
/turf/open/floor/engine,
/area/engineering/main)
"by" = (
/obj/machinery/door/firedoor,
/obj/structure/cable,
/obj/machinery/door/airlock/engineering/glass{
	name = "Supermatter Engine Room";
	req_one_access_txt = "10;24"
	},
/obj/machinery/atmospherics/pipe/smart/manifold4w/yellow/visible,
/turf/open/floor/plasteel/dark,
/area/engineering/main)
"bz" = (
/turf/closed/wall/r_wall,
/area/engineering/supermatter)
"bA" = (
/obj/structure/cable,
/turf/open/floor/engine,
/area/engineering/supermatter)
"bB" = (
/obj/effect/turf_decal/stripes/line{
	dir = 4
	},
/obj/machinery/atmospherics/pipe/smart/manifold4w/scrubbers/visible,
/turf/open/floor/engine,
/area/engineering/main)
"bC" = (
/obj/machinery/atmospherics/pipe/smart/manifold4w/cyan/visible,
/turf/closed/wall/r_wall,
/area/engineering/supermatter)
"bF" = (
/obj/machinery/power/rad_collector/anchored,
/obj/structure/window/plasma/reinforced,
/obj/structure/cable,
/obj/machinery/atmospherics/pipe/smart/manifold4w/cyan/visible,
/turf/open/floor/engine,
/area/engineering/supermatter)
"bH" = (
/obj/effect/turf_decal/stripes/line{
	dir = 4
	},
/obj/machinery/light{
	dir = 4
	},
/obj/machinery/atmospherics/components/trinary/filter/flipped/critical,
/turf/open/floor/engine,
/area/engineering/main)
"bI" = (
/obj/machinery/button/door{
	id = "engsm";
	name = "Radiation Shutters Control";
	pixel_x = 24;
	req_access_txt = "10"
	},
/obj/effect/turf_decal/stripes/line{
	dir = 4
	},
/obj/structure/cable,
/obj/machinery/atmospherics/pipe/smart/manifold4w/cyan/visible,
/turf/open/floor/engine,
/area/engineering/main)
"bJ" = (
/obj/machinery/atmospherics/components/binary/pump{
	dir = 4;
	name = "Gas to Chamber"
	},
/turf/open/floor/engine,
/area/engineering/supermatter)
"bK" = (
/obj/machinery/meter,
/obj/machinery/atmospherics/pipe/smart/manifold4w/cyan/visible,
/turf/closed/wall/r_wall,
/area/engineering/supermatter)
"bL" = (
/obj/machinery/atmospherics/components/unary/vent_pump/on{
	dir = 1
	},
/turf/open/floor/engine,
/area/engineering/supermatter)
"bN" = (
/obj/structure/sign/warning/fire,
/turf/closed/wall/r_wall,
/area/engineering/supermatter)
"bO" = (
/obj/effect/turf_decal/stripes/line{
	dir = 6
	},
/obj/machinery/atmospherics/pipe/smart/manifold4w/scrubbers/visible,
/turf/open/floor/engine,
/area/engineering/main)
"bP" = (
/obj/structure/reflector/single/anchored{
	dir = 9
	},
/turf/open/floor/plating,
/area/engineering/main)
"bQ" = (
/obj/effect/turf_decal/stripes/line{
	dir = 8
	},
/obj/structure/cable,
/turf/open/floor/engine,
/area/engineering/main)
"bW" = (
/obj/effect/turf_decal/stripes/line{
	dir = 4
	},
/obj/structure/cable,
/obj/machinery/atmospherics/components/binary/pump/on{
	name = "Engine Coolant Bypass"
	},
/turf/open/floor/engine,
/area/engineering/main)
"bX" = (
/obj/machinery/door/airlock/engineering/glass/critical{
	heat_proof = 1;
	name = "Supermatter Chamber";
	req_one_access_txt = "10;24"
	},
/obj/effect/mapping_helpers/airlock/cyclelink_helper{
	dir = 4
	},
/turf/open/floor/engine,
/area/engineering/supermatter)
"bY" = (
/obj/effect/mapping_helpers/airlock/cyclelink_helper{
	dir = 8
	},
/obj/machinery/door/airlock/engineering/glass/critical{
	heat_proof = 1;
	name = "Supermatter Chamber";
	req_one_access_txt = "10;24"
	},
/turf/open/floor/engine,
/area/engineering/supermatter)
"ca" = (
/obj/machinery/power/supermatter_crystal/engine,
/turf/open/floor/engine,
/area/engineering/supermatter)
"cb" = (
/obj/effect/spawner/structure/window/plasma/reinforced,
/turf/open/floor/plating,
/area/engineering/supermatter)
"cc" = (
/obj/effect/turf_decal/delivery,
/obj/structure/cable,
/obj/machinery/atmospherics/pipe/smart/manifold4w/cyan/visible,
/turf/open/floor/plasteel/dark,
/area/engineering/main)
"cd" = (
/obj/effect/turf_decal/delivery,
/obj/machinery/atmospherics/pipe/smart/manifold4w/scrubbers/visible,
/turf/open/floor/plasteel/dark,
/area/engineering/main)
"cf" = (
/obj/structure/reflector/box/anchored{
	dir = 8
	},
/turf/open/floor/plasteel/dark,
/area/engineering/main)
"cg" = (
/obj/effect/turf_decal/stripes/line{
	dir = 4
	},
/obj/machinery/camera{
	c_tag = "Engineering Supermatter Port";
	dir = 8;
	network = list("ss13","engine")
	},
/obj/machinery/airalarm/directional/west,
/obj/effect/mapping_helpers/airalarm/engine_access,
/obj/structure/cable,
/obj/machinery/atmospherics/pipe/smart/manifold4w/green/visible{
	dir = 8
	},
/turf/open/floor/engine,
/area/engineering/supermatter)
"ch" = (
/obj/machinery/atmospherics/pipe/smart/manifold4w/green/visible,
/turf/closed/wall/r_wall,
/area/engineering/supermatter)
"ck" = (
/obj/machinery/atmospherics/components/binary/pump{
	dir = 8;
	name = "Gas to Filter"
	},
/turf/open/floor/engine,
/area/engineering/supermatter)
"co" = (
/obj/machinery/meter,
/obj/machinery/atmospherics/pipe/smart/manifold4w/green/visible{
	dir = 8
	},
/turf/closed/wall/r_wall,
/area/engineering/supermatter)
"cM" = (
/obj/machinery/atmospherics/components/unary/vent_scrubber/on,
/turf/open/floor/engine,
/area/engineering/supermatter)
"dh" = (
/turf/open/floor/engine,
/area/engineering/supermatter)
"du" = (
/obj/effect/turf_decal/stripes/corner{
	dir = 8
	},
/obj/structure/cable,
/obj/machinery/atmospherics/pipe/smart/manifold4w/cyan/visible,
/turf/open/floor/engine,
/area/engineering/main)
"dz" = (
/turf/open/space/basic,
/area/space)
"fe" = (
/obj/structure/closet/firecloset,
/turf/open/floor/plasteel/dark,
/area/engineering/main)
"hm" = (
/obj/effect/turf_decal/stripes/line{
	dir = 9
	},
/obj/structure/cable,
/obj/machinery/atmospherics/pipe/smart/manifold4w/cyan/visible,
/turf/open/floor/engine,
/area/engineering/main)
"hM" = (
/obj/structure/reflector/single/anchored{
	dir = 10
	},
/turf/open/floor/plating,
/area/engineering/main)
"io" = (
/obj/effect/turf_decal/stripes/line{
	dir = 4
	},
/obj/machinery/light{
	dir = 4
	},
/obj/structure/cable,
/obj/machinery/atmospherics/pipe/smart/manifold4w/green/visible,
/turf/open/floor/engine,
/area/engineering/main)
"lt" = (
/obj/machinery/atmospherics/pipe/smart/manifold4w/green/visible{
	dir = 8
	},
/turf/closed/wall/r_wall,
/area/engineering/supermatter)
"lz" = (
/obj/item/radio/intercom{
	pixel_y = 21
	},
/turf/open/floor/plasteel/dark,
/area/engineering/main)
"md" = (
/obj/structure/sign/warning/electricshock,
/turf/closed/wall/r_wall,
/area/engineering/supermatter)
"mC" = (
/obj/effect/turf_decal/stripes/line{
	dir = 5
	},
/obj/machinery/atmospherics/components/trinary/filter/flipped/critical,
/turf/open/floor/engine,
/area/engineering/main)
"mO" = (
/obj/effect/turf_decal/stripes/line{
	dir = 8
	},
/obj/machinery/atmospherics/pipe/smart/manifold4w/supply/hidden/layer4,
/turf/open/floor/engine,
/area/engineering/main)
"mY" = (
/obj/machinery/shower{
	dir = 8;
	name = "emergency shower"
	},
/obj/structure/sign/warning/securearea{
	pixel_y = 32
	},
/obj/effect/turf_decal/stripes/line{
	dir = 5
	},
/turf/open/floor/plasteel,
/area/engineering/main)
"nI" = (
/obj/effect/turf_decal/stripes/line{
	dir = 4
	},
/obj/machinery/light{
	dir = 4
	},
/obj/machinery/atmospherics/pipe/smart/manifold4w/scrubbers/visible,
/turf/open/floor/engine,
/area/engineering/main)
"nR" = (
/obj/effect/turf_decal/stripes/line{
	dir = 4
	},
/obj/structure/cable,
/obj/machinery/atmospherics/components/trinary/filter/flipped/critical{
	dir = 1
	},
/turf/open/floor/engine,
/area/engineering/main)
"pc" = (
/obj/effect/turf_decal/delivery,
/obj/machinery/atmospherics/pipe/smart/manifold4w/scrubbers/visible{
	dir = 1
	},
/turf/open/floor/plasteel/dark,
/area/engineering/main)
"py" = (
/obj/effect/turf_decal/bot{
	dir = 1
	},
/obj/machinery/portable_atmospherics/canister,
/obj/machinery/atmospherics/components/unary/portables_connector/visible{
	dir = 8
	},
/turf/open/floor/plasteel/dark,
/area/engineering/main)
"qU" = (
/obj/machinery/camera{
	c_tag = "Supermatter Chamber";
	dir = 4;
	network = list("engine")
	},
/turf/open/floor/engine,
/area/engineering/supermatter)
"rI" = (
/obj/effect/turf_decal/stripes/line{
	dir = 4
	},
/obj/machinery/atmospherics/components/trinary/filter/flipped/critical{
	filter_type = "n2"
	},
/turf/open/floor/engine,
/area/engineering/main)
"sF" = (
/obj/effect/turf_decal/stripes/line{
	dir = 4
	},
/obj/structure/cable,
/obj/machinery/atmospherics/pipe/smart/manifold4w/green/visible,
/turf/open/floor/engine,
/area/engineering/main)
"th" = (
/obj/item/crowbar,
/obj/structure/cable,
/obj/machinery/door/poddoor/shutters/radiation/preopen{
	id = "engsm";
	name = "Radiation Chamber Shutters"
	},
/turf/open/floor/plating,
/area/engineering/supermatter)
"vO" = (
/obj/machinery/door/firedoor,
/obj/machinery/door/airlock/engineering/glass{
	name = "Supermatter Engine Room";
	req_one_access_txt = "10;24"
	},
/obj/machinery/atmospherics/pipe/smart/simple/orange/hidden,
/turf/open/floor/plating,
/area/maintenance/starboard)
"wg" = (
/obj/structure/reflector/double/anchored{
	dir = 5
	},
/turf/open/floor/plasteel/dark,
/area/engineering/main)
"wA" = (
/obj/effect/turf_decal/stripes/line{
	dir = 4
	},
/obj/machinery/meter,
/obj/machinery/atmospherics/pipe/smart/manifold4w/orange/visible,
/turf/open/floor/engine,
/area/engineering/main)
"xg" = (
/obj/machinery/power/rad_collector/anchored,
/obj/structure/window/plasma/reinforced{
	dir = 1
	},
/obj/structure/cable,
/obj/machinery/atmospherics/pipe/smart/manifold4w/green/visible{
	dir = 8
	},
/turf/open/floor/engine,
/area/engineering/supermatter)
"xC" = (
/obj/machinery/power/emitter/welded{
	dir = 1
	},
/obj/structure/cable,
/turf/open/floor/plating,
/area/engineering/main)
"yi" = (
/obj/machinery/power/emitter/welded{
	dir = 1
	},
/obj/machinery/light{
	dir = 4
	},
/obj/structure/cable,
/turf/open/floor/plating,
/area/engineering/main)
"yz" = (
/obj/effect/turf_decal/stripes/corner{
	dir = 4
	},
/obj/structure/cable,
/obj/machinery/atmospherics/pipe/smart/manifold4w/green/visible,
/turf/open/floor/engine,
/area/engineering/main)
"AH" = (
/obj/effect/turf_decal/stripes/line{
	dir = 1
	},
/obj/structure/cable,
/obj/machinery/atmospherics/pipe/smart/manifold4w/green/visible,
/turf/open/floor/engine,
/area/engineering/main)
"Bp" = (
/obj/effect/turf_decal/stripes/line{
	dir = 1
	},
/obj/structure/cable,
/obj/machinery/light{
	dir = 1
	},
/obj/machinery/atmospherics/pipe/smart/manifold4w/green/visible,
/turf/open/floor/engine,
/area/engineering/main)
"Bx" = (
/obj/effect/turf_decal/stripes/line{
	dir = 1
	},
/obj/structure/cable,
/obj/machinery/meter,
/obj/machinery/atmospherics/pipe/smart/manifold4w/green/visible{
	dir = 1
	},
/turf/open/floor/engine,
/area/engineering/main)
"Cd" = (
/obj/effect/turf_decal/stripes/line{
	dir = 1
	},
/obj/machinery/atmospherics/pipe/smart/manifold4w/green/visible,
/turf/open/floor/engine,
/area/engineering/main)
"Dp" = (
/obj/effect/turf_decal/stripes/line{
	dir = 1
	},
/obj/machinery/light{
	dir = 1
	},
/obj/machinery/atmospherics/pipe/smart/manifold4w/green/visible{
	dir = 1
	},
/turf/open/floor/engine,
/area/engineering/main)
"GV" = (
/obj/structure/cable,
/obj/effect/turf_decal/stripes/corner{
	dir = 1
	},
/obj/machinery/atmospherics/components/binary/pump{
	dir = 4;
	name = "Cooling Loop Bypass"
	},
/turf/open/floor/engine,
/area/engineering/main)
"Ia" = (
/obj/effect/spawner/structure/window/plasma/reinforced,
/turf/open/floor/plating,
/area/engineering/main)
"Is" = (
/obj/effect/turf_decal/stripes/line{
	dir = 4
	},
/obj/structure/cable,
/obj/machinery/atmospherics/pipe/smart/manifold4w/orange/visible,
/turf/open/floor/engine,
/area/engineering/main)
"IS" = (
/obj/effect/turf_decal/stripes/line{
	dir = 8
	},
/obj/machinery/atmospherics/components/unary/vent_pump/on/layer4,
/turf/open/floor/engine,
/area/engineering/main)
"Jm" = (
/obj/effect/turf_decal/stripes/line{
	dir = 10
	},
/obj/machinery/atmospherics/pipe/smart/manifold4w/supply/hidden/layer4,
/turf/open/floor/engine,
/area/engineering/main)
"JG" = (
/obj/effect/turf_decal/stripes/line,
/obj/machinery/atmospherics/pipe/smart/manifold4w/supply/hidden/layer4{
	dir = 4
	},
/turf/open/floor/engine,
/area/engineering/main)
"JX" = (
/obj/effect/turf_decal/stripes/line,
/obj/machinery/firealarm{
	dir = 1;
	pixel_y = -24
	},
/obj/machinery/atmospherics/pipe/smart/manifold4w/supply/hidden/layer4{
	dir = 4
	},
/turf/open/floor/engine,
/area/engineering/main)
"NJ" = (
/obj/effect/turf_decal/stripes/line,
/obj/machinery/atmospherics/components/binary/pump{
	dir = 1;
	name = "Atmos to Loop"
	},
/obj/machinery/atmospherics/pipe/smart/manifold4w/supply/hidden/layer4{
	dir = 4
	},
/turf/open/floor/engine,
/area/engineering/main)
"OM" = (
/obj/effect/turf_decal/stripes/line,
/obj/machinery/camera{
	c_tag = "Engineering Supermatter Aft";
	dir = 1;
	network = list("ss13","engine")
	},
/obj/machinery/atmospherics/pipe/smart/manifold4w/supply/hidden/layer4{
	dir = 4
	},
/turf/open/floor/engine,
/area/engineering/main)
"PY" = (
/obj/effect/turf_decal/stripes/line,
/obj/machinery/atmospherics/components/binary/pump/on{
	name = "Gas to Cold Loop"
	},
/obj/machinery/atmospherics/pipe/smart/manifold4w/supply/hidden/layer4{
	dir = 4
	},
/turf/open/floor/engine,
/area/engineering/main)
"Qx" = (
/obj/effect/turf_decal/stripes/line{
	dir = 6
	},
/obj/machinery/atmospherics/components/binary/pump/on{
	dir = 1;
	name = "Cold Loop to Gas"
	},
/obj/machinery/atmospherics/pipe/smart/manifold4w/supply/hidden/layer4{
	dir = 4
	},
/turf/open/floor/engine,
/area/engineering/main)
"SD" = (
/obj/effect/spawner/structure/window/plasma/reinforced,
/obj/machinery/atmospherics/pipe/heat_exchanging/junction,
/turf/open/floor/plating,
/area/engineering/main)
"Ui" = (
/obj/effect/spawner/structure/window/plasma/reinforced,
/obj/machinery/atmospherics/pipe/smart/manifold4w/supply/hidden/layer4{
	dir = 4
	},
/turf/open/floor/plating,
/area/engineering/main)
"WL" = (
/obj/machinery/atmospherics/pipe/smart/manifold4w/supply/hidden/layer4{
	dir = 4
	},
/turf/open/floor/plasteel/dark,
/area/engineering/main)
"WN" = (
/obj/effect/turf_decal/stripes/line{
	dir = 8
	},
/obj/structure/cable,
/obj/machinery/atmospherics/pipe/smart/manifold4w/cyan/visible,
/turf/open/floor/engine,
/area/engineering/main)
"WX" = (
/obj/machinery/airalarm{
	dir = 1;
	pixel_y = -22
	},
/obj/machinery/atmospherics/components/unary/vent_pump/on/layer4{
	dir = 8
	},
/turf/open/floor/plasteel/dark,
/area/engineering/main)
"YP" = (
/obj/item/wrench,
/turf/open/floor/plasteel/dark,
/area/engineering/main)
"YT" = (
/turf/open/floor/plating,
/area/engineering/main)
"Zf" = (
/turf/open/floor/plasteel/dark,
/area/engineering/main)

(1,1,1) = {"
ab
ai
ap
az
aE
aL
bb
bi
bw
bw
bw
bQ
bw
bw
bw
IS
mO
Jm
ad
"}
(2,1,1) = {"
ae
aj
aq
aA
aF
aM
bc
bk
bx
bk
bI
bW
cg
io
nR
sF
yz
JG
ad
"}
(3,1,1) = {"
mY
ak
ar
aB
Ia
aM
bd
bl
bl
bz
bC
bX
ch
bz
pc
cd
AH
JG
ad
"}
(4,1,1) = {"
ad
al
ad
Ia
ad
aN
bd
bm
bm
bz
bJ
dh
ck
bz
py
py
AH
JX
ad
"}
(5,1,1) = {"
fe
am
at
au
aH
aO
be
bp
bz
bC
bK
bY
co
lt
bz
bp
Bp
JG
ad
"}
(6,1,1) = {"
af
an
au
aC
Ia
aM
bd
bq
dh
bF
bL
dh
cM
xg
qU
bq
AH
JG
ad
"}
(7,1,1) = {"
ag
an
ax
aC
Ia
aM
bd
br
bA
bF
bL
ca
cM
xg
bA
th
Bx
NJ
vO
"}
(8,1,1) = {"
af
an
au
aC
Ia
aM
bf
bq
dh
bF
bL
dh
cM
xg
dh
bq
Cd
OM
ad
"}
(9,1,1) = {"
ah
ao
ay
ay
by
aP
bg
bp
bz
bz
bN
cb
md
bz
bz
bp
Dp
PY
SD
"}
(10,1,1) = {"
ad
ad
ad
Ia
ad
aW
du
WN
WN
WN
aU
cc
hm
WN
WN
bQ
GV
JG
Ia
"}
(11,1,1) = {"
dz
as
ad
aD
aK
aX
bh
bs
bB
bH
bO
cd
mC
nI
rI
wA
Is
Qx
SD
"}
(12,1,1) = {"
dz
as
ad
aI
ad
aY
bn
Ia
ad
ad
Ia
Ia
Ia
ad
ad
Ia
bn
Ui
ad
"}
(13,1,1) = {"
dz
as
as
as
ad
aZ
bu
YT
Zf
Zf
Zf
cf
wg
Zf
Zf
YT
bu
WL
ad
"}
(14,1,1) = {"
dz
dz
dz
dz
ad
ba
bu
bu
Zf
Zf
Zf
Zf
Zf
Zf
Zf
bu
bu
WX
ad
"}
(15,1,1) = {"
dz
dz
dz
dz
ad
lz
YT
bt
Zf
Zf
Zf
cf
Zf
Zf
Zf
xC
YT
YP
ad
"}
(16,1,1) = {"
dz
dz
dz
dz
ad
YT
YT
bv
YT
YT
bP
ad
hM
YT
YT
yi
YT
Zf
ad
"}
(17,1,1) = {"
as
dz
dz
dz
ad
ad
ad
ad
ad
ad
ad
ad
ad
ad
ad
ad
ad
ad
ad
"}
