//MAP CONVERTED BY dmm2tgm.py THIS HEADER COMMENT PREVENTS RECONVERSION, DO NOT REMOVE
"aT" = (
/obj/effect/turf_decal/siding/thinplating_new/corner{
	dir = 1
	},
/obj/structure/flora/bush{
	pixel_y = -7;
	pixel_x = 10
	},
/obj/structure/flora/ausbushes/sparsegrass{
	pixel_x = 10;
	pixel_y = 20
	},
/turf/open/floor/plating/asteroid/snow/normal_temp,
/area/hallway/primary/central/low_level_centre)
"bl" = (
/obj/effect/turf_decal/siding/thinplating_new/corner{
	dir = 1
	},
/obj/structure/flora/rock/pile/icy{
	pixel_y = 4;
	pixel_x = 11
	},
/turf/open/floor/plating/asteroid/snow/normal_temp,
/area/hallway/primary/central/low_level_centre)
"co" = (
/obj/structure/flora/ausbushes/sparsegrass{
	pixel_y = 10
	},
/turf/open/floor/plating/asteroid/snow/normal_temp,
/area/template_noop)
"cx" = (
/obj/effect/turf_decal/tile/blue,
/obj/effect/turf_decal/tile/blue{
	dir = 1
	},
/obj/effect/turf_decal/tile/blue{
	dir = 8
	},
/turf/open/floor/plasteel/dark,
/area/hallway/primary/central/low_level_centre)
"cI" = (
/obj/structure/flora/bush{
	pixel_x = 15;
	pixel_y = 10
	},
/mob/living/simple_animal/pet/penguin/baby,
/turf/open/floor/plating/asteroid/snow/normal_temp,
/area/hallway/primary/central/low_level_centre)
"cP" = (
/obj/structure/statue/snow/snowlegion{
	desc = "An off-putting snowman, something about it gives you a sense of dread instead of holiday cheer.";
	anchored = 1
	},
/turf/open/floor/plating/asteroid/snow/normal_temp,
/area/template_noop)
"dz" = (
/obj/structure/statue/snow/snowman{
	anchored = 1
	},
/turf/open/floor/plating/asteroid/snow/normal_temp,
/area/template_noop)
"dP" = (
/turf/open/floor/plasteel/dark/side{
	dir = 9
	},
/area/hallway/primary/central/low_level_centre)
"ea" = (
/turf/open/floor/plating/asteroid/snow/normal_temp,
/area/hallway/primary/central/low_level_centre)
"fk" = (
/turf/template_noop,
/area/template_noop)
"fl" = (
/obj/structure/window/reinforced,
/obj/effect/turf_decal/siding/thinplating_new,
/turf/open/floor/plating/asteroid/snow/normal_temp,
/area/hallway/primary/central/low_level_centre)
"fU" = (
/obj/structure/flora/grass/brown,
/turf/open/floor/plating/asteroid/snow/normal_temp,
/area/template_noop)
"hf" = (
/obj/structure/statue/snow/snowman{
	pixel_x = -10;
	pixel_y = 15;
	anchored = 1
	},
/obj/structure/flora/rock/pile/icy{
	pixel_y = 1;
	pixel_x = 15
	},
/turf/open/floor/plating/asteroid/snow/normal_temp,
/area/hallway/primary/central/low_level_centre)
"hF" = (
/obj/structure/flora/rock/pile/icy{
	pixel_y = -17
	},
/obj/structure/flora/ausbushes/sparsegrass{
	pixel_y = 10
	},
/turf/open/floor/plating/asteroid/snow/normal_temp,
/area/template_noop)
"io" = (
/obj/structure/statue/snow/snowman{
	anchored = 1
	},
/obj/structure/flora/rock/pile/icy{
	pixel_x = -5;
	pixel_y = 7
	},
/turf/open/floor/plating/asteroid/snow/normal_temp,
/area/template_noop)
"iN" = (
/obj/structure/flora/grass/green{
	pixel_x = -7
	},
/turf/open/floor/plating/asteroid/snow/normal_temp,
/area/template_noop)
"jD" = (
/turf/open/floor/plasteel/dark/side{
	dir = 10
	},
/area/hallway/primary/central/low_level_centre)
"kY" = (
/obj/structure/window/reinforced,
/obj/effect/turf_decal/siding/thinplating_new,
/obj/effect/turf_decal/weather/snow/corner{
	dir = 9
	},
/turf/open/floor/plating/ice/icemoon/safe,
/area/hallway/primary/central/low_level_centre)
"nA" = (
/turf/open/floor/plasteel/dark/corner,
/area/hallway/primary/central/low_level_centre)
"nS" = (
/obj/structure/window/reinforced{
	dir = 8
	},
/obj/structure/window/reinforced,
/obj/effect/turf_decal/siding/thinplating_new{
	dir = 10
	},
/turf/open/floor/plating/asteroid/snow/normal_temp,
/area/hallway/primary/central/low_level_centre)
"of" = (
/obj/structure/flora/ausbushes/sparsegrass,
/turf/open/floor/plating/asteroid/snow/normal_temp,
/area/hallway/primary/central/low_level_centre)
"oj" = (
/obj/structure/flora/rock/pile/icy{
	pixel_y = 4;
	pixel_x = 11
	},
/turf/open/floor/plating/asteroid/snow/normal_temp,
/area/hallway/primary/central/low_level_centre)
"ou" = (
/obj/structure/window/reinforced{
	dir = 8
	},
/obj/effect/turf_decal/siding/thinplating_new{
	dir = 8
	},
/obj/structure/flora/bush{
	pixel_x = 20
	},
/turf/open/floor/plating/asteroid/snow/normal_temp,
/area/hallway/primary/central/low_level_centre)
"oO" = (
/obj/effect/turf_decal/siding/thinplating_new/corner{
	dir = 8
	},
/obj/structure/flora/grass/brown,
/turf/open/floor/plating/asteroid/snow/normal_temp,
/area/hallway/primary/central/low_level_centre)
"pf" = (
/obj/effect/turf_decal/weather/snow/corner{
	dir = 8
	},
/turf/template_noop,
/area/template_noop)
"ql" = (
/obj/structure/window/reinforced,
/obj/effect/turf_decal/siding/thinplating_new,
/obj/machinery/atmospherics/components/unary/vent_scrubber/on/layer2,
/obj/structure/flora/grass/green{
	pixel_y = 6;
	pixel_x = -4
	},
/turf/open/floor/plating/asteroid/snow/normal_temp,
/area/hallway/primary/central/low_level_centre)
"qU" = (
/obj/structure/flora/tree/pine{
	pixel_y = -4;
	pixel_x = 0
	},
/obj/structure/flora/grass/both,
/turf/open/floor/plating/asteroid/snow/normal_temp,
/area/template_noop)
"sB" = (
/obj/machinery/light/floor,
/obj/machinery/light/floor/directional/west,
/obj/structure/window/reinforced{
	dir = 8
	},
/obj/structure/window/reinforced,
/obj/effect/turf_decal/siding/thinplating_new{
	dir = 10
	},
/obj/structure/flora/ausbushes/sparsegrass,
/turf/open/floor/plating/asteroid/snow/normal_temp,
/area/hallway/primary/central/low_level_centre)
"sV" = (
/obj/structure/flora/grass/green{
	pixel_y = 14
	},
/turf/open/floor/plating/asteroid/snow/normal_temp,
/area/hallway/primary/central/low_level_centre)
"up" = (
/obj/structure/window/reinforced{
	dir = 1
	},
/obj/structure/window/reinforced{
	dir = 4
	},
/obj/effect/turf_decal/siding/thinplating_new{
	dir = 5
	},
/turf/open/floor/plating/asteroid/snow/normal_temp,
/area/hallway/primary/central/low_level_centre)
"xp" = (
/obj/structure/window/reinforced{
	dir = 4
	},
/obj/effect/turf_decal/siding/thinplating_new{
	dir = 4
	},
/obj/structure/flora/ausbushes/sparsegrass{
	pixel_y = 13;
	pixel_x = -13
	},
/turf/open/floor/plating/asteroid/snow/normal_temp,
/area/hallway/primary/central/low_level_centre)
"zq" = (
/obj/structure/flora/ausbushes/sparsegrass,
/turf/open/floor/plating/asteroid/snow/normal_temp,
/area/template_noop)
"Aw" = (
/obj/structure/window/reinforced{
	dir = 8
	},
/obj/structure/window/reinforced{
	dir = 1
	},
/obj/effect/turf_decal/siding/thinplating_new{
	dir = 9
	},
/turf/open/floor/plating/asteroid/snow/normal_temp,
/area/hallway/primary/central/low_level_centre)
"AB" = (
/obj/structure/flora/grass/both{
	pixel_y = 12;
	pixel_x = 20
	},
/turf/open/floor/plating/asteroid/snow/normal_temp,
/area/hallway/primary/central/low_level_centre)
"AK" = (
/obj/structure/statue/snow/snowlegion{
	desc = "An off-putting snowman, something about it gives you a sense of dread instead of holiday cheer.";
	anchored = 1
	},
/turf/open/floor/plating/asteroid/snow/normal_temp,
/area/hallway/primary/central/low_level_centre)
"Bl" = (
/obj/effect/turf_decal/siding/thinplating_new/corner{
	dir = 8
	},
/obj/structure/flora/grass/both,
/turf/open/floor/plating/asteroid/snow/normal_temp,
/area/hallway/primary/central/low_level_centre)
"Bx" = (
/obj/effect/turf_decal/siding/thinplating_new/corner,
/obj/structure/flora/ausbushes/sparsegrass{
	pixel_x = -16;
	pixel_y = -6
	},
/turf/open/floor/plating/asteroid/snow/normal_temp,
/area/hallway/primary/central/low_level_centre)
"Cd" = (
/obj/structure/window/reinforced{
	dir = 1
	},
/obj/structure/window/reinforced{
	dir = 8
	},
/obj/effect/turf_decal/siding/thinplating_new{
	dir = 9
	},
/turf/open/floor/plating/asteroid/snow/normal_temp,
/area/hallway/primary/central/low_level_centre)
"Cs" = (
/obj/structure/window/reinforced{
	dir = 4
	},
/obj/structure/window/reinforced,
/obj/effect/turf_decal/siding/thinplating_new{
	dir = 6
	},
/obj/effect/turf_decal/weather/snow/corner{
	dir = 9
	},
/turf/open/floor/plating/ice/icemoon/safe,
/area/hallway/primary/central/low_level_centre)
"CA" = (
/turf/open/floor/plasteel/dark/corner{
	dir = 4
	},
/area/hallway/primary/central/low_level_centre)
"CF" = (
/obj/structure/flora/ausbushes/sparsegrass{
	pixel_x = 7
	},
/turf/open/floor/plating/asteroid/snow/normal_temp,
/area/template_noop)
"CW" = (
/obj/effect/turf_decal/siding/thinplating_new/corner{
	dir = 4
	},
/obj/structure/flora/grass/both{
	pixel_y = -5;
	pixel_x = 20
	},
/turf/open/floor/plating/asteroid/snow/normal_temp,
/area/hallway/primary/central/low_level_centre)
"DQ" = (
/obj/structure/window/reinforced{
	dir = 4
	},
/obj/effect/turf_decal/siding/thinplating_new{
	dir = 4
	},
/obj/effect/turf_decal/weather/snow/corner{
	dir = 9
	},
/turf/open/floor/plating/ice/icemoon/safe,
/area/hallway/primary/central/low_level_centre)
"DX" = (
/obj/structure/window/reinforced{
	dir = 1
	},
/obj/effect/turf_decal/siding/thinplating_new{
	dir = 1
	},
/obj/effect/turf_decal/weather/snow/corner{
	dir = 6
	},
/turf/open/floor/plating/ice/icemoon/safe,
/area/hallway/primary/central/low_level_centre)
"GC" = (
/obj/structure/snowflakes,
/turf/template_noop,
/area/template_noop)
"Hm" = (
/obj/structure/window/reinforced{
	dir = 8
	},
/obj/structure/window/reinforced,
/obj/effect/turf_decal/siding/thinplating_new{
	dir = 10
	},
/obj/structure/flora/rock/icy{
	pixel_y = 15;
	pixel_x = 7
	},
/turf/open/floor/plating/asteroid/snow/normal_temp,
/area/hallway/primary/central/low_level_centre)
"HQ" = (
/turf/open/floor/plasteel/dark/corner{
	dir = 8
	},
/area/hallway/primary/central/low_level_centre)
"IP" = (
/obj/machinery/light/floor,
/obj/machinery/light/floor/directional/east,
/obj/structure/window/reinforced{
	dir = 4
	},
/obj/structure/window/reinforced,
/obj/effect/turf_decal/siding/thinplating_new{
	dir = 6
	},
/turf/open/floor/plating/ice/icemoon/safe,
/area/hallway/primary/central/low_level_centre)
"Kd" = (
/obj/structure/flora/ausbushes/sparsegrass{
	pixel_y = 28
	},
/mob/living/simple_animal/pet/penguin/baby,
/turf/open/floor/plating/asteroid/snow/normal_temp,
/area/hallway/primary/central/low_level_centre)
"Kg" = (
/obj/structure/flora/tree/pine,
/turf/open/floor/plating/asteroid/snow/normal_temp,
/area/hallway/primary/central/low_level_centre)
"Km" = (
/obj/structure/flora/tree/dead,
/turf/open/floor/plating/asteroid/snow/normal_temp,
/area/hallway/primary/central/low_level_centre)
"Kp" = (
/obj/structure/window/reinforced{
	dir = 8
	},
/obj/effect/turf_decal/siding/thinplating_new{
	dir = 8
	},
/obj/effect/turf_decal/weather/snow/corner{
	dir = 6
	},
/turf/open/floor/plating/ice/icemoon/safe,
/area/hallway/primary/central/low_level_centre)
"LW" = (
/obj/effect/turf_decal/siding/thinplating_new/corner{
	dir = 4
	},
/turf/open/floor/plating/asteroid/snow/normal_temp,
/area/hallway/primary/central/low_level_centre)
"Nu" = (
/obj/structure/flora/grass/brown,
/turf/open/floor/plating/asteroid/snow/normal_temp,
/area/hallway/primary/central/low_level_centre)
"Ny" = (
/turf/open/floor/plasteel/monofloor/dark,
/area/hallway/primary/central/low_level_centre)
"NB" = (
/mob/living/simple_animal/pet/penguin/emperor,
/turf/open/floor/plating/asteroid/snow/normal_temp,
/area/hallway/primary/central/low_level_centre)
"PF" = (
/obj/structure/flora/grass/both,
/turf/open/floor/plating/asteroid/snow/normal_temp,
/area/template_noop)
"PL" = (
/obj/effect/turf_decal/tile/blue{
	dir = 8
	},
/obj/effect/turf_decal/tile/blue{
	dir = 4
	},
/obj/effect/turf_decal/tile/blue{
	dir = 1
	},
/turf/open/floor/plasteel/dark,
/area/hallway/primary/central/low_level_centre)
"PZ" = (
/obj/effect/turf_decal/weather/snow/corner{
	dir = 4
	},
/turf/template_noop,
/area/template_noop)
"QD" = (
/obj/structure/window/reinforced{
	dir = 1
	},
/obj/effect/turf_decal/siding/thinplating_new{
	dir = 1
	},
/obj/machinery/atmospherics/components/unary/vent_pump/on/layer4{
	dir = 1
	},
/obj/structure/flora/grass/both{
	pixel_y = -13;
	pixel_x = 11
	},
/turf/open/floor/plating/asteroid/snow/normal_temp,
/area/hallway/primary/central/low_level_centre)
"QR" = (
/mob/living/simple_animal/deer,
/turf/open/floor/plating/asteroid/snow/normal_temp,
/area/hallway/primary/central/low_level_centre)
"QU" = (
/obj/machinery/light/floor/directional/north,
/obj/machinery/light/floor/directional/east,
/obj/structure/window/reinforced{
	dir = 4
	},
/obj/structure/window/reinforced{
	dir = 1
	},
/obj/effect/turf_decal/siding/thinplating_new{
	dir = 5
	},
/turf/open/floor/plating/asteroid/snow/normal_temp,
/area/hallway/primary/central/low_level_centre)
"Rj" = (
/obj/effect/turf_decal/weather/snow/corner,
/turf/template_noop,
/area/template_noop)
"Rw" = (
/turf/open/floor/plasteel/dark/side{
	dir = 5
	},
/area/hallway/primary/central/low_level_centre)
"RO" = (
/obj/structure/window/reinforced{
	dir = 4
	},
/obj/structure/window/reinforced{
	dir = 1
	},
/obj/effect/turf_decal/siding/thinplating_new{
	dir = 5
	},
/turf/open/floor/plating/asteroid/snow/normal_temp,
/area/hallway/primary/central/low_level_centre)
"Tp" = (
/obj/structure/flora/tree/dead,
/turf/open/floor/plating/asteroid/snow/normal_temp,
/area/template_noop)
"TQ" = (
/obj/structure/flora/rock/icy{
	pixel_y = 6
	},
/turf/open/floor/plating/asteroid/snow/normal_temp,
/area/template_noop)
"Us" = (
/obj/effect/turf_decal/weather/snow/corner{
	dir = 1
	},
/turf/template_noop,
/area/template_noop)
"UB" = (
/obj/structure/flora/tree/pine/xmas,
/turf/open/floor/plating/asteroid/snow/normal_temp,
/area/hallway/primary/central/low_level_centre)
"Vh" = (
/obj/machinery/light/floor/directional/north,
/obj/machinery/light/floor/directional/west,
/obj/structure/window/reinforced{
	dir = 8
	},
/obj/structure/window/reinforced{
	dir = 1
	},
/obj/effect/turf_decal/siding/thinplating_new{
	dir = 9
	},
/turf/open/floor/plating/ice/icemoon/safe,
/area/hallway/primary/central/low_level_centre)
"Vr" = (
/obj/structure/flora/grass/green,
/turf/open/floor/plating/asteroid/snow/normal_temp,
/area/template_noop)
"VI" = (
/obj/structure/window/reinforced{
	dir = 1
	},
/obj/effect/turf_decal/siding/thinplating_new{
	dir = 1
	},
/turf/open/floor/plating/asteroid/snow/normal_temp,
/area/hallway/primary/central/low_level_centre)
"Wt" = (
/obj/effect/turf_decal/siding/thinplating_new/corner,
/turf/open/floor/plating/asteroid/snow/normal_temp,
/area/hallway/primary/central/low_level_centre)
"Ww" = (
/turf/open/floor/plasteel/dark/side{
	dir = 6
	},
/area/hallway/primary/central/low_level_centre)
"YS" = (
/turf/open/floor/plasteel/dark/corner{
	dir = 1
	},
/area/hallway/primary/central/low_level_centre)
"ZU" = (
/obj/structure/flora/tree/pine{
	pixel_x = 0
	},
/obj/structure/flora/grass/both,
/turf/open/floor/plating/asteroid/snow/normal_temp,
/area/template_noop)

(1,1,1) = {"
TQ
Us
Rj
TQ
fk
fk
GC
fk
fk
fk
fk
GC
fk
fk
TQ
fk
fk
TQ
"}
(2,1,1) = {"
Vr
Us
Rj
io
co
Tp
PF
cP
Us
Rj
cP
co
Tp
hF
dz
Us
Rj
PF
"}
(3,1,1) = {"
pf
fk
fk
pf
pf
pf
pf
pf
fk
fk
pf
pf
pf
pf
pf
fk
fk
pf
"}
(4,1,1) = {"
PZ
fk
fk
fk
fk
fk
fk
fk
fk
fk
fk
fk
fk
fk
fk
fk
fk
PZ
"}
(5,1,1) = {"
PF
Us
fk
fk
fk
PL
dP
YS
Aw
Hm
HQ
jD
cx
fk
fk
fk
Rj
fU
"}
(6,1,1) = {"
Tp
Us
fk
fk
fk
dP
Vh
Kp
bl
Bl
ou
sB
jD
fk
fk
fk
Rj
Tp
"}
(7,1,1) = {"
fU
Us
fk
fk
fk
YS
DX
Nu
AK
ea
Km
fl
HQ
fk
fk
fk
Rj
zq
"}
(8,1,1) = {"
pf
fk
fk
fk
fk
Cd
aT
QR
ea
ea
of
oO
nS
fk
fk
fk
fk
pf
"}
(9,1,1) = {"
fk
fk
fk
fk
fk
QD
ea
ea
ea
UB
Kd
AB
ql
fk
fk
fk
fk
fk
"}
(10,1,1) = {"
PZ
fk
fk
fk
fk
up
LW
oj
ea
sV
hf
Wt
Cs
fk
fk
fk
fk
PZ
"}
(11,1,1) = {"
CF
Us
fk
fk
fk
CA
VI
ea
Kg
cI
NB
kY
nA
fk
fk
fk
Rj
Vr
"}
(12,1,1) = {"
Tp
Us
fk
fk
fk
Rw
QU
xp
CW
Bx
DQ
IP
Ww
fk
fk
fk
Rj
Tp
"}
(13,1,1) = {"
iN
Us
fk
fk
fk
Ny
Rw
CA
RO
Cs
nA
Ww
Ny
fk
fk
fk
Rj
PF
"}
(14,1,1) = {"
pf
fk
fk
fk
fk
fk
fk
fk
fk
fk
fk
fk
fk
fk
fk
fk
fk
pf
"}
(15,1,1) = {"
PZ
fk
fk
fk
fk
fk
fk
fk
fk
fk
fk
fk
fk
fk
fk
fk
fk
PZ
"}
(16,1,1) = {"
qU
Us
fk
PZ
fk
fk
fk
PZ
fk
fk
PZ
fk
fk
fk
PZ
fk
Rj
ZU
"}
(17,1,1) = {"
fU
Us
Rj
Tp
Us
fk
Rj
Tp
Us
Rj
Tp
Us
fk
Rj
Tp
Us
Rj
fU
"}
