//MAP CONVERTED BY dmm2tgm.py THIS HEADER COMMENT PREVENTS RECONVERSION, DO NOT REMOVE
"aT" = (
/obj/effect/turf_decal/siding/thinplating_new/corner{
	dir = 1
	},
/turf/open/floor/fakespace,
/area/hallway/primary/central/low_level_centre)
"bl" = (
/obj/effect/turf_decal/siding/thinplating_new/corner{
	dir = 1
	},
/mob/living/simple_animal/hostile/carp{
	dir = 8
	},
/turf/open/floor/fakespace,
/area/hallway/primary/central/low_level_centre)
"cx" = (
/obj/effect/turf_decal/tile/blue,
/obj/effect/turf_decal/tile/blue{
	dir = 1
	},
/obj/effect/turf_decal/tile/blue{
	dir = 8
	},
/turf/open/floor/plasteel/dark,
/area/hallway/primary/central/low_level_centre)
"cI" = (
/obj/structure/glowshroom/single,
/turf/open/floor/plating/asteroid,
/area/hallway/primary/central/low_level_centre)
"dP" = (
/turf/open/floor/plasteel/dark/side{
	dir = 9
	},
/area/hallway/primary/central/low_level_centre)
"ea" = (
/obj/structure/flora/rock/pile{
	icon_state = "basalt2";
	pixel_y = 5
	},
/turf/open/floor/plating/asteroid,
/area/hallway/primary/central/low_level_centre)
"fk" = (
/turf/template_noop,
/area/template_noop)
"io" = (
/obj/item/kirbyplants/photosynthetic,
/turf/template_noop,
/area/template_noop)
"jD" = (
/turf/open/floor/plasteel/dark/side{
	dir = 10
	},
/area/hallway/primary/central/low_level_centre)
"kY" = (
/obj/structure/window/reinforced,
/obj/effect/turf_decal/siding/thinplating_new,
/turf/open/floor/fakespace,
/area/hallway/primary/central/low_level_centre)
"nA" = (
/obj/structure/fluff/hedge,
/turf/open/floor/plasteel/dark/corner,
/area/hallway/primary/central/low_level_centre)
"of" = (
/turf/open/floor/plating/asteroid,
/area/hallway/primary/central/low_level_centre)
"oO" = (
/obj/effect/turf_decal/siding/thinplating_new/corner{
	dir = 8
	},
/turf/open/floor/fakespace,
/area/hallway/primary/central/low_level_centre)
"ql" = (
/obj/structure/window/reinforced,
/obj/effect/turf_decal/siding/thinplating_new,
/obj/machinery/atmospherics/components/unary/vent_scrubber/on/layer2,
/obj/structure/lattice/catwalk,
/turf/open/floor/fakespace,
/area/hallway/primary/central/low_level_centre)
"sB" = (
/obj/machinery/light/floor,
/obj/machinery/light/floor/directional/west,
/obj/structure/window/reinforced{
	dir = 8
	},
/obj/structure/window/reinforced,
/obj/effect/turf_decal/siding/thinplating_new{
	dir = 10
	},
/obj/structure/lattice/catwalk,
/obj/structure/marker_beacon/green,
/turf/open/floor/fakespace,
/area/hallway/primary/central/low_level_centre)
"up" = (
/obj/structure/window/reinforced{
	dir = 1
	},
/obj/structure/window/reinforced{
	dir = 4
	},
/obj/effect/turf_decal/siding/thinplating_new{
	dir = 5
	},
/obj/structure/lattice/catwalk,
/turf/open/floor/fakespace,
/area/hallway/primary/central/low_level_centre)
"Aw" = (
/obj/structure/window/reinforced{
	dir = 8
	},
/obj/structure/window/reinforced{
	dir = 1
	},
/obj/effect/turf_decal/siding/thinplating_new{
	dir = 9
	},
/obj/structure/lattice/catwalk,
/turf/open/floor/fakespace,
/area/hallway/primary/central/low_level_centre)
"AB" = (
/turf/open/floor/fakespace,
/area/hallway/primary/central/low_level_centre)
"Bx" = (
/obj/effect/turf_decal/siding/thinplating_new/corner,
/turf/open/floor/plating/asteroid,
/area/hallway/primary/central/low_level_centre)
"Cd" = (
/obj/structure/window/reinforced{
	dir = 1
	},
/obj/structure/window/reinforced{
	dir = 8
	},
/obj/effect/turf_decal/siding/thinplating_new{
	dir = 9
	},
/obj/structure/lattice/catwalk,
/turf/open/floor/fakespace,
/area/hallway/primary/central/low_level_centre)
"Cs" = (
/obj/structure/window/reinforced{
	dir = 4
	},
/obj/structure/window/reinforced,
/obj/effect/turf_decal/siding/thinplating_new{
	dir = 6
	},
/obj/structure/lattice/catwalk,
/turf/open/floor/fakespace,
/area/hallway/primary/central/low_level_centre)
"CA" = (
/obj/structure/fluff/hedge,
/turf/open/floor/plasteel/dark/corner{
	dir = 4
	},
/area/hallway/primary/central/low_level_centre)
"CW" = (
/obj/effect/turf_decal/siding/thinplating_new/corner{
	dir = 4
	},
/obj/structure/flora/rock/pile{
	icon_state = "basalt"
	},
/turf/open/floor/plating/asteroid,
/area/hallway/primary/central/low_level_centre)
"DQ" = (
/obj/structure/window/reinforced{
	dir = 4
	},
/obj/effect/turf_decal/siding/thinplating_new{
	dir = 4
	},
/turf/open/floor/fakespace,
/area/hallway/primary/central/low_level_centre)
"Hm" = (
/obj/structure/window/reinforced{
	dir = 8
	},
/obj/structure/window/reinforced,
/obj/effect/turf_decal/siding/thinplating_new{
	dir = 10
	},
/obj/structure/lattice/catwalk,
/turf/open/floor/fakespace,
/area/hallway/primary/central/low_level_centre)
"HQ" = (
/obj/structure/fluff/hedge,
/turf/open/floor/plasteel/dark/corner{
	dir = 8
	},
/area/hallway/primary/central/low_level_centre)
"IP" = (
/obj/machinery/light/floor,
/obj/machinery/light/floor/directional/east,
/obj/structure/window/reinforced{
	dir = 4
	},
/obj/structure/window/reinforced,
/obj/effect/turf_decal/siding/thinplating_new{
	dir = 6
	},
/obj/structure/lattice/catwalk,
/obj/structure/marker_beacon/burgundy,
/turf/open/floor/fakespace,
/area/hallway/primary/central/low_level_centre)
"Kg" = (
/turf/closed/mineral/random/labormineral,
/area/hallway/primary/central/low_level_centre)
"Kp" = (
/obj/structure/window/reinforced{
	dir = 8
	},
/obj/effect/turf_decal/siding/thinplating_new{
	dir = 8
	},
/turf/open/floor/fakespace,
/area/hallway/primary/central/low_level_centre)
"LW" = (
/obj/effect/turf_decal/siding/thinplating_new/corner{
	dir = 4
	},
/turf/open/floor/plating/asteroid,
/area/hallway/primary/central/low_level_centre)
"Ny" = (
/turf/open/floor/plasteel/monofloor/dark,
/area/hallway/primary/central/low_level_centre)
"PL" = (
/obj/effect/turf_decal/tile/blue{
	dir = 8
	},
/obj/effect/turf_decal/tile/blue{
	dir = 4
	},
/obj/effect/turf_decal/tile/blue{
	dir = 1
	},
/turf/open/floor/plasteel/dark,
/area/hallway/primary/central/low_level_centre)
"QD" = (
/obj/structure/window/reinforced{
	dir = 1
	},
/obj/effect/turf_decal/siding/thinplating_new{
	dir = 1
	},
/obj/machinery/atmospherics/components/unary/vent_pump/on/layer4{
	dir = 1
	},
/obj/structure/lattice/catwalk,
/turf/open/floor/fakespace,
/area/hallway/primary/central/low_level_centre)
"QR" = (
/obj/structure/flora/rock/pile,
/turf/open/floor/plating/asteroid,
/area/hallway/primary/central/low_level_centre)
"QU" = (
/obj/machinery/light/floor/directional/north,
/obj/machinery/light/floor/directional/east,
/obj/structure/window/reinforced{
	dir = 4
	},
/obj/structure/window/reinforced{
	dir = 1
	},
/obj/effect/turf_decal/siding/thinplating_new{
	dir = 5
	},
/obj/structure/lattice/catwalk,
/obj/structure/marker_beacon/green,
/turf/open/floor/fakespace,
/area/hallway/primary/central/low_level_centre)
"Rw" = (
/turf/open/floor/plasteel/dark/side{
	dir = 5
	},
/area/hallway/primary/central/low_level_centre)
"RO" = (
/obj/structure/window/reinforced{
	dir = 4
	},
/obj/structure/window/reinforced{
	dir = 1
	},
/obj/effect/turf_decal/siding/thinplating_new{
	dir = 5
	},
/obj/structure/lattice/catwalk,
/turf/open/floor/fakespace,
/area/hallway/primary/central/low_level_centre)
"Tp" = (
/obj/structure/fluff/hedge,
/turf/template_noop,
/area/template_noop)
"Vh" = (
/obj/machinery/light/floor/directional/north,
/obj/machinery/light/floor/directional/west,
/obj/structure/window/reinforced{
	dir = 8
	},
/obj/structure/window/reinforced{
	dir = 1
	},
/obj/effect/turf_decal/siding/thinplating_new{
	dir = 9
	},
/obj/structure/lattice/catwalk,
/obj/structure/marker_beacon/burgundy,
/turf/open/floor/fakespace,
/area/hallway/primary/central/low_level_centre)
"VI" = (
/obj/structure/window/reinforced{
	dir = 1
	},
/obj/effect/turf_decal/siding/thinplating_new{
	dir = 1
	},
/turf/open/floor/fakespace,
/area/hallway/primary/central/low_level_centre)
"Wt" = (
/obj/effect/turf_decal/siding/thinplating_new/corner,
/mob/living/simple_animal/hostile/carp,
/turf/open/floor/fakespace,
/area/hallway/primary/central/low_level_centre)
"Ww" = (
/turf/open/floor/plasteel/dark/side{
	dir = 6
	},
/area/hallway/primary/central/low_level_centre)
"YS" = (
/obj/structure/fluff/hedge,
/turf/open/floor/plasteel/dark/corner{
	dir = 1
	},
/area/hallway/primary/central/low_level_centre)

(1,1,1) = {"
Tp
fk
fk
Tp
fk
fk
fk
fk
fk
fk
fk
fk
fk
fk
Tp
fk
fk
Tp
"}
(2,1,1) = {"
Tp
fk
fk
io
Tp
Tp
Tp
io
fk
fk
io
Tp
Tp
Tp
io
fk
fk
Tp
"}
(3,1,1) = {"
fk
fk
fk
fk
fk
fk
fk
fk
fk
fk
fk
fk
fk
fk
fk
fk
fk
fk
"}
(4,1,1) = {"
fk
fk
fk
fk
fk
fk
fk
fk
fk
fk
fk
fk
fk
fk
fk
fk
fk
fk
"}
(5,1,1) = {"
Tp
fk
fk
fk
fk
PL
dP
YS
Aw
Hm
HQ
jD
cx
fk
fk
fk
fk
Tp
"}
(6,1,1) = {"
Tp
fk
fk
fk
fk
dP
Vh
Kp
bl
oO
Kp
sB
jD
fk
fk
fk
fk
Tp
"}
(7,1,1) = {"
Tp
fk
fk
fk
fk
YS
VI
AB
of
cI
AB
kY
HQ
fk
fk
fk
fk
Tp
"}
(8,1,1) = {"
fk
fk
fk
fk
fk
Cd
aT
QR
Kg
ea
of
oO
Hm
fk
fk
fk
fk
fk
"}
(9,1,1) = {"
fk
fk
fk
fk
fk
QD
of
cI
Kg
Kg
cI
AB
ql
fk
fk
fk
fk
fk
"}
(10,1,1) = {"
fk
fk
fk
fk
fk
up
LW
Kg
Kg
Kg
QR
Wt
Cs
fk
fk
fk
fk
fk
"}
(11,1,1) = {"
Tp
fk
fk
fk
fk
CA
VI
QR
Kg
cI
of
kY
nA
fk
fk
fk
fk
Tp
"}
(12,1,1) = {"
Tp
fk
fk
fk
fk
Rw
QU
DQ
CW
Bx
DQ
IP
Ww
fk
fk
fk
fk
Tp
"}
(13,1,1) = {"
Tp
fk
fk
fk
fk
Ny
Rw
CA
RO
Cs
nA
Ww
Ny
fk
fk
fk
fk
Tp
"}
(14,1,1) = {"
fk
fk
fk
fk
fk
fk
fk
fk
fk
fk
fk
fk
fk
fk
fk
fk
fk
fk
"}
(15,1,1) = {"
fk
fk
fk
fk
fk
fk
fk
fk
fk
fk
fk
fk
fk
fk
fk
fk
fk
fk
"}
(16,1,1) = {"
Tp
fk
fk
fk
fk
fk
fk
fk
fk
fk
fk
fk
fk
fk
fk
fk
fk
Tp
"}
(17,1,1) = {"
Tp
fk
fk
Tp
fk
fk
fk
Tp
fk
fk
Tp
fk
fk
fk
Tp
fk
fk
Tp
"}
