//MAP CONVERTED BY dmm2tgm.py THIS HEADER COMMENT PREVENTS RECONVERSION, DO NOT REMOVE
"a" = (
/turf/template_noop,
/area/template_noop)
"b" = (
/turf/closed/wall/mineral/titanium,
/area/shuttle/arrival)
"c" = (
/obj/structure/fans/tiny,
/obj/effect/turf_decal/stripes/line,
/obj/effect/turf_decal/stripes/line{
	dir = 1
	},
/obj/machinery/door/airlock/shuttle{
	name = "Arrival Shuttle Airlock"
	},
/turf/open/floor/mineral/plastitanium,
/area/shuttle/arrival)
"d" = (
/obj/structure/window/shuttle,
/obj/structure/grille,
/turf/open/floor/plating,
/area/shuttle/arrival)
"e" = (
/obj/item/clothing/suit/hazardvest{
	desc = "A high-visibility lifejacket complete with whistle and slot for oxygen tanks.";
	name = "emergency lifejacket"
	},
/obj/item/clothing/suit/hazardvest{
	desc = "A high-visibility lifejacket complete with whistle and slot for oxygen tanks.";
	name = "emergency lifejacket"
	},
/obj/item/tank/internals/emergency_oxygen{
	pixel_x = 3
	},
/obj/item/tank/internals/emergency_oxygen{
	pixel_x = 3
	},
/obj/item/clothing/mask/breath{
	pixel_x = -3;
	pixel_y = -3
	},
/obj/item/clothing/mask/breath{
	pixel_x = -3;
	pixel_y = -3
	},
/obj/item/clothing/head/hardhat/orange{
	name = "protective hat";
	pixel_y = 9
	},
/obj/item/clothing/head/hardhat/orange{
	name = "protective hat";
	pixel_y = 9
	},
/obj/structure/closet/crate/internals,
/obj/effect/turf_decal/delivery,
/turf/open/floor/mineral/plastitanium,
/area/shuttle/arrival)
"f" = (
/obj/structure/chair/comfy/shuttle{
	dir = 1
	},
/obj/effect/turf_decal/bot,
/turf/open/floor/mineral/plastitanium,
/area/shuttle/arrival)
"g" = (
/obj/effect/turf_decal/stripes/corner{
	dir = 8
	},
/obj/effect/turf_decal/stripes/line{
	dir = 4
	},
/turf/open/floor/mineral/titanium/white,
/area/shuttle/arrival)
"h" = (
/obj/structure/chair/comfy/shuttle,
/obj/effect/turf_decal/bot,
/turf/open/floor/mineral/plastitanium,
/area/shuttle/arrival)
"i" = (
/obj/effect/turf_decal/stripes/line,
/turf/open/floor/mineral/titanium/white,
/area/shuttle/arrival)
"j" = (
/obj/effect/turf_decal/stripes/line{
	dir = 8
	},
/obj/effect/turf_decal/stripes/line{
	dir = 4
	},
/turf/open/floor/mineral/titanium/white,
/area/shuttle/arrival)
"k" = (
/turf/closed/wall/mineral/titanium/nodiagonal,
/area/shuttle/arrival)
"l" = (
/obj/machinery/light{
	dir = 1;
	use_power = 0
	},
/obj/structure/chair/comfy/shuttle,
/obj/effect/turf_decal/bot,
/turf/open/floor/mineral/plastitanium,
/area/shuttle/arrival)
"m" = (
/obj/structure/window/shuttle,
/obj/structure/grille,
/obj/structure/shuttle/engine/heater{
	dir = 4
	},
/obj/structure/sign/warning/fire,
/turf/open/floor/plating,
/area/shuttle/arrival)
"n" = (
/obj/structure/shuttle/engine/propulsion/burst/right{
	dir = 4
	},
/obj/effect/turf_decal/stripes/line{
	dir = 4
	},
/turf/open/floor/plating/airless,
/area/shuttle/arrival)
"o" = (
/obj/effect/turf_decal/stripes/end{
	dir = 8
	},
/turf/open/floor/mineral/titanium/white,
/area/shuttle/arrival)
"p" = (
/obj/machinery/light{
	dir = 4;
	icon_state = "tube";
	use_power = 0
	},
/obj/effect/turf_decal/bot,
/obj/structure/chair/comfy/shuttle,
/turf/open/floor/mineral/plastitanium,
/area/shuttle/arrival)
"q" = (
/turf/closed/wall/mineral/plastitanium,
/area/shuttle/arrival)
"r" = (
/obj/effect/turf_decal/stripes/line{
	dir = 1
	},
/turf/open/floor/mineral/titanium/white,
/area/shuttle/arrival)
"s" = (
/obj/structure/shuttle/engine/propulsion{
	dir = 4
	},
/obj/effect/turf_decal/stripes/line{
	dir = 4
	},
/turf/open/floor/plating/airless,
/area/shuttle/arrival)
"t" = (
/obj/effect/turf_decal/delivery,
/obj/machinery/door/airlock/shuttle{
	name = "Arrival Shuttle Airlock"
	},
/turf/open/floor/mineral/plastitanium,
/area/shuttle/arrival)
"u" = (
/obj/structure/shuttle/engine/propulsion{
	dir = 4
	},
/obj/docking_port/mobile/arrivals,
/obj/effect/turf_decal/stripes/line{
	dir = 4
	},
/turf/open/floor/plating/airless,
/area/shuttle/arrival)
"v" = (
/obj/effect/turf_decal/bot,
/obj/structure/chair/comfy/shuttle,
/turf/open/floor/mineral/plastitanium,
/area/shuttle/arrival)
"w" = (
/obj/effect/turf_decal/bot,
/obj/structure/chair/comfy/shuttle{
	dir = 1
	},
/turf/open/floor/mineral/plastitanium,
/area/shuttle/arrival)
"x" = (
/obj/structure/flora/ausbushes/grassybush,
/obj/structure/flora/ausbushes/lavendergrass,
/obj/structure/flora/ausbushes/ywflowers,
/obj/structure/flora/ausbushes/fernybush,
/obj/structure/window/shuttle,
/turf/open/floor/grass,
/area/shuttle/arrival)
"y" = (
/obj/structure/extinguisher_cabinet{
	pixel_x = 27
	},
/obj/machinery/light{
	dir = 4;
	icon_state = "tube";
	use_power = 0
	},
/obj/effect/turf_decal/bot,
/obj/structure/chair/comfy/shuttle{
	dir = 1
	},
/turf/open/floor/mineral/plastitanium,
/area/shuttle/arrival)
"z" = (
/obj/item/radio/intercom{
	name = "Station Intercom (General)";
	pixel_y = -29
	},
/obj/machinery/light{
	use_power = 0
	},
/obj/structure/chair/comfy/shuttle{
	dir = 1
	},
/obj/effect/turf_decal/bot,
/turf/open/floor/mineral/plastitanium,
/area/shuttle/arrival)
"A" = (
/obj/structure/shuttle/engine/propulsion/burst/left{
	dir = 4
	},
/obj/effect/turf_decal/stripes/line{
	dir = 4
	},
/turf/open/floor/plating/airless,
/area/shuttle/arrival)
"B" = (
/obj/machinery/light{
	use_power = 0
	},
/obj/structure/chair/comfy/shuttle{
	dir = 1
	},
/obj/effect/turf_decal/bot,
/turf/open/floor/mineral/plastitanium,
/area/shuttle/arrival)
"C" = (
/obj/structure/sign/nanotrasen,
/turf/closed/wall/mineral/titanium/nodiagonal,
/area/shuttle/arrival)
"D" = (
/obj/effect/turf_decal/stripes/line{
	dir = 4
	},
/obj/effect/turf_decal/stripes/line{
	dir = 8
	},
/turf/open/floor/mineral/titanium/white,
/area/shuttle/arrival)
"E" = (
/obj/structure/table,
/obj/item/storage/toolbox/emergency,
/obj/item/crowbar/red,
/turf/open/floor/mineral/plastitanium,
/area/shuttle/arrival)
"H" = (
/obj/effect/turf_decal/stripes/corner{
	dir = 4
	},
/obj/effect/turf_decal/stripes/line{
	dir = 8
	},
/turf/open/floor/mineral/titanium/white,
/area/shuttle/arrival)
"I" = (
/obj/effect/turf_decal/stripes/corner{
	dir = 1
	},
/obj/effect/turf_decal/stripes/line{
	dir = 4
	},
/turf/open/floor/mineral/titanium/white,
/area/shuttle/arrival)
"L" = (
/obj/machinery/vending/wallmed{
	use_power = 0
	},
/turf/closed/wall/mineral/titanium/nodiagonal,
/area/shuttle/arrival)
"M" = (
/obj/structure/window/shuttle,
/obj/structure/grille,
/obj/structure/shuttle/engine/heater{
	dir = 4
	},
/turf/open/floor/plating,
/area/shuttle/arrival)
"N" = (
/obj/machinery/requests_console{
	department = "Arrival shuttle";
	name = "Arrivals Shuttle console"
	},
/turf/closed/wall/mineral/titanium/nodiagonal,
/area/shuttle/arrival)
"O" = (
/obj/effect/turf_decal/stripes/end{
	dir = 4
	},
/obj/effect/light_emitter{
	light_range = 3;
	set_cap = 1;
	set_luminosity = 4
	},
/turf/open/floor/mineral/titanium/white,
/area/shuttle/arrival)
"Q" = (
/obj/effect/turf_decal/stripes/corner,
/obj/effect/turf_decal/stripes/line{
	dir = 8
	},
/turf/open/floor/mineral/titanium/white,
/area/shuttle/arrival)
"R" = (
/obj/structure/table,
/obj/item/flashlight{
	pixel_y = 8
	},
/obj/item/flashlight,
/obj/item/radio/intercom/directional/west,
/turf/open/floor/mineral/plastitanium,
/area/shuttle/arrival)
"S" = (
/obj/effect/turf_decal/stripes/line{
	dir = 4
	},
/turf/open/floor/mineral/titanium/white,
/area/shuttle/arrival)
"U" = (
/obj/structure/sign/nanotrasen,
/turf/closed/wall/mineral/titanium,
/area/shuttle/arrival)
"Y" = (
/obj/effect/light_emitter{
	light_range = 3;
	set_cap = 1;
	set_luminosity = 4
	},
/turf/open/floor/mineral/titanium/white,
/area/shuttle/arrival)
"Z" = (
/obj/effect/turf_decal/stripes/corner{
	dir = 1
	},
/obj/effect/turf_decal/stripes/corner{
	dir = 8
	},
/turf/open/floor/mineral/titanium/white,
/area/shuttle/arrival)

(1,1,1) = {"
a
b
d
d
d
b
a
"}
(2,1,1) = {"
a
b
v
o
w
b
a
"}
(3,1,1) = {"
b
U
p
O
y
U
b
"}
(4,1,1) = {"
k
b
b
t
b
b
k
"}
(5,1,1) = {"
U
e
R
o
E
e
U
"}
(6,1,1) = {"
c
D
H
Z
Q
D
c
"}
(7,1,1) = {"
b
l
r
Y
i
B
b
"}
(8,1,1) = {"
d
h
r
N
i
f
d
"}
(9,1,1) = {"
d
h
r
x
i
f
d
"}
(10,1,1) = {"
d
h
r
x
i
f
d
"}
(11,1,1) = {"
d
h
r
L
i
f
d
"}
(12,1,1) = {"
b
l
r
Y
i
z
b
"}
(13,1,1) = {"
c
j
I
S
g
j
c
"}
(14,1,1) = {"
C
m
M
M
M
m
C
"}
(15,1,1) = {"
q
n
s
u
s
A
q
"}
