//MAP CONVERTED BY dmm2tgm.py THIS HEADER COMMENT PREVENTS RECONVERSION, DO NOT REMOVE
"a" = (
/obj/effect/turf_decal/stripes/line,
/turf/open/floor/mineral/plastitanium/red,
/area/shuttle/assault_pod)
"b" = (
/obj/machinery/porta_turret/syndicate/pod,
/turf/closed/wall/mineral/plastitanium,
/area/shuttle/assault_pod)
"c" = (
/obj/structure/chair/comfy/shuttle{
	dir = 4
	},
/obj/effect/turf_decal/stripes/line{
	dir = 9
	},
/turf/open/floor/mineral/plastitanium/red,
/area/shuttle/assault_pod)
"d" = (
/turf/closed/wall/mineral/plastitanium,
/area/shuttle/assault_pod)
"e" = (
/obj/machinery/door/airlock/centcom{
	aiControlDisabled = 1;
	name = "Assault Pod";
	req_access_txt = "150"
	},
/obj/docking_port/mobile/assault_pod{
	name = "steel rain";
	port_direction = 4;
	preferred_direction = 4
	},
/obj/structure/fans/tiny,
/turf/open/floor/plating,
/area/shuttle/assault_pod)
"f" = (
/obj/structure/chair/comfy/shuttle{
	dir = 8
	},
/obj/effect/turf_decal/bot,
/turf/open/floor/mineral/plastitanium/red,
/area/shuttle/assault_pod)
"h" = (
/obj/machinery/computer/shuttle_flight/syndicate/drop_pod,
/turf/closed/wall/mineral/plastitanium,
/area/shuttle/assault_pod)
"i" = (
/obj/effect/turf_decal/stripes/line{
	dir = 8
	},
/turf/open/floor/mineral/plastitanium/red,
/area/shuttle/assault_pod)
"j" = (
/obj/effect/turf_decal/stripes/corner{
	dir = 1
	},
/turf/open/floor/mineral/plastitanium/red,
/area/shuttle/assault_pod)
"p" = (
/obj/effect/turf_decal/stripes/line{
	dir = 1
	},
/turf/open/floor/mineral/plastitanium/red,
/area/shuttle/assault_pod)
"t" = (
/obj/machinery/door/airlock/centcom{
	aiControlDisabled = 1;
	name = "Assault Pod";
	req_access_txt = "150"
	},
/obj/structure/fans/tiny,
/turf/open/floor/plating,
/area/shuttle/assault_pod)
"w" = (
/obj/effect/turf_decal/stripes/corner{
	dir = 8
	},
/turf/open/floor/mineral/plastitanium/red,
/area/shuttle/assault_pod)
"z" = (
/obj/structure/chair/comfy/shuttle{
	dir = 8
	},
/obj/effect/turf_decal/stripes/line{
	dir = 6
	},
/turf/open/floor/mineral/plastitanium/red,
/area/shuttle/assault_pod)
"A" = (
/obj/structure/chair/comfy/shuttle{
	dir = 4
	},
/obj/effect/turf_decal/bot,
/turf/open/floor/mineral/plastitanium/red,
/area/shuttle/assault_pod)
"B" = (
/obj/effect/turf_decal/stripes/line{
	dir = 4
	},
/turf/open/floor/mineral/plastitanium/red,
/area/shuttle/assault_pod)
"D" = (
/obj/structure/chair/comfy/shuttle,
/obj/machinery/light{
	dir = 1
	},
/obj/effect/turf_decal/bot,
/turf/open/floor/mineral/plastitanium/red,
/area/shuttle/assault_pod)
"E" = (
/obj/effect/turf_decal/stripes/corner,
/turf/open/floor/mineral/plastitanium/red,
/area/shuttle/assault_pod)
"F" = (
/obj/structure/chair/comfy/shuttle{
	dir = 4
	},
/obj/effect/turf_decal/stripes/line{
	dir = 10
	},
/turf/open/floor/mineral/plastitanium/red,
/area/shuttle/assault_pod)
"H" = (
/obj/structure/chair/comfy/shuttle{
	dir = 8
	},
/obj/effect/turf_decal/stripes/line{
	dir = 5
	},
/turf/open/floor/mineral/plastitanium/red,
/area/shuttle/assault_pod)
"I" = (
/obj/machinery/shuttle/engine/void{
	dir = 8
	},
/turf/closed/wall/mineral/plastitanium,
/area/shuttle/assault_pod)
"L" = (
/obj/structure/chair/comfy/shuttle{
	dir = 1
	},
/obj/machinery/light,
/obj/effect/turf_decal/bot,
/turf/open/floor/mineral/plastitanium/red,
/area/shuttle/assault_pod)
"O" = (
/obj/effect/turf_decal/stripes/corner{
	dir = 4
	},
/turf/open/floor/mineral/plastitanium/red,
/area/shuttle/assault_pod)
"R" = (
/obj/machinery/door/airlock/centcom{
	name = "Assault Pod";
	req_access_txt = "150"
	},
/obj/structure/fans/tiny,
/turf/open/floor/plating,
/area/shuttle/assault_pod)
"U" = (
/obj/machinery/shuttle/engine/void{
	dir = 1
	},
/turf/closed/wall/mineral/plastitanium,
/area/shuttle/assault_pod)
"V" = (
/turf/template_noop,
/area/template_noop)
"X" = (
/obj/machinery/shuttle/engine/void,
/turf/closed/wall/mineral/plastitanium,
/area/shuttle/assault_pod)
"Z" = (
/obj/machinery/shuttle/engine/void{
	dir = 4
	},
/turf/closed/wall/mineral/plastitanium,
/area/shuttle/assault_pod)

(1,1,1) = {"
V
b
Z
t
Z
b
V
"}
(2,1,1) = {"
b
d
c
i
F
d
b
"}
(3,1,1) = {"
X
c
j
f
w
F
U
"}
(4,1,1) = {"
R
p
L
h
D
a
e
"}
(5,1,1) = {"
X
H
O
A
E
z
U
"}
(6,1,1) = {"
b
d
H
B
z
d
b
"}
(7,1,1) = {"
V
b
I
t
I
b
V
"}
