//MAP CONVERTED BY dmm2tgm.py THIS HEADER COMMENT PREVENTS RECONVERSION, DO NOT REMOVE
"a" = (
/turf/open/floor/mineral/titanium,
/area/shuttle/supply)
"b" = (
/turf/closed/wall/mineral/titanium,
/area/shuttle/supply)
"c" = (
/obj/machinery/conveyor{
	dir = 10;
	id = "Cargo_Shuttle_Conveyor";
	name = "Cargo Shuttle conveyor belt"
	},
/turf/open/floor/mineral/titanium/blue,
/area/shuttle/supply)
"d" = (
/obj/machinery/conveyor{
	dir = 4;
	id = "Cargo_Shuttle_Conveyor";
	name = "Cargo Shuttle conveyor belt"
	},
/turf/open/floor/mineral/titanium/blue,
/area/shuttle/supply)
"e" = (
/obj/machinery/conveyor{
	dir = 6;
	id = "Cargo_Shuttle_Conveyor";
	movedir = 2;
	name = "Cargo Shuttle conveyor belt"
	},
/turf/open/floor/mineral/titanium/blue,
/area/shuttle/supply)
"f" = (
/obj/machinery/conveyor{
	dir = 4;
	id = "QMLoad2"
	},
/obj/machinery/door/poddoor{
	id = "QMLoaddoor2";
	name = "supply dock loading door"
	},
/turf/open/floor/mineral/titanium,
/area/shuttle/supply)
"g" = (
/obj/machinery/door/airlock/titanium{
	name = "Supply Shuttle Airlock";
	req_access_txt = "31"
	},
/turf/open/floor/mineral/titanium,
/area/shuttle/supply)
"h" = (
/obj/structure/window/reinforced{
	dir = 1
	},
/obj/structure/window/plasma/reinforced{
	dir = 8
	},
/obj/structure/window/plasma/reinforced{
	dir = 4
	},
/obj/machinery/atmospherics/components/binary/pump{
	dir = 1;
	name = "Микс в Дистрибуцию"
	},
/obj/machinery/meter{
	name = "Mixed Air Tank Out"
	},
/turf/open/floor/plating/airless,
/area/shuttle/supply)
"i" = (
/obj/machinery/door/airlock/titanium{
	name = "Supply Shuttle Airlock";
	req_access_txt = "31"
	},
/obj/docking_port/mobile/supply,
/turf/open/floor/mineral/titanium,
/area/shuttle/supply)
"j" = (
/obj/machinery/conveyor{
	dir = 8;
	id = "QMLoad"
	},
/obj/machinery/door/poddoor{
	id = "QMLoaddoor";
	name = "supply dock loading door"
	},
/turf/open/floor/mineral/titanium,
/area/shuttle/supply)
"k" = (
/obj/structure/window/plasma/reinforced,
/obj/machinery/atmospherics/components/unary/passive_vent,
/obj/machinery/conveyor{
	dir = 8;
	id = "Cargo_Shuttle_Conveyor";
	name = "Cargo Shuttle conveyor belt"
	},
/turf/open/floor/mineral/titanium/blue,
/area/shuttle/supply)
"l" = (
/obj/machinery/light{
	dir = 8
	},
/obj/machinery/conveyor{
	dir = 9;
	id = "Cargo_Shuttle_Conveyor";
	movedir = 1;
	name = "Cargo Shuttle conveyor belt"
	},
/turf/open/floor/mineral/titanium/blue,
/area/shuttle/supply)
"m" = (
/obj/structure/window/plasma/reinforced,
/obj/structure/window/plasma/reinforced{
	dir = 8
	},
/obj/structure/window/plasma/reinforced{
	dir = 4
	},
/obj/machinery/atmospherics/components/unary/tank/air{
	dir = 1
	},
/turf/open/floor/plating/airless,
/area/shuttle/supply)
"n" = (
/obj/machinery/button/door{
	id = "QMLoaddoor2";
	name = "Loading Doors";
	pixel_x = 24;
	pixel_y = 8
	},
/obj/machinery/button/door{
	id = "QMLoaddoor";
	name = "Loading Doors";
	pixel_x = 24;
	pixel_y = -8
	},
/obj/machinery/light{
	dir = 4
	},
/obj/machinery/conveyor_switch/oneway{
	dir = 8;
	id = "Cargo_Shuttle_Conveyor"
	},
/obj/item/conv_printer,
/obj/item/export_scanner,
/turf/open/floor/mineral/titanium,
/area/shuttle/supply)
"q" = (
/obj/structure/window/reinforced{
	dir = 1
	},
/obj/structure/shuttle/engine/heater,
/turf/open/floor/plating/airless,
/area/shuttle/supply)
"r" = (
/obj/machinery/light{
	dir = 1
	},
/obj/machinery/computer/cargo{
	dir = 8
	},
/turf/open/floor/mineral/titanium/blue,
/area/shuttle/supply)
"s" = (
/turf/template_noop,
/area/template_noop)
"t" = (
/obj/structure/shuttle/engine/propulsion/burst/left,
/turf/open/floor/plating/airless,
/area/shuttle/supply)
"u" = (
/obj/structure/shuttle/engine/propulsion,
/turf/open/floor/plating/airless,
/area/shuttle/supply)
"v" = (
/obj/structure/shuttle/engine/propulsion/burst/right,
/turf/open/floor/plating/airless,
/area/shuttle/supply)
"w" = (
/obj/machinery/computer/shuttle{
	dir = 4
	},
/turf/open/floor/mineral/titanium/blue,
/area/shuttle/supply)
"x" = (
/obj/structure/chair/comfy/shuttle{
	dir = 1
	},
/turf/open/floor/mineral/titanium,
/area/shuttle/supply)
"y" = (
/obj/machinery/conveyor{
	dir = 5;
	id = "Cargo_Shuttle_Conveyor";
	movedir = 4;
	name = "Cargo Shuttle conveyor belt"
	},
/turf/open/floor/mineral/titanium/blue,
/area/shuttle/supply)
"B" = (
/obj/machinery/conveyor{
	id = "Cargo_Shuttle_Conveyor";
	name = "Cargo Shuttle conveyor belt"
	},
/turf/open/floor/mineral/titanium/blue,
/area/shuttle/supply)
"C" = (
/obj/machinery/conveyor{
	dir = 1;
	id = "Cargo_Shuttle_Conveyor";
	name = "Cargo Shuttle conveyor belt"
	},
/turf/open/floor/mineral/titanium/blue,
/area/shuttle/supply)
"D" = (
/obj/machinery/conveyor{
	dir = 9;
	id = "Cargo_Shuttle_Conveyor";
	movedir = 1;
	name = "Cargo Shuttle conveyor belt"
	},
/turf/open/floor/mineral/titanium/blue,
/area/shuttle/supply)
"E" = (
/obj/machinery/conveyor{
	dir = 8;
	id = "Cargo_Shuttle_Conveyor";
	name = "Cargo Shuttle conveyor belt"
	},
/turf/open/floor/mineral/titanium/blue,
/area/shuttle/supply)

(1,1,1) = {"
b
b
b
b
b
b
b
b
b
b
b
s
"}
(2,1,1) = {"
b
w
y
D
y
l
y
D
y
D
b
t
"}
(3,1,1) = {"
b
x
d
E
d
E
d
E
d
E
q
u
"}
(4,1,1) = {"
b
r
d
E
d
E
d
E
d
k
h
m
"}
(5,1,1) = {"
b
y
C
E
C
E
C
E
C
E
q
u
"}
(6,1,1) = {"
b
e
B
d
a
n
a
B
B
c
b
v
"}
(7,1,1) = {"
b
b
b
f
g
b
i
j
b
b
b
s
"}
