//MAP CONVERTED BY dmm2tgm.py THIS HEADER COMMENT PREVENTS RECONVERSION, DO NOT REMOVE
"aa" = (
/turf/template_noop,
/area/template_noop)
"ab" = (
/obj/effect/turf_decal/stripes/line{
	dir = 6
	},
/obj/structure/chair/office/light,
/obj/structure/sink{
	dir = 8;
	pixel_x = 11
	},
/turf/open/floor/mineral/titanium/blue,
/area/shuttle/escape)
"ac" = (
/obj/effect/turf_decal/stripes/corner{
	dir = 4
	},
/turf/open/floor/mineral/titanium/blue,
/area/shuttle/escape)
"ad" = (
/turf/closed/wall/mineral/titanium,
/area/shuttle/escape)
"ae" = (
/obj/structure/sign/nanotrasen,
/turf/closed/wall/mineral/titanium/interior,
/area/shuttle/escape)
"af" = (
/obj/structure/table/reinforced,
/obj/item/storage/toolbox/mechanical,
/obj/item/radio,
/turf/open/floor/mineral/plastitanium,
/area/shuttle/escape)
"ag" = (
/obj/effect/turf_decal/bot,
/obj/machinery/computer/communications,
/turf/open/floor/mineral/plastitanium,
/area/shuttle/escape)
"ah" = (
/obj/effect/turf_decal/bot,
/obj/machinery/computer/emergency_shuttle,
/turf/open/floor/mineral/plastitanium,
/area/shuttle/escape)
"ai" = (
/obj/structure/table/reinforced,
/obj/item/storage/firstaid/o2{
	pixel_x = 4;
	pixel_y = 4
	},
/obj/item/storage/firstaid/regular,
/obj/item/crowbar,
/turf/open/floor/mineral/plastitanium,
/area/shuttle/escape)
"al" = (
/obj/structure/chair/comfy/shuttle{
	dir = 4
	},
/obj/machinery/keycard_auth{
	pixel_x = -24
	},
/obj/effect/turf_decal/bot,
/turf/open/floor/mineral/plastitanium,
/area/shuttle/escape)
"am" = (
/obj/structure/sign/departments/medbay/alt,
/turf/closed/wall/mineral/titanium,
/area/shuttle/escape)
"an" = (
/turf/open/floor/mineral/titanium/blue,
/area/shuttle/escape)
"ao" = (
/obj/structure/chair/comfy/shuttle{
	dir = 4
	},
/obj/effect/turf_decal/bot,
/turf/open/floor/mineral/plastitanium,
/area/shuttle/escape)
"ap" = (
/obj/structure/chair/comfy/shuttle{
	dir = 8
	},
/obj/machinery/keycard_auth{
	pixel_x = 24
	},
/obj/effect/turf_decal/bot,
/turf/open/floor/mineral/plastitanium,
/area/shuttle/escape)
"aq" = (
/obj/structure/table/reinforced,
/obj/machinery/recharger,
/turf/open/floor/mineral/plastitanium,
/area/shuttle/escape)
"ar" = (
/obj/effect/turf_decal/stripes/line{
	dir = 10
	},
/obj/item/kirbyplants{
	icon_state = "plant-22"
	},
/turf/open/floor/mineral/plastitanium,
/area/shuttle/escape)
"as" = (
/obj/effect/turf_decal/stripes/line,
/obj/machinery/light,
/obj/item/kirbyplants{
	icon_state = "applebush"
	},
/turf/open/floor/mineral/plastitanium,
/area/shuttle/escape)
"at" = (
/obj/effect/turf_decal/stripes/line,
/turf/open/floor/mineral/plastitanium,
/area/shuttle/escape)
"au" = (
/obj/structure/table/reinforced,
/obj/item/clipboard,
/obj/item/restraints/handcuffs,
/obj/item/tank/internals/emergency_oxygen/engi,
/obj/item/tank/internals/emergency_oxygen/engi,
/obj/item/assembly/flash/handheld,
/turf/open/floor/mineral/plastitanium,
/area/shuttle/escape)
"ay" = (
/obj/effect/turf_decal/stripes/line{
	dir = 8
	},
/obj/effect/turf_decal/stripes/corner{
	dir = 1
	},
/turf/open/floor/mineral/titanium/white,
/area/shuttle/escape)
"az" = (
/obj/machinery/status_display/evac,
/turf/closed/wall/mineral/titanium,
/area/shuttle/escape)
"aA" = (
/obj/effect/turf_decal/stripes/line{
	dir = 1
	},
/obj/structure/chair/comfy/shuttle,
/turf/open/floor/mineral/plastitanium/red/brig,
/area/shuttle/escape/brig)
"aB" = (
/obj/structure/window/shuttle,
/obj/structure/grille,
/turf/open/floor/plating,
/area/shuttle/escape)
"aC" = (
/obj/effect/turf_decal/stripes/line{
	dir = 1
	},
/obj/effect/turf_decal/stripes/line,
/turf/open/floor/mineral/titanium/yellow,
/area/shuttle/escape)
"aD" = (
/obj/machinery/suit_storage_unit/standard_unit,
/obj/effect/turf_decal/bot,
/obj/effect/turf_decal/stripes/line{
	dir = 10
	},
/turf/open/floor/mineral/plastitanium,
/area/shuttle/escape)
"aE" = (
/obj/machinery/suit_storage_unit/standard_unit,
/obj/effect/turf_decal/bot,
/obj/effect/turf_decal/stripes/line{
	dir = 6
	},
/turf/open/floor/mineral/plastitanium,
/area/shuttle/escape)
"aF" = (
/obj/effect/turf_decal/stripes/line{
	dir = 8
	},
/obj/structure/chair/comfy/shuttle{
	dir = 4
	},
/obj/machinery/light{
	dir = 8
	},
/turf/open/floor/mineral/plastitanium/red/brig,
/area/shuttle/escape/brig)
"aG" = (
/turf/open/floor/mineral/plastitanium/red/brig,
/area/shuttle/escape/brig)
"aH" = (
/obj/effect/turf_decal/stripes/corner{
	dir = 4
	},
/obj/effect/turf_decal/stripes/corner,
/turf/open/floor/mineral/plastitanium/red/brig,
/area/shuttle/escape/brig)
"aI" = (
/obj/machinery/door/airlock/shuttle{
	name = "Emergency Shuttle Airlock"
	},
/obj/structure/fans/tiny,
/obj/effect/turf_decal/stripes/line{
	dir = 8
	},
/obj/effect/turf_decal/stripes/line{
	dir = 4
	},
/turf/open/floor/mineral/plastitanium/red/brig,
/area/shuttle/escape/brig)
"aJ" = (
/obj/effect/turf_decal/stripes/line,
/obj/structure/chair/comfy/shuttle{
	dir = 1
	},
/turf/open/floor/mineral/plastitanium/red/brig,
/area/shuttle/escape/brig)
"aK" = (
/obj/structure/chair/comfy/shuttle{
	dir = 1
	},
/obj/effect/turf_decal/bot,
/turf/open/floor/mineral/plastitanium,
/area/shuttle/escape)
"aM" = (
/obj/effect/turf_decal/stripes/line{
	dir = 8
	},
/obj/effect/turf_decal/stripes/line{
	dir = 4
	},
/turf/open/floor/mineral/titanium/yellow,
/area/shuttle/escape)
"aP" = (
/obj/machinery/door/airlock/shuttle{
	name = "Emergency Shuttle Airlock"
	},
/obj/docking_port/mobile/emergency{
	name = "Box emergency shuttle"
	},
/obj/structure/fans/tiny,
/obj/effect/turf_decal/stripes/line{
	dir = 4
	},
/obj/effect/turf_decal/stripes/line{
	dir = 8
	},
/turf/open/floor/mineral/plastitanium,
/area/shuttle/escape)
"aQ" = (
/obj/effect/turf_decal/stripes/corner{
	dir = 8
	},
/obj/effect/turf_decal/stripes/corner,
/obj/effect/turf_decal/stripes/corner{
	dir = 4
	},
/obj/effect/turf_decal/stripes/corner{
	dir = 1
	},
/turf/open/floor/mineral/titanium/white,
/area/shuttle/escape)
"aR" = (
/obj/effect/turf_decal/delivery,
/obj/effect/turf_decal/stripes/corner{
	dir = 1
	},
/obj/machinery/stasis,
/turf/open/floor/mineral/plastitanium,
/area/shuttle/escape)
"aS" = (
/obj/effect/turf_decal/bot,
/obj/structure/chair/comfy/shuttle,
/turf/open/floor/mineral/plastitanium,
/area/shuttle/escape)
"aT" = (
/obj/effect/turf_decal/stripes/line{
	dir = 1
	},
/obj/effect/turf_decal/stripes/corner{
	dir = 8
	},
/turf/open/floor/mineral/titanium/white,
/area/shuttle/escape)
"aV" = (
/obj/machinery/door/airlock/shuttle{
	name = "Emergency Shuttle Airlock"
	},
/obj/structure/fans/tiny,
/obj/effect/turf_decal/stripes/line{
	dir = 4
	},
/obj/effect/turf_decal/stripes/line{
	dir = 8
	},
/turf/open/floor/mineral/plastitanium,
/area/shuttle/escape)
"aW" = (
/obj/effect/turf_decal/stripes/line,
/obj/effect/turf_decal/stripes/corner{
	dir = 1
	},
/turf/open/floor/mineral/titanium/white,
/area/shuttle/escape)
"aX" = (
/obj/machinery/door/airlock/shuttle{
	name = "Emergency Shuttle Airlock"
	},
/obj/effect/turf_decal/stripes/line,
/obj/effect/turf_decal/stripes/line{
	dir = 1
	},
/turf/open/floor/mineral/plastitanium,
/area/shuttle/escape)
"aZ" = (
/obj/effect/turf_decal/stripes/line{
	dir = 8
	},
/turf/open/floor/mineral/titanium/blue,
/area/shuttle/escape)
"bb" = (
/turf/open/floor/mineral/titanium/yellow,
/area/shuttle/escape)
"bc" = (
/obj/structure/closet/crate{
	name = "emergency supplies crate"
	},
/obj/item/storage/toolbox/emergency,
/obj/item/storage/toolbox/emergency,
/obj/item/flashlight/flare{
	pixel_x = 3;
	pixel_y = 3
	},
/obj/item/flashlight/flare{
	pixel_x = -6;
	pixel_y = -2
	},
/obj/item/crowbar,
/obj/item/wrench,
/obj/item/radio,
/obj/effect/turf_decal/bot,
/obj/item/radio/intercom/directional/north,
/turf/open/floor/mineral/plastitanium,
/area/shuttle/escape)
"bd" = (
/obj/effect/turf_decal/stripes/line{
	dir = 4
	},
/turf/open/floor/mineral/titanium/blue,
/area/shuttle/escape)
"bf" = (
/obj/item/clothing/suit/hazardvest{
	desc = "A high-visibility lifejacket complete with whistle and slot for oxygen tanks.";
	name = "emergency lifejacket"
	},
/obj/item/clothing/suit/hazardvest{
	desc = "A high-visibility lifejacket complete with whistle and slot for oxygen tanks.";
	name = "emergency lifejacket"
	},
/obj/item/tank/internals/emergency_oxygen{
	pixel_x = 3
	},
/obj/item/tank/internals/emergency_oxygen{
	pixel_x = 3
	},
/obj/item/clothing/mask/breath{
	pixel_x = -3;
	pixel_y = -3
	},
/obj/item/clothing/mask/breath{
	pixel_x = -3;
	pixel_y = -3
	},
/obj/item/clothing/head/hardhat/orange{
	name = "protective hat";
	pixel_y = 9
	},
/obj/item/clothing/head/hardhat/orange{
	name = "protective hat";
	pixel_y = 9
	},
/obj/structure/closet/crate/internals,
/obj/effect/turf_decal/delivery,
/turf/open/floor/mineral/plastitanium,
/area/shuttle/escape)
"bg" = (
/obj/effect/turf_decal/delivery,
/obj/machinery/recharge_station,
/turf/open/floor/mineral/plastitanium,
/area/shuttle/escape)
"bi" = (
/obj/structure/window/shuttle,
/obj/structure/grille,
/obj/structure/shuttle/engine/heater,
/turf/open/floor/plating,
/area/shuttle/escape)
"bj" = (
/obj/machinery/vending/wallmed{
	name = "Emergency NanoMed";
	use_power = 0
	},
/turf/closed/wall/mineral/titanium/nodiagonal,
/area/shuttle/escape)
"bk" = (
/obj/structure/shuttle/engine/propulsion,
/turf/open/floor/plating/airless,
/area/shuttle/escape)
"bl" = (
/obj/effect/turf_decal/loading_area,
/obj/effect/turf_decal/stripes/line,
/obj/effect/turf_decal/stripes/line{
	dir = 1
	},
/turf/open/floor/mineral/titanium/yellow,
/area/shuttle/escape)
"bm" = (
/obj/machinery/vending/wallmed{
	name = "Emergency NanoMed";
	use_power = 0
	},
/turf/closed/wall/mineral/titanium,
/area/shuttle/escape)
"bn" = (
/obj/effect/turf_decal/stripes/line,
/obj/effect/turf_decal/stripes/line{
	dir = 1
	},
/turf/open/floor/mineral/titanium/white,
/area/shuttle/escape)
"bo" = (
/obj/effect/turf_decal/stripes/line{
	dir = 1
	},
/obj/effect/turf_decal/stripes/line,
/turf/open/floor/mineral/titanium/white,
/area/shuttle/escape)
"bp" = (
/obj/effect/turf_decal/delivery,
/obj/machinery/door/airlock/shuttle{
	name = "External Shuttle Airlock"
	},
/obj/structure/fans/tiny,
/obj/effect/turf_decal/stripes/line{
	dir = 4
	},
/obj/structure/sign/warning/vacuum/external{
	pixel_y = 32
	},
/turf/open/floor/mineral/plastitanium,
/area/shuttle/escape)
"bq" = (
/obj/effect/turf_decal/stripes/line,
/turf/open/floor/mineral/titanium/yellow,
/area/shuttle/escape)
"br" = (
/obj/structure/closet/crate/medical,
/obj/item/storage/firstaid/regular,
/obj/item/storage/firstaid/o2{
	pixel_x = 3;
	pixel_y = 3
	},
/obj/item/storage/firstaid/toxin{
	pixel_x = -4;
	pixel_y = 3
	},
/obj/item/healthanalyzer{
	pixel_x = 3;
	pixel_y = 3
	},
/obj/item/lazarus_injector,
/obj/effect/turf_decal/bot,
/mob/living/simple_animal/bot/medbot{
	name = "\improper emergency medibot";
	pixel_x = -3;
	pixel_y = 2
	},
/obj/machinery/light{
	dir = 4
	},
/turf/open/floor/mineral/plastitanium,
/area/shuttle/escape)
"bs" = (
/obj/structure/table,
/obj/item/storage/firstaid/fire{
	pixel_x = 4;
	pixel_y = 4
	},
/obj/item/storage/firstaid/regular{
	pixel_x = 2;
	pixel_y = 2
	},
/obj/item/storage/firstaid/regular,
/turf/open/floor/mineral/plastitanium,
/area/shuttle/escape)
"bP" = (
/obj/machinery/computer/operating{
	dir = 1
	},
/obj/effect/turf_decal/bot,
/turf/open/floor/mineral/plastitanium,
/area/shuttle/escape)
"cJ" = (
/obj/effect/turf_decal/stripes/line{
	dir = 8
	},
/obj/effect/turf_decal/stripes/line{
	dir = 4
	},
/turf/open/floor/mineral/titanium/white,
/area/shuttle/escape)
"cT" = (
/obj/structure/sign/departments/engineering{
	pixel_y = 32
	},
/obj/effect/turf_decal/stripes/line,
/obj/effect/turf_decal/stripes/line{
	dir = 1
	},
/turf/open/floor/mineral/titanium/white,
/area/shuttle/escape)
"dn" = (
/obj/effect/turf_decal/delivery,
/obj/machinery/door/airlock/security/glass{
	name = "Holding Area";
	req_access_txt = "2"
	},
/turf/open/floor/mineral/plastitanium,
/area/shuttle/escape/brig)
"dw" = (
/obj/structure/extinguisher_cabinet,
/turf/closed/wall/mineral/titanium/nodiagonal,
/area/shuttle/escape)
"dz" = (
/obj/effect/turf_decal/stripes/line{
	dir = 9
	},
/obj/structure/table,
/obj/item/crowbar/red,
/obj/item/storage/lockbox/loyalty,
/turf/open/floor/mineral/plastitanium/red/brig,
/area/shuttle/escape/brig)
"ga" = (
/obj/structure/table,
/obj/item/circular_saw,
/obj/item/scalpel{
	pixel_y = 16
	},
/obj/item/hemostat,
/turf/open/floor/plasteel/dark,
/area/shuttle/escape)
"gk" = (
/obj/effect/turf_decal/stripes/line,
/obj/effect/turf_decal/stripes/line{
	dir = 1
	},
/obj/machinery/light{
	dir = 1
	},
/turf/open/floor/mineral/titanium/white,
/area/shuttle/escape)
"js" = (
/obj/structure/sign/warning/securearea,
/turf/closed/wall/mineral/titanium,
/area/shuttle/escape)
"kh" = (
/obj/effect/turf_decal/delivery,
/turf/open/floor/mineral/plastitanium,
/area/shuttle/escape)
"kH" = (
/obj/structure/rack,
/obj/item/storage/toolbox/electrical{
	pixel_x = -3;
	pixel_y = 1
	},
/obj/item/storage/toolbox/mechanical{
	pixel_y = -1
	},
/obj/item/storage/toolbox/emergency{
	pixel_x = 3;
	pixel_y = -5
	},
/obj/effect/turf_decal/bot,
/turf/open/floor/mineral/plastitanium,
/area/shuttle/escape)
"lY" = (
/obj/structure/chair/comfy/shuttle{
	dir = 8
	},
/obj/effect/turf_decal/bot,
/turf/open/floor/mineral/plastitanium,
/area/shuttle/escape)
"lZ" = (
/obj/effect/turf_decal/stripes/line{
	dir = 4
	},
/turf/open/floor/mineral/titanium/white,
/area/shuttle/escape)
"nV" = (
/obj/effect/turf_decal/stripes/corner,
/obj/effect/turf_decal/stripes/corner{
	dir = 8
	},
/turf/open/floor/mineral/plastitanium/red/brig,
/area/shuttle/escape/brig)
"oF" = (
/obj/effect/turf_decal/stripes/line{
	dir = 1
	},
/obj/effect/turf_decal/stripes/corner,
/obj/effect/turf_decal/stripes/corner{
	dir = 8
	},
/turf/open/floor/mineral/titanium/yellow,
/area/shuttle/escape)
"pm" = (
/obj/effect/turf_decal/delivery,
/obj/structure/reagent_dispensers/watertank,
/turf/open/floor/mineral/plastitanium,
/area/shuttle/escape)
"py" = (
/obj/effect/turf_decal/stripes/line{
	dir = 1
	},
/obj/effect/turf_decal/stripes/corner,
/turf/open/floor/mineral/titanium/white,
/area/shuttle/escape)
"qK" = (
/obj/machinery/status_display/ai,
/turf/closed/wall/mineral/titanium,
/area/shuttle/escape)
"qY" = (
/obj/structure/flora/ausbushes/grassybush,
/obj/structure/flora/ausbushes/lavendergrass,
/obj/structure/flora/ausbushes/ywflowers,
/obj/structure/flora/ausbushes/fernybush,
/obj/structure/window/shuttle,
/turf/open/floor/grass,
/area/shuttle/escape)
"qZ" = (
/obj/structure/table/optable,
/obj/effect/turf_decal/bot,
/obj/machinery/light{
	dir = 4
	},
/obj/item/surgical_drapes,
/turf/open/floor/mineral/plastitanium,
/area/shuttle/escape)
"rm" = (
/obj/structure/sign/nanotrasen,
/turf/closed/wall/mineral/titanium,
/area/shuttle/escape)
"tP" = (
/obj/structure/sign/departments/security{
	pixel_y = 32
	},
/obj/effect/turf_decal/stripes/line,
/obj/effect/turf_decal/stripes/line{
	dir = 1
	},
/turf/open/floor/mineral/titanium/white,
/area/shuttle/escape)
"tS" = (
/obj/structure/flora/ausbushes/grassybush,
/obj/structure/flora/ausbushes/lavendergrass,
/obj/structure/flora/ausbushes/brflowers,
/obj/structure/flora/ausbushes/leafybush,
/obj/structure/window/shuttle,
/turf/open/floor/grass,
/area/shuttle/escape)
"tV" = (
/obj/effect/turf_decal/stripes/line{
	dir = 1
	},
/obj/effect/turf_decal/stripes/line,
/obj/machinery/light,
/turf/open/floor/mineral/titanium/white,
/area/shuttle/escape)
"uB" = (
/obj/item/kirbyplants{
	icon_state = "plant-21"
	},
/obj/effect/turf_decal/stripes/end{
	dir = 4
	},
/obj/machinery/light{
	dir = 4;
	icon_state = "tube"
	},
/turf/open/floor/mineral/titanium/white,
/area/shuttle/escape)
"vI" = (
/obj/effect/turf_decal/stripes/line{
	dir = 10
	},
/obj/structure/chair/office/light{
	dir = 8
	},
/turf/open/floor/mineral/titanium/blue,
/area/shuttle/escape)
"wb" = (
/obj/structure/table,
/obj/item/defibrillator/compact/loaded,
/obj/machinery/light{
	dir = 8
	},
/turf/open/floor/mineral/plastitanium,
/area/shuttle/escape)
"ws" = (
/obj/machinery/door/airlock/command{
	name = "Shuttle Control";
	req_one_access_txt = "19"
	},
/obj/effect/turf_decal/stripes/line,
/turf/open/floor/mineral/plastitanium,
/area/shuttle/escape)
"wV" = (
/obj/effect/turf_decal/stripes/line{
	dir = 8
	},
/obj/effect/turf_decal/stripes/corner{
	dir = 4
	},
/turf/open/floor/mineral/titanium/white,
/area/shuttle/escape)
"xa" = (
/obj/effect/turf_decal/stripes/line,
/obj/effect/turf_decal/stripes/corner{
	dir = 4
	},
/obj/effect/turf_decal/stripes/corner{
	dir = 1
	},
/turf/open/floor/mineral/titanium/white,
/area/shuttle/escape)
"xN" = (
/obj/structure/table,
/obj/item/storage/toolbox/emergency,
/obj/item/crowbar/red,
/turf/open/floor/mineral/plastitanium,
/area/shuttle/escape)
"AX" = (
/obj/effect/turf_decal/stripes/line{
	dir = 9
	},
/turf/open/floor/mineral/plastitanium,
/area/shuttle/escape)
"Ce" = (
/obj/machinery/door/airlock/shuttle{
	name = "Emergency Shuttle Airlock"
	},
/obj/effect/turf_decal/delivery,
/turf/open/floor/mineral/plastitanium,
/area/shuttle/escape)
"Cj" = (
/obj/effect/turf_decal/stripes/line{
	dir = 6
	},
/obj/structure/table,
/obj/item/storage/box/zipties{
	pixel_y = 4
	},
/obj/item/restraints/handcuffs,
/obj/item/restraints/handcuffs,
/turf/open/floor/mineral/plastitanium/red/brig,
/area/shuttle/escape/brig)
"Cn" = (
/obj/effect/turf_decal/delivery,
/obj/effect/turf_decal/stripes/corner{
	dir = 4
	},
/obj/machinery/stasis,
/turf/open/floor/mineral/plastitanium,
/area/shuttle/escape)
"CK" = (
/obj/structure/closet/emcloset/anchored,
/obj/effect/turf_decal/bot,
/turf/open/floor/mineral/plastitanium,
/area/shuttle/escape)
"CL" = (
/obj/structure/chair/comfy/shuttle{
	dir = 1
	},
/obj/effect/turf_decal/stripes/line{
	dir = 1
	},
/turf/open/floor/mineral/plastitanium,
/area/shuttle/escape)
"Dx" = (
/obj/effect/turf_decal/stripes/line{
	dir = 4
	},
/obj/effect/turf_decal/stripes/corner{
	dir = 8
	},
/turf/open/floor/mineral/plastitanium,
/area/shuttle/escape)
"ES" = (
/obj/machinery/vending/medical,
/obj/effect/turf_decal/bot,
/turf/open/floor/mineral/plastitanium,
/area/shuttle/escape)
"GM" = (
/obj/effect/turf_decal/delivery,
/obj/machinery/door/airlock/security/glass{
	name = "Holding Area";
	req_one_access_txt = "19"
	},
/turf/open/floor/mineral/plastitanium,
/area/shuttle/escape/brig)
"HT" = (
/obj/effect/turf_decal/stripes/corner{
	dir = 1
	},
/obj/effect/turf_decal/stripes/corner{
	dir = 4
	},
/obj/effect/turf_decal/stripes/corner,
/turf/open/floor/mineral/titanium/white,
/area/shuttle/escape)
"IE" = (
/obj/effect/turf_decal/bot,
/obj/machinery/computer/crew,
/obj/effect/turf_decal/stripes/line,
/turf/open/floor/mineral/plastitanium,
/area/shuttle/escape)
"JX" = (
/obj/effect/turf_decal/stripes/line{
	dir = 1
	},
/obj/structure/chair/comfy/shuttle,
/obj/machinery/light{
	dir = 1
	},
/turf/open/floor/mineral/plastitanium/red/brig,
/area/shuttle/escape/brig)
"MP" = (
/obj/effect/turf_decal/stripes/line{
	dir = 4
	},
/obj/effect/turf_decal/stripes/line{
	dir = 8
	},
/turf/open/floor/mineral/titanium/white,
/area/shuttle/escape)
"Nf" = (
/obj/structure/sign/warning/fire,
/turf/closed/wall/mineral/titanium,
/area/shuttle/escape)
"Oe" = (
/obj/effect/turf_decal/stripes/line{
	dir = 1
	},
/obj/effect/turf_decal/stripes/corner{
	dir = 8
	},
/obj/effect/turf_decal/stripes/corner,
/obj/item/radio/intercom/directional/north,
/turf/open/floor/mineral/titanium/white,
/area/shuttle/escape)
"Pp" = (
/obj/effect/turf_decal/stripes/line,
/obj/machinery/light,
/turf/open/floor/mineral/plastitanium,
/area/shuttle/escape)
"Qq" = (
/turf/closed/wall/mineral/plastitanium,
/area/shuttle/escape)
"Qy" = (
/obj/effect/turf_decal/stripes/line{
	dir = 5
	},
/turf/open/floor/mineral/plastitanium,
/area/shuttle/escape)
"SH" = (
/obj/effect/turf_decal/stripes/line{
	dir = 5
	},
/obj/structure/table,
/obj/machinery/recharger,
/turf/open/floor/mineral/plastitanium/red/brig,
/area/shuttle/escape/brig)
"SY" = (
/obj/effect/turf_decal/stripes/line{
	dir = 6
	},
/turf/open/floor/mineral/titanium/yellow,
/area/shuttle/escape)
"Tk" = (
/obj/effect/turf_decal/stripes/line{
	dir = 5
	},
/obj/machinery/light{
	dir = 4
	},
/obj/item/kirbyplants{
	icon_state = "plant-10"
	},
/obj/item/radio/intercom/directional/east,
/turf/open/floor/mineral/titanium/blue,
/area/shuttle/escape)
"Vd" = (
/obj/effect/turf_decal/bot,
/obj/structure/chair/comfy/shuttle{
	dir = 1
	},
/turf/open/floor/mineral/plastitanium,
/area/shuttle/escape)
"VN" = (
/obj/structure/table,
/obj/item/storage/firstaid/o2,
/obj/item/tank/internals/emergency_oxygen,
/turf/open/floor/mineral/plastitanium,
/area/shuttle/escape)
"XC" = (
/obj/structure/table,
/obj/item/clipboard,
/obj/item/reagent_containers/hypospray/medipen,
/obj/item/reagent_containers/hypospray/medipen{
	pixel_y = 6
	},
/obj/item/reagent_containers/hypospray/medipen{
	pixel_y = -6
	},
/obj/item/reagent_containers/glass/bottle/multiver,
/turf/open/floor/mineral/plastitanium,
/area/shuttle/escape)
"Ye" = (
/obj/effect/turf_decal/delivery,
/obj/machinery/door/airlock/medical/glass{
	name = "Shuttle Infirmary"
	},
/turf/open/floor/mineral/plastitanium,
/area/shuttle/escape)
"Yi" = (
/obj/effect/turf_decal/stripes/line,
/obj/effect/turf_decal/stripes/corner{
	dir = 1
	},
/turf/open/floor/mineral/plastitanium/red/brig,
/area/shuttle/escape/brig)
"Yq" = (
/obj/effect/turf_decal/stripes/line{
	dir = 4
	},
/obj/effect/turf_decal/stripes/corner{
	dir = 8
	},
/turf/open/floor/mineral/titanium/white,
/area/shuttle/escape)
"YK" = (
/obj/effect/turf_decal/stripes/line,
/turf/open/floor/mineral/titanium/blue,
/area/shuttle/escape)
"YM" = (
/obj/effect/turf_decal/stripes/line{
	dir = 4
	},
/turf/open/floor/mineral/titanium/yellow,
/area/shuttle/escape)
"Zl" = (
/obj/structure/chair/comfy/shuttle{
	dir = 4
	},
/obj/effect/turf_decal/bot,
/obj/machinery/light{
	dir = 8
	},
/turf/open/floor/mineral/plastitanium,
/area/shuttle/escape)

(1,1,1) = {"
aa
aa
aa
aa
ad
ad
ad
aI
rm
aP
az
aB
aB
aB
az
aV
rm
aV
ad
ad
ad
aa
"}
(2,1,1) = {"
aa
ad
ad
ad
ad
dz
aF
Yi
aB
bn
Zl
ao
ao
ao
Zl
bo
ad
bb
bq
pm
ad
Qq
"}
(3,1,1) = {"
ad
ae
al
aq
ad
aA
aG
nV
dn
aQ
MP
MP
MP
wV
ay
aW
aB
bb
bq
bf
bi
bk
"}
(4,1,1) = {"
aB
af
AX
ar
ad
JX
aG
aJ
aB
bn
Vd
bj
aS
py
lZ
Yq
aX
YM
SY
bg
bi
bk
"}
(5,1,1) = {"
aB
ag
CL
as
ad
SH
aH
Cj
ad
tP
Vd
tS
aS
bo
xN
VN
ad
bc
br
kH
bi
bk
"}
(6,1,1) = {"
aB
ah
CL
at
az
aB
GM
aB
bm
gk
Vd
qY
aS
tV
dw
az
ad
ad
ad
qK
Nf
Qq
"}
(7,1,1) = {"
aB
IE
CL
Pp
ad
CK
aC
bf
ad
cT
Vd
tS
aS
bo
am
Cn
ES
wb
bs
XC
bi
bk
"}
(8,1,1) = {"
aB
ai
Qy
Dx
ws
kh
oF
aM
Ce
xa
Vd
dw
aS
aT
Ye
aZ
aZ
aZ
vI
ga
bi
bk
"}
(9,1,1) = {"
ad
ae
ap
au
js
aD
bl
aK
ad
Oe
cJ
cJ
cJ
HT
Ye
bd
ac
an
YK
bP
bi
bk
"}
(10,1,1) = {"
aa
ad
ad
ad
ad
aE
bl
aK
az
uB
lY
lY
lY
uB
am
aR
Tk
bd
ab
qZ
ad
Qq
"}
(11,1,1) = {"
aa
aa
aa
aa
ad
ad
bp
ad
rm
az
aB
aB
aB
az
rm
ad
ad
aB
ad
ad
ad
aa
"}
