//MAP CONVERTED BY dmm2tgm.py THIS HEADER COMMENT PREVENTS RECONVERSION, DO NOT REMOVE
"aI" = (
/obj/effect/decal/cleanable/dirt,
/obj/effect/decal/cleanable/blood/old,
/turf/open/floor/plasteel,
/area/shuttle)
"cK" = (
/obj/machinery/atmospherics/components/unary/portables_connector/visible{
	dir = 4
	},
/obj/effect/turf_decal/bot,
/obj/machinery/portable_atmospherics/canister/toxins,
/obj/effect/mapping_helpers/auto_wrench,
/turf/open/floor/plating,
/area/shuttle)
"dy" = (
/obj/effect/spawner/structure/window/hollow/reinforced/end{
	dir = 4
	},
/turf/open/floor/plating,
/area/shuttle)
"gM" = (
/obj/effect/decal/cleanable/dirt,
/obj/effect/turf_decal/bot,
/obj/effect/turf_decal/stripes/line{
	dir = 1
	},
/turf/open/floor/plasteel,
/area/shuttle)
"gV" = (
/obj/effect/decal/cleanable/blood/old,
/turf/open/floor/plasteel,
/area/shuttle)
"ic" = (
/obj/effect/turf_decal/stripes/line{
	dir = 8
	},
/obj/effect/turf_decal/caution{
	dir = 4;
	icon_state = "caution"
	},
/turf/open/floor/plasteel,
/area/shuttle)
"ih" = (
/obj/structure/table,
/obj/machinery/microwave{
	pixel_y = 5
	},
/turf/open/floor/plating,
/area/shuttle)
"jf" = (
/obj/structure/table,
/obj/machinery/light/small{
	dir = 1
	},
/obj/item/gps/mining,
/obj/effect/turf_decal/tile/neutral{
	dir = 8
	},
/obj/effect/turf_decal/tile/neutral,
/turf/open/floor/plasteel/dark,
/area/shuttle)
"jj" = (
/turf/closed/wall/rust,
/area/shuttle)
"kY" = (
/obj/machinery/door/airlock/external,
/obj/structure/fans/tiny,
/obj/effect/mapping_helpers/airlock/cyclelink_helper{
	dir = 4
	},
/obj/docking_port/mobile{
	dir = 4
	},
/turf/open/floor/mineral/plastitanium,
/area/shuttle)
"lE" = (
/obj/machinery/suit_storage_unit/standard_unit{
	desc = "An industrial suit storage device carrying retro space suits. Neat!";
	helmet_type = /obj/item/clothing/head/helmet/space;
	suit_type = /obj/item/clothing/suit/space
	},
/obj/effect/turf_decal/delivery,
/obj/effect/turf_decal/tile/neutral,
/obj/effect/turf_decal/tile/neutral{
	dir = 8
	},
/obj/structure/window/reinforced{
	dir = 4;
	pixel_x = 3
	},
/turf/open/floor/plasteel/dark,
/area/shuttle)
"mm" = (
/obj/structure/lattice/catwalk,
/turf/template_noop,
/area/shuttle)
"ms" = (
/obj/effect/decal/cleanable/dirt,
/obj/machinery/atmospherics/pipe/smart/manifold4w/purple/visible,
/turf/open/floor/plasteel,
/area/shuttle)
"nu" = (
/obj/effect/decal/cleanable/dirt,
/obj/structure/table,
/obj/effect/turf_decal/tile/blue{
	dir = 1
	},
/obj/effect/turf_decal/tile/blue{
	dir = 4
	},
/obj/effect/turf_decal/tile/blue,
/obj/item/assembly/flash/handheld,
/turf/open/floor/plasteel,
/area/shuttle)
"oP" = (
/obj/machinery/door/airlock/external,
/obj/structure/fans/tiny,
/obj/effect/mapping_helpers/airlock/cyclelink_helper{
	dir = 4
	},
/turf/open/floor/mineral/plastitanium,
/area/shuttle)
"oQ" = (
/turf/closed/wall,
/area/shuttle)
"pm" = (
/obj/structure/tank_dispenser/oxygen,
/obj/effect/mapping_helpers/broken_floor,
/turf/open/floor/plating,
/area/shuttle)
"ql" = (
/obj/effect/turf_decal/tile/blue{
	dir = 1
	},
/obj/effect/turf_decal/tile/blue{
	dir = 4
	},
/obj/machinery/computer/shuttle_flight,
/turf/open/floor/plasteel,
/area/shuttle)
"qE" = (
/obj/effect/turf_decal/bot,
/turf/open/floor/plasteel,
/area/shuttle)
"qM" = (
/obj/effect/turf_decal/tile/blue{
	dir = 4
	},
/turf/open/floor/plasteel,
/area/shuttle)
"qY" = (
/obj/effect/decal/cleanable/cobweb/cobweb2,
/obj/effect/turf_decal/tile/neutral{
	dir = 8
	},
/obj/effect/turf_decal/tile/neutral,
/obj/structure/rack,
/obj/item/radio/off{
	pixel_x = 6;
	pixel_y = 14
	},
/obj/item/weldingtool/largetank,
/turf/open/floor/plasteel/dark,
/area/shuttle)
"rl" = (
/obj/structure/sign/warning/fire,
/turf/closed/wall/rust,
/area/shuttle)
"sb" = (
/obj/structure/table,
/obj/item/pickaxe,
/obj/effect/mapping_helpers/broken_floor,
/turf/open/floor/plasteel,
/area/shuttle)
"sq" = (
/obj/effect/turf_decal/stripes/line{
	dir = 8
	},
/obj/effect/turf_decal/caution{
	dir = 4;
	icon_state = "caution"
	},
/obj/effect/mapping_helpers/broken_floor,
/turf/open/floor/plating,
/area/shuttle)
"sw" = (
/obj/machinery/suit_storage_unit/standard_unit{
	desc = "An industrial suit storage device carrying retro space suits. Neat!";
	helmet_type = /obj/item/clothing/head/helmet/space;
	suit_type = /obj/item/clothing/suit/space
	},
/obj/effect/turf_decal/delivery,
/obj/effect/turf_decal/tile/neutral,
/obj/effect/turf_decal/tile/neutral{
	dir = 8
	},
/turf/open/floor/plasteel/dark,
/area/shuttle)
"sE" = (
/obj/effect/spawner/structure/window/hollow/reinforced/directional{
	dir = 5
	},
/turf/open/floor/plating,
/area/shuttle)
"sH" = (
/obj/effect/decal/cleanable/cobweb/cobweb2,
/obj/structure/ore_box,
/turf/open/floor/plating,
/area/shuttle)
"sU" = (
/obj/structure/sign/poster/contraband/random{
	pixel_x = 32
	},
/obj/structure/closet/secure_closet/freezer/fridge,
/turf/open/floor/plating,
/area/shuttle)
"uN" = (
/turf/open/floor/mineral/plastitanium,
/area/shuttle)
"vp" = (
/obj/effect/decal/cleanable/cobweb,
/turf/open/floor/plating,
/area/shuttle)
"vT" = (
/obj/machinery/atmospherics/pipe/smart/manifold4w/purple/visible,
/turf/open/floor/plating,
/area/shuttle)
"wC" = (
/obj/effect/spawner/structure/window/hollow/reinforced/end,
/turf/open/floor/plating,
/area/shuttle)
"xE" = (
/turf/open/floor/plasteel,
/area/shuttle)
"yN" = (
/obj/effect/decal/cleanable/dirt,
/obj/structure/table,
/obj/item/kirbyplants/dead{
	name = "sad-looking potted plant";
	pixel_y = 13
	},
/obj/effect/turf_decal/tile/blue{
	dir = 1
	},
/obj/effect/turf_decal/tile/blue{
	dir = 4
	},
/obj/effect/turf_decal/tile/blue{
	dir = 8
	},
/turf/open/floor/plasteel,
/area/shuttle)
"zd" = (
/obj/effect/turf_decal/stripes/line{
	dir = 1
	},
/obj/effect/decal/cleanable/glass,
/turf/open/floor/plasteel,
/area/shuttle)
"Ao" = (
/obj/effect/decal/cleanable/dirt,
/obj/structure/chair/comfy/shuttle{
	dir = 1
	},
/turf/open/floor/plasteel,
/area/shuttle)
"Bo" = (
/obj/effect/landmark/exploration_weapon_spawner{
	dir = 4
	},
/turf/closed/wall/rust,
/area/shuttle)
"Cs" = (
/obj/machinery/door/airlock/external,
/obj/effect/mapping_helpers/airlock/cyclelink_helper{
	dir = 8
	},
/turf/open/floor/mineral/plastitanium,
/area/shuttle)
"CZ" = (
/obj/effect/turf_decal/bot,
/obj/structure/cable,
/turf/open/floor/plating,
/area/shuttle)
"Dp" = (
/obj/effect/decal/cleanable/dirt,
/turf/open/floor/plating{
	luminosity = 2
	},
/area/shuttle)
"DP" = (
/obj/machinery/power/port_gen/pacman,
/obj/structure/cable,
/turf/open/floor/plating,
/area/shuttle)
"Eb" = (
/obj/effect/turf_decal/stripes/corner{
	dir = 1
	},
/obj/structure/sign/warning/vacuum{
	pixel_x = -32
	},
/obj/effect/decal/cleanable/dirt,
/turf/open/floor/plasteel,
/area/shuttle)
"Em" = (
/obj/effect/turf_decal/tile/blue{
	dir = 1
	},
/turf/open/floor/plasteel,
/area/shuttle)
"EY" = (
/obj/effect/decal/cleanable/dirt,
/obj/structure/table,
/obj/item/storage/toolbox/mechanical{
	pixel_y = 4
	},
/turf/open/floor/plasteel,
/area/shuttle)
"FY" = (
/obj/effect/decal/cleanable/dirt,
/obj/machinery/atmospherics/pipe/smart/manifold4w/purple/visible,
/turf/open/floor/plating,
/area/shuttle)
"Gd" = (
/obj/machinery/door/firedoor/closed,
/obj/structure/cable,
/turf/open/floor/plating,
/area/shuttle)
"Gw" = (
/obj/effect/landmark/exploration_weapon_spawner{
	dir = 8
	},
/turf/closed/wall,
/area/shuttle)
"GN" = (
/obj/effect/spawner/structure/window/hollow/reinforced/directional{
	dir = 9
	},
/turf/open/floor/plating,
/area/shuttle)
"HZ" = (
/obj/machinery/light/small{
	dir = 1
	},
/turf/open/floor/mineral/plastitanium,
/area/shuttle)
"Ji" = (
/turf/template_noop,
/area/template_noop)
"JF" = (
/obj/effect/spawner/structure/window/hollow/reinforced/end{
	dir = 8
	},
/turf/open/floor/plating,
/area/shuttle)
"Kz" = (
/obj/effect/mapping_helpers/broken_floor,
/turf/open/floor/plating,
/area/shuttle)
"KH" = (
/obj/machinery/light/small{
	dir = 8
	},
/obj/effect/mapping_helpers/broken_floor,
/turf/open/floor/plating,
/area/shuttle)
"La" = (
/obj/effect/spawner/structure/window/hollow/reinforced/middle{
	dir = 4
	},
/turf/open/floor/plating,
/area/shuttle)
"ME" = (
/obj/item/wrench,
/obj/structure/cable,
/turf/open/floor/plating,
/area/shuttle)
"Ny" = (
/obj/machinery/light/small{
	dir = 4
	},
/obj/effect/decal/cleanable/cobweb/cobweb2,
/obj/effect/turf_decal/tile/blue,
/obj/effect/turf_decal/tile/blue{
	dir = 4
	},
/obj/effect/turf_decal/tile/blue{
	dir = 1
	},
/obj/effect/decal/cleanable/blood/old,
/turf/open/floor/plasteel,
/area/shuttle)
"NH" = (
/obj/effect/turf_decal/bot,
/obj/machinery/light/small{
	dir = 4
	},
/turf/open/floor/plasteel,
/area/shuttle)
"NZ" = (
/obj/effect/spawner/structure/window/hollow/reinforced/end{
	dir = 1
	},
/turf/open/floor/plating,
/area/shuttle)
"OE" = (
/obj/effect/decal/cleanable/dirt,
/obj/effect/mapping_helpers/broken_floor,
/obj/machinery/atmospherics/pipe/smart/manifold4w/purple/visible,
/turf/open/floor/plating,
/area/shuttle)
"Ru" = (
/obj/machinery/light/small{
	dir = 8
	},
/obj/structure/sign/poster/contraband/random{
	pixel_y = 32
	},
/obj/structure/closet/emcloset/anchored,
/obj/effect/mob_spawn/human/corpse/assistant,
/obj/effect/mapping_helpers/broken_floor,
/turf/open/floor/plating,
/area/shuttle)
"RJ" = (
/obj/structure/lattice,
/turf/template_noop,
/area/shuttle)
"Sr" = (
/obj/effect/turf_decal/stripes/line{
	dir = 1
	},
/obj/item/shard,
/obj/effect/decal/cleanable/glass,
/turf/open/floor/plasteel,
/area/shuttle)
"TX" = (
/turf/open/floor/plating,
/area/shuttle)
"Ut" = (
/obj/effect/decal/cleanable/dirt,
/obj/effect/turf_decal/stripes/corner,
/turf/open/floor/plasteel,
/area/shuttle)
"UN" = (
/obj/effect/turf_decal/stripes/line{
	dir = 4
	},
/obj/structure/cable,
/turf/open/floor/plasteel,
/area/shuttle)
"Vq" = (
/obj/machinery/atmospherics/components/unary/shuttle/engine_heater{
	dir = 1
	},
/turf/open/floor/plating,
/area/shuttle)
"Vt" = (
/obj/machinery/light/small{
	dir = 1
	},
/obj/effect/decal/cleanable/dirt,
/obj/effect/decal/cleanable/cobweb,
/obj/structure/sign/poster/contraband/random{
	pixel_x = -32
	},
/obj/structure/closet/emcloset/anchored,
/turf/open/floor/plating,
/area/shuttle)
"VC" = (
/obj/machinery/shuttle/engine/plasma{
	dir = 1
	},
/obj/effect/turf_decal/stripes/line,
/turf/open/floor/plating,
/area/shuttle)
"WK" = (
/obj/structure/table,
/turf/open/floor/plating,
/area/shuttle)
"XG" = (
/obj/effect/decal/cleanable/dirt,
/turf/open/floor/plasteel,
/area/shuttle)
"XW" = (
/obj/machinery/computer/weapons,
/turf/open/floor/plating,
/area/shuttle)
"Zk" = (
/obj/effect/decal/cleanable/dirt,
/turf/open/floor/plating,
/area/shuttle)
"ZC" = (
/obj/effect/spawner/structure/window/hollow/reinforced/middle,
/turf/open/floor/plating,
/area/shuttle)
"ZV" = (
/obj/effect/decal/cleanable/cobweb,
/obj/machinery/power/apc/ten_k/directional/north,
/obj/structure/cable,
/turf/open/floor/plating,
/area/shuttle)
"ZW" = (
/obj/machinery/atmospherics/components/unary/portables_connector/visible{
	dir = 4
	},
/obj/effect/turf_decal/bot,
/obj/machinery/portable_atmospherics/canister/toxins,
/obj/effect/mapping_helpers/auto_wrench,
/turf/open/floor/plasteel,
/area/shuttle)

(1,1,1) = {"
Ji
Ji
Ji
Ji
Ji
Ji
oQ
oP
kY
oQ
Ji
Ji
Ji
Ji
Ji
Ji
Ji
"}
(2,1,1) = {"
Ji
Ji
mm
RJ
Ji
Ji
jj
HZ
uN
oQ
oQ
jj
oQ
RJ
mm
Ji
Ji
"}
(3,1,1) = {"
mm
RJ
RJ
RJ
RJ
Gw
oQ
Cs
Cs
jj
vp
KH
JF
Ji
RJ
Ji
Ji
"}
(4,1,1) = {"
Ji
Ji
Ji
Ji
Ji
jj
Vt
ic
sq
Eb
aI
CZ
dy
Ji
RJ
RJ
RJ
"}
(5,1,1) = {"
Ji
Ji
Ji
GN
wC
yN
Em
xE
Ut
UN
ME
DP
oQ
Kz
RJ
Ji
Ji
"}
(6,1,1) = {"
Ji
Ji
Ji
ZC
XW
xE
xE
sU
oQ
Gd
NZ
wC
jj
oQ
mm
Ji
Ji
"}
(7,1,1) = {"
Ji
Ji
Ji
ZC
ql
Ao
ih
oQ
jj
ZV
cK
ZW
TX
OE
Vq
VC
Ji
"}
(8,1,1) = {"
Ji
Ji
Ji
ZC
nu
qM
jj
oQ
Ru
TX
vT
ms
FY
vT
Vq
VC
Ji
"}
(9,1,1) = {"
Ji
Ji
Ji
sE
wC
Ny
oQ
lE
Sr
XG
Kz
TX
TX
rl
jj
Ji
Ji
"}
(10,1,1) = {"
Ji
Ji
Ji
Ji
jj
oQ
oQ
sw
zd
sb
TX
pm
Kz
TX
Ji
Ji
Ji
"}
(11,1,1) = {"
Ji
Ji
Ji
Ji
RJ
RJ
jj
jf
Dp
WK
TX
Zk
RJ
Ji
Ji
Ji
Ji
"}
(12,1,1) = {"
Ji
mm
RJ
RJ
RJ
RJ
oQ
qY
gM
qE
gV
Kz
mm
Ji
Ji
Ji
Ji
"}
(13,1,1) = {"
Ji
Ji
Ji
Ji
Ji
mm
Bo
jj
sH
NH
EY
jj
Ji
Ji
Ji
Ji
Ji
"}
(14,1,1) = {"
Ji
Ji
Ji
Ji
Ji
Ji
Ji
jj
NZ
La
wC
jj
Ji
Ji
Ji
Ji
Ji
"}
(15,1,1) = {"
Ji
Ji
Ji
Ji
Ji
Ji
Ji
Ji
RJ
RJ
Ji
Ji
Ji
Ji
Ji
Ji
Ji
"}
(16,1,1) = {"
Ji
Ji
Ji
Ji
Ji
Ji
Ji
Ji
Ji
RJ
Ji
Ji
Ji
Ji
Ji
Ji
Ji
"}
(17,1,1) = {"
Ji
Ji
Ji
Ji
Ji
Ji
Ji
Ji
mm
RJ
RJ
Ji
Ji
Ji
Ji
Ji
Ji
"}
