//MAP CONVERTED BY dmm2tgm.py THIS HEADER COMMENT PREVENTS RECONVERSION, DO NOT REMOVE
"a" = (
/obj/machinery/light/directional/west,
/obj/machinery/airalarm{
	dir = 1;
	pixel_y = -22
	},
/turf/open/floor/mineral/plastitanium,
/area/shuttle/exploration)
"b" = (
/obj/machinery/atmospherics/pipe/smart/manifold4w/scrubbers/hidden/layer2{
	dir = 8
	},
/obj/machinery/atmospherics/components/unary/vent_pump/on/layer4{
	dir = 1
	},
/turf/open/floor/mineral/plastitanium,
/area/shuttle/exploration)
"c" = (
/obj/machinery/door/airlock/shuttle,
/obj/effect/turf_decal/stripes/line,
/obj/effect/turf_decal/stripes/line{
	dir = 1
	},
/obj/machinery/door/firedoor/border_only,
/obj/machinery/door/firedoor/border_only{
	dir = 1
	},
/obj/structure/cable,
/obj/machinery/atmospherics/pipe/smart/manifold4w/supply/hidden/layer4{
	dir = 4
	},
/obj/machinery/atmospherics/pipe/smart/manifold4w/scrubbers/hidden/layer2{
	dir = 8
	},
/turf/open/floor/mineral/plastitanium,
/area/shuttle/exploration)
"d" = (
/obj/machinery/modular_computer/console/preset/civilian,
/turf/open/floor/mineral/plastitanium,
/area/shuttle/exploration)
"f" = (
/obj/machinery/atmospherics/components/unary/vent_pump/on/layer4{
	dir = 4
	},
/turf/open/floor/mineral/plastitanium,
/area/shuttle/exploration)
"g" = (
/obj/machinery/door/airlock/shuttle,
/obj/machinery/door/firedoor/border_only{
	dir = 1
	},
/obj/machinery/door/firedoor/border_only,
/obj/effect/turf_decal/stripes/line{
	dir = 1
	},
/obj/effect/turf_decal/stripes/line,
/obj/machinery/atmospherics/pipe/smart/manifold4w/supply/hidden/layer4{
	dir = 4
	},
/obj/machinery/atmospherics/pipe/smart/manifold4w/scrubbers/hidden/layer2{
	dir = 8
	},
/turf/open/floor/mineral/plastitanium,
/area/shuttle/exploration)
"h" = (
/obj/machinery/atmospherics/components/unary/vent_scrubber/on/layer2{
	dir = 8
	},
/turf/open/floor/mineral/plastitanium,
/area/shuttle/exploration)
"i" = (
/obj/effect/turf_decal/stripes/line{
	dir = 1
	},
/obj/structure/closet/crate,
/obj/item/wrench,
/obj/item/radio/headset/headset_exploration,
/obj/item/radio/headset/headset_exploration,
/obj/effect/turf_decal/bot,
/turf/open/floor/mineral/plastitanium,
/area/shuttle/exploration)
"j" = (
/obj/machinery/telecomms/broadcaster/preset_exploration,
/obj/effect/turf_decal/delivery,
/turf/open/floor/mineral/plastitanium,
/area/shuttle/exploration)
"k" = (
/obj/machinery/atmospherics/components/unary/vent_scrubber/on/layer2{
	dir = 4
	},
/turf/open/floor/mineral/titanium,
/area/shuttle/exploration)
"l" = (
/turf/template_noop,
/area/template_noop)
"m" = (
/obj/machinery/computer/objective,
/turf/open/floor/mineral/plastitanium,
/area/shuttle/exploration)
"n" = (
/obj/structure/window/reinforced/survival_pod{
	dir = 1
	},
/obj/structure/shuttle/engine/heater,
/turf/open/floor/plating,
/area/shuttle/exploration)
"o" = (
/obj/machinery/telecomms/bus/preset_exploration,
/obj/effect/turf_decal/delivery,
/turf/open/floor/mineral/plastitanium,
/area/shuttle/exploration)
"p" = (
/obj/structure/cable,
/obj/machinery/power/apc/auto_name/north,
/obj/machinery/atmospherics/pipe/smart/manifold4w/supply/hidden/layer4{
	dir = 4
	},
/obj/machinery/atmospherics/pipe/smart/manifold4w/scrubbers/hidden/layer2{
	dir = 8
	},
/turf/open/floor/mineral/titanium,
/area/shuttle/exploration)
"r" = (
/obj/effect/turf_decal/stripes/line{
	dir = 4
	},
/obj/effect/spawner/structure/window/shuttle,
/turf/open/floor/plating,
/area/shuttle/exploration)
"s" = (
/obj/effect/turf_decal/stripes/line{
	dir = 1
	},
/obj/machinery/telecomms/hub/preset/exploration,
/obj/effect/turf_decal/delivery,
/turf/open/floor/mineral/plastitanium,
/area/shuttle/exploration)
"t" = (
/obj/machinery/door/airlock/external/glass,
/obj/docking_port/mobile{
	dir = 4;
	dwidth = 5;
	height = 7;
	id = "exploration";
	name = "Шаттл Рейнджеров";
	port_direction = 8;
	width = 13
	},
/obj/structure/cable,
/obj/structure/fans/tiny,
/obj/machinery/atmospherics/pipe/smart/manifold4w/supply/hidden/layer4{
	dir = 4
	},
/obj/machinery/atmospherics/pipe/smart/manifold4w/scrubbers/hidden/layer2{
	dir = 8
	},
/turf/open/floor/mineral/plastitanium,
/area/shuttle/exploration)
"u" = (
/obj/machinery/light/directional/south,
/obj/machinery/atmospherics/pipe/smart/manifold4w/scrubbers/hidden/layer2{
	dir = 8
	},
/obj/machinery/atmospherics/components/unary/vent_pump/on/layer4{
	dir = 1
	},
/turf/open/floor/mineral/titanium,
/area/shuttle/exploration)
"w" = (
/obj/machinery/telecomms/receiver/preset_exploration,
/obj/effect/turf_decal/delivery,
/turf/open/floor/mineral/plastitanium,
/area/shuttle/exploration)
"x" = (
/obj/structure/cable,
/obj/machinery/atmospherics/pipe/smart/manifold4w/supply/hidden/layer4{
	dir = 4
	},
/obj/machinery/atmospherics/pipe/smart/manifold4w/scrubbers/hidden/layer2{
	dir = 8
	},
/turf/open/floor/mineral/titanium,
/area/shuttle/exploration)
"y" = (
/turf/open/floor/mineral/titanium,
/area/shuttle/exploration)
"z" = (
/turf/closed/wall/mineral/titanium/nodiagonal,
/area/shuttle/exploration)
"A" = (
/obj/effect/turf_decal/bot,
/obj/machinery/portable_atmospherics/canister/tier_1,
/obj/machinery/atmospherics/components/unary/portables_connector/visible/layer2{
	dir = 8
	},
/turf/open/floor/mineral/titanium,
/area/shuttle/exploration)
"B" = (
/obj/effect/turf_decal/stripes/line{
	dir = 1
	},
/obj/machinery/power/port_gen/pacman,
/obj/structure/cable,
/obj/effect/turf_decal/bot,
/turf/open/floor/mineral/plastitanium,
/area/shuttle/exploration)
"D" = (
/obj/structure/table,
/obj/machinery/recharger,
/turf/open/floor/mineral/plastitanium,
/area/shuttle/exploration)
"F" = (
/obj/structure/table,
/obj/item/storage/toolbox/mechanical,
/obj/item/multitool,
/obj/item/gps/mining,
/turf/open/floor/mineral/plastitanium,
/area/shuttle/exploration)
"G" = (
/obj/structure/shuttle/engine/propulsion/burst,
/turf/open/floor/plating,
/area/shuttle/exploration)
"H" = (
/obj/machinery/atmospherics/pipe/smart/manifold4w/supply/hidden/layer4{
	dir = 4
	},
/turf/open/floor/mineral/titanium,
/area/shuttle/exploration)
"I" = (
/turf/closed/wall/mineral/plastitanium,
/area/shuttle/exploration)
"J" = (
/obj/machinery/telecomms/server/presets/exploration,
/obj/effect/turf_decal/delivery,
/turf/open/floor/mineral/plastitanium,
/area/shuttle/exploration)
"L" = (
/obj/machinery/telecomms/processor/preset_exploration,
/obj/effect/turf_decal/delivery,
/turf/open/floor/mineral/plastitanium,
/area/shuttle/exploration)
"N" = (
/obj/effect/turf_decal/stripes/line{
	dir = 1
	},
/obj/structure/cable,
/obj/machinery/atmospherics/pipe/smart/manifold4w/supply/hidden/layer4{
	dir = 4
	},
/obj/machinery/atmospherics/pipe/smart/manifold4w/scrubbers/hidden/layer2{
	dir = 8
	},
/turf/open/floor/mineral/plastitanium,
/area/shuttle/exploration)
"O" = (
/obj/machinery/atmospherics/components/unary/vent_scrubber/on/layer2{
	dir = 4
	},
/turf/open/floor/mineral/plastitanium,
/area/shuttle/exploration)
"P" = (
/obj/structure/chair/comfy/shuttle{
	dir = 1
	},
/turf/open/floor/mineral/plastitanium,
/area/shuttle/exploration)
"Q" = (
/turf/closed/wall/mineral/titanium,
/area/shuttle/exploration)
"R" = (
/obj/effect/spawner/structure/window/shuttle,
/turf/open/floor/plating,
/area/shuttle/exploration)
"S" = (
/obj/machinery/atmospherics/pipe/smart/manifold4w/supply/hidden/layer4{
	dir = 4
	},
/obj/machinery/atmospherics/pipe/smart/manifold4w/scrubbers/hidden/layer2{
	dir = 8
	},
/turf/open/floor/mineral/plastitanium,
/area/shuttle/exploration)
"T" = (
/obj/machinery/light/directional/east,
/turf/open/floor/mineral/plastitanium,
/area/shuttle/exploration)
"U" = (
/turf/open/floor/mineral/plastitanium,
/area/shuttle/exploration)
"V" = (
/obj/effect/turf_decal/stripes/line{
	dir = 1
	},
/obj/structure/cable,
/obj/structure/closet/crate/science,
/obj/item/circuitboard/computer/exploration_shuttle,
/obj/item/stack/sheet/mineral/plasma/five,
/obj/effect/turf_decal/bot,
/obj/machinery/light/directional/north,
/obj/item/tank/internals/oxygen,
/obj/item/tank/internals/oxygen,
/obj/item/tank/internals/oxygen,
/obj/item/clothing/mask/breath,
/obj/item/clothing/mask/breath,
/obj/item/clothing/mask/breath,
/obj/machinery/airalarm{
	pixel_y = 23
	},
/turf/open/floor/mineral/plastitanium,
/area/shuttle/exploration)
"W" = (
/obj/machinery/computer/shuttle_flight/exploration,
/turf/open/floor/mineral/plastitanium,
/area/shuttle/exploration)
"X" = (
/obj/effect/turf_decal/bot,
/obj/machinery/atmospherics/components/unary/portables_connector/visible/layer4{
	dir = 8
	},
/obj/machinery/portable_atmospherics/canister/air,
/turf/open/floor/mineral/titanium,
/area/shuttle/exploration)

(1,1,1) = {"
l
R
R
Q
Q
t
Q
z
r
r
Q
I
l
"}
(2,1,1) = {"
R
R
D
a
z
x
y
z
B
U
w
I
I
"}
(3,1,1) = {"
R
W
P
f
z
p
k
z
V
O
o
n
G
"}
(4,1,1) = {"
R
d
P
S
g
x
x
c
N
b
J
n
G
"}
(5,1,1) = {"
R
m
P
h
z
H
u
z
s
U
L
n
G
"}
(6,1,1) = {"
R
R
F
T
z
X
A
z
i
U
j
I
I
"}
(7,1,1) = {"
l
R
R
Q
Q
R
R
z
R
R
Q
I
l
"}
