//MAP CONVERTED BY dmm2tgm.py THIS HEADER COMMENT PREVENTS RECONVERSION, DO NOT REMOVE
"a" = (
/turf/closed/wall/mineral/titanium,
/area/shuttle/freelancer)
"c" = (
/obj/structure/rack,
/obj/item/storage/toolbox/electrical{
	pixel_x = -3;
	pixel_y = 1
	},
/obj/item/storage/toolbox/mechanical{
	pixel_y = -1
	},
/obj/item/storage/toolbox/emergency{
	pixel_x = 3;
	pixel_y = -5
	},
/obj/effect/turf_decal/bot,
/obj/structure/cable,
/turf/open/floor/mineral/plastitanium,
/area/shuttle/freelancer)
"i" = (
/obj/effect/turf_decal/stripes/end{
	dir = 4
	},
/obj/machinery/light/small/directional/south,
/obj/structure/cable,
/turf/open/floor/mineral/titanium/yellow,
/area/shuttle/freelancer)
"l" = (
/obj/structure/window/shuttle,
/obj/structure/grille,
/obj/machinery/power/engine_capacitor_bank{
	dir = 1
	},
/obj/structure/cable,
/turf/open/floor/plating,
/area/shuttle/freelancer)
"m" = (
/obj/effect/turf_decal/stripes/line{
	dir = 10
	},
/mob/living/simple_animal/bot/medbot,
/obj/effect/turf_decal/stripes/corner{
	dir = 4
	},
/obj/machinery/light_switch/directional/west,
/obj/structure/cable,
/turf/open/floor/mineral/titanium/yellow,
/area/shuttle/freelancer)
"n" = (
/obj/structure/cable,
/obj/machinery/power/solar/t4_plastitaniumglass,
/obj/effect/turf_decal/stripes/line{
	dir = 4
	},
/turf/open/floor/plasteel/airless/solarpanel,
/area/shuttle/freelancer)
"w" = (
/obj/structure/closet/crate{
	name = "emergency supplies crate"
	},
/obj/item/flashlight/flare{
	pixel_x = 3;
	pixel_y = 3
	},
/obj/item/flashlight/flare{
	pixel_x = -6;
	pixel_y = -2
	},
/obj/item/crowbar,
/obj/item/wrench,
/obj/item/radio,
/obj/effect/turf_decal/bot,
/obj/item/multitool,
/obj/item/gun/energy/e_gun/old,
/obj/machinery/newscaster/directional/east,
/obj/structure/cable,
/turf/open/floor/mineral/plastitanium,
/area/shuttle/freelancer)
"x" = (
/obj/structure/cable,
/turf/closed/wall/mineral/titanium,
/area/shuttle/freelancer)
"A" = (
/obj/structure/fans/tiny,
/obj/effect/turf_decal/stripes/line{
	dir = 4
	},
/obj/effect/turf_decal/stripes/line{
	dir = 8
	},
/obj/machinery/door/airlock/shuttle,
/turf/open/floor/mineral/plastitanium,
/area/shuttle/freelancer)
"E" = (
/obj/docking_port/mobile/freelancer,
/turf/closed/wall/mineral/plastitanium,
/area/shuttle/freelancer)
"H" = (
/obj/effect/turf_decal/bot,
/obj/structure/chair/comfy/shuttle{
	dir = 1
	},
/obj/machinery/power/apc/auto_name/directional/west{
	locked = 0
	},
/obj/structure/cable,
/obj/effect/landmark/start/freelancer,
/turf/open/floor/mineral/plastitanium,
/area/shuttle/freelancer)
"J" = (
/obj/effect/turf_decal/stripes/corner{
	dir = 8
	},
/obj/effect/turf_decal/stripes/line{
	dir = 5
	},
/turf/open/floor/mineral/titanium/yellow,
/area/shuttle/freelancer)
"K" = (
/obj/machinery/shuttle/engine/ion/burst{
	dir = 1
	},
/turf/open/floor/plating/airless,
/area/shuttle/freelancer)
"O" = (
/obj/machinery/power/solar/t4_plastitaniumglass,
/obj/structure/cable,
/obj/effect/turf_decal/stripes/line{
	dir = 1
	},
/turf/open/floor/plasteel/airless/solarpanel,
/area/shuttle/freelancer)
"P" = (
/obj/machinery/power/solar_control{
	dir = 8
	},
/obj/structure/cable,
/obj/item/radio/intercom/directional/north,
/obj/effect/turf_decal/delivery,
/turf/open/floor/mineral/plastitanium,
/area/shuttle/freelancer)
"T" = (
/obj/structure/window/shuttle,
/obj/structure/grille,
/turf/open/floor/plating,
/area/shuttle/freelancer)
"U" = (
/obj/structure/sign/warning/fire,
/turf/closed/wall/mineral/titanium,
/area/shuttle/freelancer)
"W" = (
/obj/machinery/computer/shuttle_flight/freelancer,
/obj/effect/turf_decal/delivery,
/turf/open/floor/mineral/plastitanium,
/area/shuttle/freelancer)
"X" = (
/obj/structure/cable,
/obj/machinery/power/tracker,
/obj/effect/turf_decal/stripes/line{
	dir = 5
	},
/turf/open/floor/plasteel/airless/solarpanel,
/area/shuttle/freelancer)

(1,1,1) = {"
a
T
a
A
a
a
a
"}
(2,1,1) = {"
T
W
H
J
m
l
K
"}
(3,1,1) = {"
a
a
P
c
i
U
E
"}
(4,1,1) = {"
O
x
x
a
w
l
K
"}
(5,1,1) = {"
X
n
a
a
a
a
a
"}
