//MAP CONVERTED BY dmm2tgm.py THIS HEADER COMMENT PREVENTS RECONVERSION, DO NOT REMOVE
"a" = (
/turf/closed/wall/mineral/titanium,
/area/shuttle/freelancer)
"c" = (
/obj/structure/rack,
/obj/item/storage/toolbox/electrical{
	pixel_x = -3;
	pixel_y = 1
	},
/obj/item/storage/toolbox/mechanical{
	pixel_y = -1
	},
/obj/item/storage/toolbox/emergency{
	pixel_x = 3;
	pixel_y = -5
	},
/obj/effect/turf_decal/bot,
/turf/open/floor/mineral/plastitanium,
/area/shuttle/freelancer)
"i" = (
/obj/effect/turf_decal/stripes/end{
	dir = 4
	},
/obj/machinery/light/small/directional/south,
/turf/open/floor/mineral/titanium/yellow,
/area/shuttle/freelancer)
"l" = (
/obj/structure/window/shuttle,
/obj/structure/grille,
/obj/structure/shuttle/engine/heater,
/turf/open/floor/plating,
/area/shuttle/freelancer)
"m" = (
/obj/effect/turf_decal/stripes/line{
	dir = 10
	},
/mob/living/simple_animal/bot/medbot,
/obj/effect/turf_decal/stripes/corner{
	dir = 4
	},
/turf/open/floor/mineral/titanium/yellow,
/area/shuttle/freelancer)
"n" = (
/turf/closed/wall/mineral/plastitanium,
/area/shuttle/freelancer)
"w" = (
/obj/structure/closet/crate{
	name = "emergency supplies crate"
	},
/obj/item/flashlight/flare{
	pixel_x = 3;
	pixel_y = 3
	},
/obj/item/flashlight/flare{
	pixel_x = -6;
	pixel_y = -2
	},
/obj/item/crowbar,
/obj/item/wrench,
/obj/item/radio,
/obj/effect/turf_decal/bot,
/obj/item/multitool,
/obj/item/gun/energy/e_gun/old,
/turf/open/floor/mineral/plastitanium,
/area/shuttle/freelancer)
"A" = (
/obj/structure/fans/tiny,
/obj/effect/turf_decal/stripes/line{
	dir = 4
	},
/obj/effect/turf_decal/stripes/line{
	dir = 8
	},
/obj/machinery/door/airlock/shuttle,
/obj/structure/cable,
/turf/open/floor/mineral/plastitanium,
/area/shuttle/freelancer)
"E" = (
/obj/docking_port/mobile/freelancer{
	dwidth = 2;
	width = 5;
	height = 7
	},
/turf/closed/wall/mineral/plastitanium,
/area/shuttle/freelancer)
"H" = (
/obj/effect/turf_decal/bot,
/obj/structure/chair/comfy/shuttle{
	dir = 1
	},
/obj/machinery/power/apc/auto_name/directional/west{
	locked = 0
	},
/obj/structure/cable,
/obj/effect/landmark/start/freelancer,
/turf/open/floor/mineral/plastitanium,
/area/shuttle/freelancer)
"J" = (
/obj/effect/turf_decal/stripes/corner{
	dir = 8
	},
/obj/effect/turf_decal/stripes/line{
	dir = 5
	},
/obj/structure/cable,
/turf/open/floor/mineral/titanium/yellow,
/area/shuttle/freelancer)
"K" = (
/obj/structure/shuttle/engine/propulsion,
/turf/open/floor/plating/airless,
/area/shuttle/freelancer)
"O" = (
/obj/structure/lattice,
/turf/template_noop,
/area/shuttle/freelancer)
"T" = (
/obj/structure/window/shuttle,
/obj/structure/grille,
/turf/open/floor/plating,
/area/shuttle/freelancer)
"U" = (
/obj/structure/sign/warning/fire,
/turf/closed/wall/mineral/titanium,
/area/shuttle/freelancer)
"W" = (
/obj/machinery/computer/shuttle_flight/freelancer,
/turf/open/floor/mineral/plastitanium,
/area/shuttle/freelancer)

(1,1,1) = {"
T
T
a
A
a
a
n
"}
(2,1,1) = {"
T
W
H
J
m
l
K
"}
(3,1,1) = {"
T
a
a
c
i
U
E
"}
(4,1,1) = {"
O
a
a
a
w
l
K
"}
(5,1,1) = {"
O
O
a
a
a
a
n
"}
