"a" = (/obj/machinery/porta_turret/syndicate/shuttle{dir = 5},/turf/closed/wall/mineral/plastitanium,/area/shuttle/custom)
"b" = (/obj/machinery/power/emitter/energycannon{dir = 4},/turf/open/floor/mineral/plastitanium,/area/shuttle/custom)
"c" = (/obj/machinery/power/emitter/energycannon,/turf/open/floor/mineral/plastitanium,/area/shuttle/custom)
"e" = (/obj/effect/turf_decal/stripes/line,/obj/machinery/light,/turf/open/floor/mineral/plastitanium,/area/shuttle/custom)
"h" = (/obj/machinery/door/airlock/external{req_access_txt = "150"},/turf/open/floor/mineral/plastitanium,/area/shuttle/custom)
"i" = (/obj/effect/turf_decal/stripes/line,/turf/open/floor/mineral/plastitanium,/area/shuttle/custom)
"l" = (/obj/machinery/light{dir = 1},/turf/open/floor/mineral/plastitanium,/area/shuttle/custom)
"m" = (/obj/effect/turf_decal/stripes/line{dir = 8},/turf/open/floor/mineral/plastitanium,/area/shuttle/custom)
"o" = (/obj/machinery/power/emitter/energycannon{dir = 1},/turf/open/floor/mineral/plastitanium,/area/shuttle/custom)
"p" = (/turf/closed/wall/mineral/plastitanium,/area/shuttle/custom)
"q" = (/obj/machinery/light,/turf/open/floor/mineral/plastitanium,/area/shuttle/custom)
"r" = (/obj/effect/turf_decal/stripes/line{dir = 1},/obj/machinery/light{dir = 1},/turf/open/floor/mineral/plastitanium,/area/shuttle/custom)
"u" = (/obj/effect/turf_decal/stripes/line{dir = 1},/turf/open/floor/mineral/plastitanium,/area/shuttle/custom)
"A" = (/turf/open/floor/mineral/plastitanium,/area/shuttle/custom)
"D" = (/turf/template_noop,/area/template_noop)
"E" = (/obj/machinery/light{dir = 8},/turf/open/floor/mineral/plastitanium,/area/shuttle/custom)
"G" = (/obj/machinery/computer/camera_advanced/shuttle_docker/adv/diy{name = "Nevmerloshuttle console"; dir = 1},/turf/open/floor/mineral/plastitanium,/area/shuttle/custom)
"H" = (/obj/effect/turf_decal/stripes/line{dir = 8},/obj/machinery/light{dir = 8},/turf/open/floor/mineral/plastitanium,/area/shuttle/custom)
"I" = (/obj/machinery/light{dir = 4},/turf/open/floor/mineral/plastitanium,/area/shuttle/custom)
"M" = (/obj/machinery/power/emitter/energycannon{dir = 8},/turf/open/floor/mineral/plastitanium,/area/shuttle/custom)
"N" = (/obj/effect/turf_decal/stripes/line{dir = 4},/turf/open/floor/mineral/plastitanium,/area/shuttle/custom)
"R" = (/obj/structure/fans/tiny,/obj/machinery/door/airlock/external{req_access_txt = "150"},/turf/open/floor/mineral/plastitanium,/area/shuttle/custom)
"S" = (/obj/machinery/computer/shuttle/diy{name = "Nevmerloshuttle console"},/turf/open/floor/mineral/plastitanium,/area/shuttle/custom)
"U" = (/obj/structure/window/plasma/reinforced/plastitanium,/turf/open/floor/plating,/area/shuttle/custom)
"X" = (/obj/machinery/turntable,/turf/open/floor/mineral/plastitanium,/area/shuttle/custom)
"Y" = (/obj/effect/turf_decal/stripes/line{dir = 4},/obj/machinery/light{dir = 4},/turf/open/floor/mineral/plastitanium,/area/shuttle/custom)

(1,1,1) = {"
aUUaDDppppppppa
poopDDpAAhAAAbU
pAIpDDpAAhAAqbU
pAApDDpANpppppa
pAApDDpANRDDDDD
phhpRRaANRDDDDD
pAAuuurAYappppp
pGAAAAAXAAAAASp
pppppaHAeiiiAAp
DDDDDRmAaRRphhp
DDDDDRmApDDpAAp
apppppmApDDpAAp
UMlAAhAApDDpEAp
UMAAAhAApDDpccp
appppppppDDaUUa
"}
