//MAP CONVERTED BY dmm2tgm.py THIS HEADER COMMENT PREVENTS RECONVERSION, DO NOT REMOVE
"a" = (
/turf/closed/wall/mineral/titanium,
/area/shuttle/mining)
"b" = (
/obj/effect/spawner/structure/window/shuttle,
/turf/open/floor/plating,
/area/shuttle/mining)
"c" = (
/obj/structure/table,
/turf/open/floor/mineral/titanium/blue,
/area/shuttle/mining)
"d" = (
/obj/machinery/computer/shuttle_flight/mining/common,
/obj/effect/turf_decal/loading_area{
	dir = 1
	},
/turf/open/floor/mineral/titanium/blue,
/area/shuttle/mining)
"e" = (
/turf/open/floor/mineral/titanium,
/area/shuttle/mining)
"f" = (
/obj/structure/chair/comfy/shuttle{
	dir = 1
	},
/obj/effect/turf_decal/bot,
/turf/open/floor/mineral/titanium/blue,
/area/shuttle/mining)
"g" = (
/obj/machinery/light{
	dir = 8
	},
/obj/machinery/power/apc/auto_name/directional/west,
/obj/structure/cable,
/obj/machinery/camera/autoname{
	dir = 5;
	start_active = 1
	},
/turf/open/floor/mineral/titanium,
/area/shuttle/mining)
"h" = (
/obj/machinery/door/airlock/titanium{
	name = "Lavaland Shuttle Airlock"
	},
/obj/docking_port/mobile{
	dir = 8;
	id = "mining_common";
	name = "lavaland shuttle";
	port_direction = 4
	},
/obj/structure/fans/tiny,
/obj/structure/cable,
/turf/open/floor/plating,
/area/shuttle/mining)
"i" = (
/obj/effect/turf_decal/bot,
/obj/structure/ore_box,
/obj/structure/cable,
/turf/open/floor/mineral/titanium/blue,
/area/shuttle/mining)
"j" = (
/obj/structure/window/reinforced{
	dir = 1;
	layer = 2.9
	},
/obj/structure/window/reinforced{
	dir = 8
	},
/obj/structure/window/reinforced{
	dir = 4
	},
/obj/machinery/power/engine_capacitor_bank{
	dir = 1
	},
/obj/structure/cable,
/turf/open/floor/plating,
/area/shuttle/mining)
"k" = (
/obj/effect/turf_decal/bot,
/obj/machinery/power/smes/engineering,
/obj/structure/cable,
/turf/open/floor/mineral/titanium/blue,
/area/shuttle/mining)
"l" = (
/obj/machinery/shuttle/engine/ion{
	dir = 1
	},
/turf/open/floor/plating/airless,
/area/shuttle/mining)
"m" = (
/obj/structure/chair/comfy/shuttle{
	dir = 1
	},
/obj/effect/turf_decal/bot,
/obj/machinery/power/terminal,
/obj/structure/cable,
/turf/open/floor/mineral/titanium/blue,
/area/shuttle/mining)
"t" = (
/obj/effect/turf_decal/bot,
/obj/structure/closet/crate,
/obj/structure/cable,
/turf/open/floor/mineral/titanium/blue,
/area/shuttle/mining)
"O" = (
/obj/structure/cable,
/turf/open/floor/mineral/titanium,
/area/shuttle/mining)
"Q" = (
/obj/structure/chair/comfy/shuttle{
	dir = 1
	},
/turf/open/floor/mineral/titanium,
/area/shuttle/mining)

(1,1,1) = {"
a
a
b
a
b
a
a
"}
(2,1,1) = {"
a
c
e
g
t
i
a
"}
(3,1,1) = {"
b
d
Q
e
f
j
l
"}
(4,1,1) = {"
a
c
e
O
m
k
a
"}
(5,1,1) = {"
a
a
b
h
b
a
a
"}
