//MAP CONVERTED BY dmm2tgm.py THIS HEADER COMMENT PREVENTS RECONVERSION, DO NOT REMOVE
"a" = (
/turf/closed/wall/mineral/titanium,
/area/centcom/supply)
"b" = (
/turf/open/floor/mineral/titanium/blue,
/area/centcom/supply)
"c" = (
/obj/machinery/light{
	dir = 1
	},
/turf/open/floor/mineral/titanium/blue,
/area/centcom/supply)
"d" = (
/obj/machinery/light{
	dir = 8
	},
/turf/open/floor/mineral/titanium/blue,
/area/centcom/supply)
"e" = (
/obj/machinery/button/door{
	id = "QMLoaddoor2";
	name = "Loading Doors";
	pixel_x = 24;
	pixel_y = 8
	},
/obj/machinery/button/door{
	id = "QMLoaddoor";
	name = "Loading Doors";
	pixel_x = 24;
	pixel_y = -8
	},
/obj/machinery/light{
	dir = 4
	},
/turf/open/floor/mineral/titanium/blue,
/area/centcom/supply)
"f" = (
/obj/machinery/door/airlock/titanium{
	name = "Supply Shuttle Airlock";
	req_access_txt = "31"
	},
/obj/docking_port/mobile/supply/trader,
/turf/open/floor/mineral/titanium,
/area/centcom/supply)
"l" = (
/obj/machinery/conveyor{
	dir = 4;
	id = "QMLoad2"
	},
/obj/machinery/door/poddoor{
	id = "QMLoaddoor2";
	name = "supply dock loading door"
	},
/turf/open/floor/mineral/titanium,
/area/centcom/supply)
"n" = (
/obj/machinery/door/airlock/titanium{
	name = "Supply Shuttle Airlock";
	req_access_txt = "31"
	},
/turf/open/floor/mineral/titanium,
/area/centcom/supply)
"r" = (
/obj/machinery/conveyor{
	dir = 8;
	id = "QMLoad"
	},
/obj/machinery/door/poddoor{
	id = "QMLoaddoor";
	name = "supply dock loading door"
	},
/turf/open/floor/mineral/titanium,
/area/centcom/supply)
"u" = (
/obj/structure/window/reinforced{
	dir = 1
	},
/obj/structure/shuttle/engine/heater,
/turf/open/floor/plating/airless,
/area/centcom/supply)
"w" = (
/turf/template_noop,
/area/template_noop)
"x" = (
/obj/structure/shuttle/engine/propulsion/burst/left,
/turf/open/floor/plating/airless,
/area/centcom/supply)
"y" = (
/obj/structure/shuttle/engine/propulsion,
/turf/open/floor/plating/airless,
/area/centcom/supply)
"A" = (
/obj/structure/shuttle/engine/propulsion/burst/right,
/turf/open/floor/plating/airless,
/area/centcom/supply)

(1,1,1) = {"
a
a
a
a
a
a
a
a
a
a
a
w
"}
(2,1,1) = {"
a
b
b
b
b
d
b
b
b
b
a
x
"}
(3,1,1) = {"
a
b
b
b
b
b
b
b
b
b
u
y
"}
(4,1,1) = {"
a
c
b
b
b
b
b
b
b
b
u
y
"}
(5,1,1) = {"
a
b
b
b
b
b
b
b
b
b
u
y
"}
(6,1,1) = {"
a
b
b
b
b
e
b
b
b
b
a
A
"}
(7,1,1) = {"
a
a
a
l
n
a
f
r
a
a
a
w
"}
