"a" = (/turf/template_noop,/area/template_noop)
"b" = (/turf/open/floor/plasteel,/area/template_noop)
"c" = (/turf/closed/wall,/area/template_noop)
"d" = (/obj/machinery/atmospherics/pipe/simple/general/visible/layer3{icon_state = "pipe11-3"; dir = 6},/turf/closed/wall,/area/template_noop)
"e" = (/obj/machinery/atmospherics/components/unary/outlet_injector/on/layer3{dir = 8; icon_state = "inje_map-3"; volume_rate = 200},/turf/open/floor/engine/airless,/area/template_noop)
"f" = (/obj/machinery/atmospherics/components/unary/outlet_injector/on/layer1{volume_rate = 200},/turf/open/floor/engine/airless,/area/template_noop)
"g" = (/obj/machinery/atmospherics/components/unary/outlet_injector/on/layer1{dir = 4; icon_state = "inje_map-1"; volume_rate = 200},/turf/open/floor/engine/airless,/area/template_noop)
"h" = (/obj/machinery/atmospherics/pipe/simple/general/visible/layer1{icon_state = "pipe11-1"; dir = 10},/turf/closed/wall,/area/template_noop)
"i" = (/obj/machinery/atmospherics/pipe/simple/general/visible{icon_state = "pipe11-2"; dir = 6},/obj/machinery/atmospherics/pipe/simple/general/visible/layer3,/turf/closed/wall,/area/template_noop)
"j" = (/obj/machinery/atmospherics/components/unary/outlet_injector/on{dir = 8; icon_state = "inje_map-2"; volume_rate = 200},/turf/open/floor/engine/airless,/area/template_noop)
"k" = (/obj/machinery/atmospherics/pipe/simple/general/hidden/layer1,/obj/machinery/atmospherics/components/unary/vent_scrubber,/turf/open/floor/engine/airless,/area/template_noop)
"l" = (/obj/machinery/atmospherics/components/unary/outlet_injector/on{dir = 4; icon_state = "inje_map-2"; volume_rate = 200},/turf/open/floor/engine/airless,/area/template_noop)
"m" = (/obj/machinery/atmospherics/pipe/simple/general/visible{icon_state = "pipe11-2"; dir = 10},/obj/machinery/atmospherics/pipe/simple/general/visible/layer1,/turf/closed/wall,/area/template_noop)
"n" = (/obj/machinery/atmospherics/pipe/simple/general/visible{icon_state = "pipe11-2"; dir = 1},/obj/machinery/atmospherics/pipe/simple/general/visible/layer3,/obj/machinery/atmospherics/pipe/simple/general/visible/layer1{icon_state = "pipe11-1"; dir = 6},/turf/closed/wall,/area/template_noop)
"o" = (/obj/machinery/atmospherics/components/unary/outlet_injector/on/layer1{dir = 8; icon_state = "inje_map-1"; volume_rate = 200},/turf/open/floor/engine/airless,/area/template_noop)
"p" = (/obj/machinery/atmospherics/components/unary/outlet_injector/on/layer3{volume_rate = 200},/obj/machinery/atmospherics/pipe/simple/general/hidden/layer1,/obj/machinery/atmospherics/pipe/simple/general/hidden{icon_state = "pipe11-2"; dir = 5},/turf/open/floor/engine/airless,/area/template_noop)
"q" = (/obj/machinery/atmospherics/components/unary/outlet_injector/on/layer3{dir = 4; icon_state = "inje_map-3"; volume_rate = 200},/obj/machinery/atmospherics/pipe/simple/general/hidden{icon_state = "pipe11-2"; dir = 10},/turf/open/floor/engine/airless,/area/template_noop)
"r" = (/obj/machinery/atmospherics/pipe/simple/general/visible{icon_state = "pipe11-2"; dir = 1},/obj/machinery/atmospherics/pipe/simple/general/visible/layer1,/obj/machinery/atmospherics/pipe/simple/general/visible/layer3{icon_state = "pipe11-3"; dir = 10},/turf/closed/wall,/area/template_noop)
"s" = (/obj/machinery/atmospherics/pipe/layer_manifold/visible,/turf/closed/wall,/area/template_noop)
"t" = (/obj/machinery/atmospherics/pipe/simple/general/hidden,/turf/closed/wall,/area/template_noop)
"u" = (/obj/machinery/atmospherics/pipe/simple/general/hidden{icon_state = "pipe11-2"; dir = 5},/turf/open/floor/plasteel,/area/template_noop)
"v" = (/obj/machinery/atmospherics/pipe/simple/general/hidden{icon_state = "pipe11-2"; dir = 8},/turf/open/floor/plasteel,/area/template_noop)
"w" = (/obj/machinery/atmospherics/pipe/manifold4w/general,/turf/open/floor/plasteel,/area/template_noop)
"x" = (/obj/machinery/atmospherics/pipe/simple/general/hidden,/obj/machinery/atmospherics/pipe/simple/general/hidden{icon_state = "pipe11-2"; dir = 8},/turf/open/floor/plasteel,/area/template_noop)
"y" = (/obj/machinery/atmospherics/pipe/simple/general/hidden{icon_state = "pipe11-2"; dir = 9},/turf/open/floor/plasteel,/area/template_noop)

(1,1,1) = {"
aaaaaaaaaa
abbbbbbbba
abcccccbba
abdefghbba
abijklmbba
abnopqrbba
abscstsbba
abuvwxybba
abbbbbbbba
aaaaaaaaaa
"}
