//MAP CONVERTED BY dmm2tgm.py THIS HEADER COMMENT PREVENTS RECONVERSION, DO NOT REMOVE
"bq" = (
/obj/effect/turf_decal/is12,
/turf/open/floor/plating/is12/dirt,
/area/ctf)
"fh" = (
/obj/effect/turf_decal/is12{
	icon_state = "l2"
	},
/turf/open/floor/plating/is12/rock,
/area/ctf)
"fy" = (
/turf/open/floor/plating/is12/wood,
/area/ctf)
"fJ" = (
/obj/structure/deployable_barricade/sandbags{
	dir = 1
	},
/turf/open/floor/plating/is12/rock,
/area/ctf)
"gR" = (
/obj/effect/turf_decal/is12{
	icon_state = "l3"
	},
/turf/open/floor/plating/is12/rock,
/area/ctf)
"iQ" = (
/obj/effect/turf_decal/is12{
	icon_state = "dirtcornerleft"
	},
/turf/open/floor/plating/is12/wood,
/area/ctf)
"ko" = (
/obj/structure/deployable_barricade/sandbags{
	dir = 4
	},
/turf/open/floor/plating/is12/trenchcenter,
/area/ctf)
"lh" = (
/turf/open/floor/plating/is12/wwidirtplating,
/area/ctf)
"lO" = (
/obj/effect/turf_decal/is12,
/turf/open/floor/plating/is12/wood,
/area/ctf)
"na" = (
/obj/item/ctf/blue,
/turf/open/floor/plating/is12/wood,
/area/ctf)
"nn" = (
/obj/structure/deployable_barricade/sandbags,
/obj/item/binoculars,
/turf/open/floor/plating/is12/wwidirtplating,
/area/ctf)
"oE" = (
/obj/effect/turf_decal/is12,
/turf/open/floor/plating/is12/rock,
/area/ctf)
"qO" = (
/obj/effect/turf_decal/is12{
	icon_state = "m4"
	},
/turf/open/floor/plating/is12/dirt,
/area/ctf)
"sd" = (
/obj/structure/deployable_barricade/sandbags,
/obj/structure/deployable_barricade/sandbags{
	dir = 4
	},
/turf/open/floor/plating/is12/wwidirtplating,
/area/ctf)
"sp" = (
/obj/effect/turf_decal/is12{
	icon_state = "grass"
	},
/turf/open/floor/plating/is12/rock,
/area/ctf)
"sv" = (
/obj/structure/deployable_barricade/sandbags,
/obj/structure/deployable_barricade/sandbags{
	dir = 8
	},
/turf/open/floor/plating/is12/wwidirtplating,
/area/ctf)
"sZ" = (
/obj/effect/turf_decal/is12{
	icon_state = "l4"
	},
/turf/open/floor/plating/is12/rock,
/area/ctf)
"tA" = (
/turf/closed/indestructible/riveted/boss,
/area/ctf)
"tO" = (
/obj/machinery/capture_the_flag/blue/warfare,
/turf/open/floor/plating/is12/wood,
/area/ctf)
"tQ" = (
/obj/structure/deployable_barricade/sandbags,
/turf/open/floor/plating/is12/rock,
/area/ctf)
"ut" = (
/obj/effect/turf_decal/is12{
	icon_state = "m1"
	},
/turf/open/floor/plating/is12/surface,
/area/ctf)
"uR" = (
/obj/structure/deployable_barricade/sandbags{
	dir = 8
	},
/turf/open/floor/plating/is12/rock,
/area/ctf)
"vj" = (
/obj/machinery/capture_the_flag/yellow/warfare,
/obj/effect/turf_decal/is12{
	icon_state = "dirtcornerleft"
	},
/turf/open/floor/plating/is12/wood,
/area/ctf)
"vp" = (
/obj/effect/turf_decal/is12{
	icon_state = "l6"
	},
/turf/open/floor/plating/is12/rock,
/area/ctf)
"wN" = (
/obj/effect/turf_decal/is12{
	icon_state = "m2"
	},
/turf/open/floor/plating/is12/surface,
/area/ctf)
"yp" = (
/turf/open/floor/plating/is12/surface,
/area/ctf)
"yQ" = (
/obj/effect/turf_decal/is12{
	icon_state = "grass"
	},
/turf/open/floor/plating/is12/wwidirtplating,
/area/ctf)
"AN" = (
/obj/structure/trap/ctf/blue,
/turf/open/floor/plating/is12/trenchcenter,
/area/ctf)
"Bn" = (
/turf/open/floor/plating/is12/mud,
/area/ctf)
"Bq" = (
/obj/effect/turf_decal/is12{
	icon_state = "m3"
	},
/turf/open/floor/plating/is12/dirt,
/area/ctf)
"Cw" = (
/turf/open/floor/plating/is12/trenchcenter,
/area/ctf)
"CI" = (
/obj/effect/turf_decal/is12{
	icon_state = "l7"
	},
/turf/open/floor/plating/is12/rock,
/area/ctf)
"De" = (
/obj/structure/deployable_barricade/sandbags,
/turf/open/floor/plating/is12/wwidirt,
/area/ctf)
"El" = (
/obj/structure/deployable_barricade/sandbags{
	dir = 1
	},
/turf/open/floor/plating/is12/wwidirtplating,
/area/ctf)
"HI" = (
/obj/effect/turf_decal/is12{
	icon_state = "m2"
	},
/turf/open/floor/plating/is12/dirt,
/area/ctf)
"IB" = (
/obj/effect/turf_decal/is12{
	icon_state = "dirtcornerright"
	},
/turf/open/floor/plating/is12/wood,
/area/ctf)
"IY" = (
/obj/structure/deployable_barricade/sandbags{
	dir = 1
	},
/obj/item/binoculars,
/turf/open/floor/plating/is12/wwidirtplating,
/area/ctf)
"Li" = (
/obj/effect/turf_decal/is12{
	icon_state = "l8"
	},
/turf/open/floor/plating/is12/rock,
/area/ctf)
"LH" = (
/turf/open/floor/plating/is12/rock,
/area/ctf)
"MB" = (
/obj/effect/turf_decal/is12{
	icon_state = "l5"
	},
/turf/open/floor/plating/is12/rock,
/area/ctf)
"MM" = (
/obj/effect/turf_decal/is12{
	icon_state = "l1"
	},
/turf/open/floor/plating/is12/rock,
/area/ctf)
"Nc" = (
/obj/structure/deployable_barricade/sandbags{
	dir = 1
	},
/obj/structure/deployable_barricade/sandbags{
	dir = 8
	},
/turf/open/floor/plating/is12/wwidirtplating,
/area/ctf)
"Ny" = (
/obj/effect/turf_decal/is12{
	icon_state = "m1"
	},
/turf/open/floor/plating/is12/dirt,
/area/ctf)
"Of" = (
/turf/open/floor/plating/is12/dirt,
/area/ctf)
"Qb" = (
/obj/structure/deployable_barricade/sandbags{
	dir = 4
	},
/turf/open/floor/plating/is12/rock,
/area/ctf)
"Qc" = (
/obj/structure/deployable_barricade/sandbags{
	dir = 1
	},
/turf/open/floor/plating/is12/wwidirt,
/area/ctf)
"Sw" = (
/obj/structure/deployable_barricade/sandbags{
	dir = 1
	},
/obj/structure/deployable_barricade/sandbags{
	dir = 4
	},
/turf/open/floor/plating/is12/wwidirtplating,
/area/ctf)
"TE" = (
/turf/open/floor/plating/is12/wwidirt,
/area/ctf)
"Uo" = (
/obj/item/ctf/yellow,
/turf/open/floor/plating/is12/wood,
/area/ctf)
"Vj" = (
/obj/structure/trap/ctf/yellow,
/turf/open/floor/plating/is12/trenchcenter,
/area/ctf)
"VQ" = (
/obj/effect/turf_decal/is12{
	icon_state = "m3"
	},
/turf/open/floor/plating/is12/surface,
/area/ctf)
"VT" = (
/obj/structure/deployable_barricade/sandbags{
	dir = 8
	},
/turf/open/floor/plating/is12/trenchcenter,
/area/ctf)
"WY" = (
/obj/effect/turf_decal/is12{
	icon_state = "m4"
	},
/turf/open/floor/plating/is12/surface,
/area/ctf)
"Xa" = (
/obj/structure/deployable_barricade/sandbags,
/turf/open/floor/plating/is12/wwidirtplating,
/area/ctf)
"Ym" = (
/obj/effect/turf_decal/is12{
	icon_state = "l9"
	},
/turf/open/floor/plating/is12/rock,
/area/ctf)
"Zy" = (
/obj/effect/turf_decal/is12{
	icon_state = "grass"
	},
/turf/open/floor/plating/is12/dirt,
/area/ctf)

(1,1,1) = {"
tA
tA
tA
tA
tA
tA
tA
tA
tA
tA
tA
tA
tA
tA
tA
tA
tA
tA
tA
tA
tA
tA
tA
tA
tA
tA
tA
tA
tA
tA
tA
tA
tA
tA
tA
tA
tA
tA
tA
tA
tA
tA
tA
tA
tA
tA
tA
tA
tA
tA
"}
(2,1,1) = {"
tA
tO
fy
fy
fy
fy
tA
LH
tQ
LH
LH
LH
LH
LH
Of
Of
Of
Of
Of
Of
Of
Of
Of
Bn
Bn
Bn
Bn
Bn
Bn
Of
Of
Of
Of
Of
qO
Bq
Of
LH
LH
fJ
LH
LH
LH
LH
LH
LH
LH
LH
LH
tA
"}
(3,1,1) = {"
tA
fy
fy
fy
fy
fy
tA
LH
tQ
LH
LH
LH
LH
LH
Of
bq
Of
Of
Zy
Of
Of
Of
Of
Bn
Bn
Bn
Bn
Bn
Bn
Bn
Of
Of
Of
Of
HI
Ny
Of
LH
LH
fJ
LH
LH
LH
LH
LH
LH
LH
LH
LH
tA
"}
(4,1,1) = {"
tA
fy
fy
fy
fy
fy
AN
LH
tQ
LH
LH
LH
LH
LH
Of
Of
Of
Of
Of
Of
Of
Of
Bn
Bn
Bn
Bn
Bn
Bn
Bn
Bn
Of
Of
Of
Of
Of
Of
Of
LH
LH
fJ
LH
LH
LH
LH
LH
LH
LH
LH
LH
tA
"}
(5,1,1) = {"
tA
fy
lO
fy
fy
fy
tA
LH
tQ
LH
LH
LH
LH
LH
Of
Cw
Cw
Cw
Xa
Of
Of
Of
Bn
Bn
Bn
Bn
Bn
Bn
Bn
Bn
Of
Of
El
Cw
Cw
Cw
Of
LH
LH
tA
tA
tA
TE
tA
tA
tA
LH
LH
LH
tA
"}
(6,1,1) = {"
tA
fy
fy
fy
fy
fy
tA
LH
tQ
LH
LH
LH
LH
LH
Of
Cw
Cw
Cw
Xa
Of
Of
Bn
Bn
Bn
Bn
Bn
Bn
Bn
Bn
Bn
Of
Of
El
Cw
Cw
Cw
Of
LH
LH
tA
fy
fy
fy
fy
IB
tA
LH
sp
LH
tA
"}
(7,1,1) = {"
tA
tA
tA
AN
tA
tA
tA
LH
tQ
LH
LH
LH
LH
LH
Of
Cw
Cw
Cw
Xa
Of
Of
Bn
Bn
Bn
Bn
Bn
Bn
Bn
Bn
Bn
Of
Of
IY
Cw
Cw
Cw
Of
LH
LH
Qc
fy
fy
fy
fy
fy
tA
LH
LH
LH
tA
"}
(8,1,1) = {"
tA
LH
LH
LH
LH
LH
LH
LH
LH
LH
LH
LH
LH
LH
Of
Cw
Cw
Cw
Xa
Of
Of
Bn
Bn
Bn
Bn
Bn
Bn
Bn
Bn
Bn
Of
Of
El
Cw
Cw
Cw
Of
LH
LH
Qc
fy
fy
Uo
fy
fy
TE
LH
LH
LH
tA
"}
(9,1,1) = {"
tA
Qb
Qb
Qb
Qb
Qb
Qb
LH
LH
LH
LH
LH
LH
LH
Of
ko
ko
ko
sd
Of
Of
Bn
Bn
Bn
Bn
Bn
Bn
Bn
Bn
Bn
Of
bq
Sw
ko
ko
ko
Of
LH
LH
Qc
fy
fy
lO
fy
fy
tA
LH
LH
LH
tA
"}
(10,1,1) = {"
tA
LH
LH
LH
LH
LH
LH
LH
LH
LH
oE
LH
LH
LH
Of
Of
Of
Of
Of
Of
Of
Bn
Bn
Bn
Bn
Bn
Bn
Bn
Bn
Bn
Of
Of
Of
Of
Of
Of
Of
LH
LH
tA
fy
fy
fy
fy
fy
tA
LH
LH
LH
tA
"}
(11,1,1) = {"
tA
LH
LH
LH
LH
LH
LH
LH
sp
LH
LH
LH
LH
LH
Of
Of
Of
Of
Of
Of
Of
Bn
Bn
Bn
Bn
Bn
Bn
Bn
Bn
Bn
Of
Of
Of
Zy
Of
Of
Of
LH
LH
tA
tA
tA
TE
tA
tA
tA
LH
LH
LH
tA
"}
(12,1,1) = {"
tA
LH
LH
LH
LH
LH
LH
LH
LH
LH
LH
LH
LH
lh
lh
lh
lh
lh
lh
lh
yp
yp
yp
yp
yp
yp
yp
yp
yp
lh
lh
lh
lh
lh
lh
lh
lh
LH
LH
LH
LH
LH
LH
LH
LH
LH
LH
LH
LH
tA
"}
(13,1,1) = {"
tA
LH
LH
LH
LH
LH
LH
LH
LH
LH
LH
LH
lh
lh
lh
lh
yQ
lh
lh
yp
yp
yp
yp
WY
VQ
yp
yp
yp
yp
yp
yp
yp
lh
lh
lh
lh
lh
lh
lh
LH
LH
LH
LH
LH
LH
CI
Li
MM
LH
tA
"}
(14,1,1) = {"
tA
LH
LH
sp
LH
LH
LH
LH
LH
LH
LH
LH
LH
LH
lh
lh
lh
lh
lh
lh
lh
lh
yp
wN
ut
yp
yp
yp
yp
yp
yp
lh
lh
lh
lh
lh
lh
lh
LH
LH
LH
LH
LH
LH
LH
vp
Ym
fh
LH
tA
"}
(15,1,1) = {"
tA
LH
LH
LH
tA
tA
tA
TE
tA
tA
tA
LH
LH
LH
Of
Of
Of
Of
Of
Of
Of
Bn
Bn
Bn
Bn
Bn
Bn
Bn
Bn
Bn
Of
Of
Of
Of
Of
Of
Of
LH
LH
LH
LH
LH
LH
LH
LH
MB
sZ
gR
LH
tA
"}
(16,1,1) = {"
tA
LH
LH
LH
tA
fy
fy
fy
fy
fy
tA
LH
LH
LH
Of
Of
Of
Of
Of
Of
Of
Bn
Bn
Bn
Bn
Bn
Bn
Bn
Bn
Bn
Of
Of
Of
Of
Of
Of
Of
LH
LH
LH
LH
LH
LH
LH
LH
LH
LH
LH
LH
tA
"}
(17,1,1) = {"
tA
LH
LH
LH
tA
fy
fy
fy
fy
fy
De
LH
sp
LH
Of
VT
VT
VT
sv
Of
Of
Bn
Bn
Bn
Bn
Bn
Bn
Bn
Bn
Bn
Of
Of
Nc
VT
VT
VT
Of
LH
LH
LH
sp
LH
LH
uR
uR
uR
uR
uR
uR
tA
"}
(18,1,1) = {"
tA
LH
LH
LH
TE
fy
fy
na
fy
fy
De
LH
LH
LH
Of
Cw
Cw
Cw
Xa
Of
Of
Bn
Bn
Bn
Bn
Bn
Bn
Bn
Bn
Bn
Of
Of
El
Cw
Cw
Cw
Of
LH
LH
LH
LH
LH
LH
LH
LH
LH
LH
LH
LH
tA
"}
(19,1,1) = {"
tA
LH
LH
LH
tA
fy
fy
fy
fy
fy
De
LH
LH
LH
Of
Cw
Cw
Cw
nn
Of
Of
Bn
Bn
Bn
Bn
Bn
Bn
Bn
Bn
Bn
Of
Of
El
Cw
Cw
Cw
Of
LH
LH
LH
LH
fJ
LH
tA
tA
tA
Vj
tA
tA
tA
"}
(20,1,1) = {"
tA
LH
LH
LH
tA
fy
fy
fy
fy
iQ
tA
LH
LH
LH
Of
Cw
Cw
Cw
Xa
bq
Of
Bn
Bn
Bn
Bn
Bn
Bn
Bn
Bn
Bn
Of
Zy
El
Cw
Cw
Cw
Of
LH
LH
LH
LH
fJ
LH
tA
fy
fy
fy
fy
fy
tA
"}
(21,1,1) = {"
tA
LH
LH
LH
tA
tA
tA
TE
tA
tA
tA
LH
LH
LH
Of
Cw
Cw
Cw
Xa
Of
Of
Bn
Bn
Bn
Bn
Bn
Bn
Bn
Bn
Of
Of
Of
El
Cw
Cw
Cw
Of
LH
LH
LH
LH
fJ
LH
tA
fy
fy
fy
fy
fy
tA
"}
(22,1,1) = {"
tA
LH
LH
LH
LH
LH
LH
LH
LH
LH
tQ
LH
LH
LH
Of
Of
Of
Of
Of
Of
Of
Bn
Bn
Bn
Bn
Bn
Bn
Bn
Bn
Of
Of
Of
Of
Of
Of
Of
Of
LH
LH
LH
LH
fJ
LH
Vj
fy
fy
fy
fy
fy
tA
"}
(23,1,1) = {"
tA
LH
LH
LH
LH
LH
LH
LH
LH
LH
tQ
LH
LH
LH
Of
Zy
Of
Of
Of
Of
Of
Bn
Bn
Bn
Bn
Bn
Bn
Bn
Of
Of
Of
Of
Of
Of
Of
Of
Of
LH
LH
LH
LH
fJ
LH
tA
fy
fy
fy
fy
fy
tA
"}
(24,1,1) = {"
tA
LH
LH
LH
LH
LH
LH
LH
LH
LH
tQ
LH
LH
LH
Of
Of
Of
Of
Of
Of
Of
Of
Bn
Bn
Bn
Bn
Bn
Bn
Of
Of
Of
Of
Of
Of
Of
Of
Of
LH
LH
LH
LH
fJ
LH
tA
fy
fy
fy
fy
vj
tA
"}
(25,1,1) = {"
tA
tA
tA
tA
tA
tA
tA
tA
tA
tA
tA
tA
tA
tA
tA
tA
tA
tA
tA
tA
tA
tA
tA
tA
tA
tA
tA
tA
tA
tA
tA
tA
tA
tA
tA
tA
tA
tA
tA
tA
tA
tA
tA
tA
tA
tA
tA
tA
tA
tA
"}
