//MAP CONVERTED BY dmm2tgm.py THIS HEADER COMMENT PREVENTS RECONVERSION, DO NOT REMOVE
"a" = (
/turf/closed/wall/mineral/sandstone,
/area/ctf)
"c" = (
/obj/effect/turf_decal/tile/blue,
/obj/effect/turf_decal/tile/blue{
	dir = 1
	},
/obj/effect/turf_decal/tile/blue{
	dir = 8
	},
/obj/effect/turf_decal/tile/blue{
	dir = 4
	},
/obj/structure/table/reinforced/ctf,
/obj/item/ammo_box/magazine/fallout/r308,
/turf/open/floor/plasteel,
/area/ctf)
"i" = (
/obj/item/ctf/yellow,
/obj/effect/turf_decal/tile/yellow,
/obj/effect/turf_decal/tile/yellow{
	dir = 8
	},
/obj/effect/turf_decal/tile/yellow{
	dir = 1
	},
/obj/effect/turf_decal/tile/yellow{
	dir = 4
	},
/turf/open/floor/plasteel,
/area/ctf)
"k" = (
/obj/item/ctf/blue,
/obj/effect/turf_decal/tile/blue,
/obj/effect/turf_decal/tile/blue{
	dir = 1
	},
/obj/effect/turf_decal/tile/blue{
	dir = 8
	},
/obj/effect/turf_decal/tile/blue{
	dir = 4
	},
/turf/open/floor/plasteel,
/area/ctf)
"m" = (
/obj/effect/turf_decal/tile/blue{
	dir = 4
	},
/obj/effect/turf_decal/tile/blue{
	dir = 8
	},
/obj/effect/turf_decal/tile/blue{
	dir = 1
	},
/obj/effect/turf_decal/tile/blue,
/turf/open/floor/plasteel,
/area/ctf)
"n" = (
/obj/effect/turf_decal/tile/yellow{
	dir = 1
	},
/obj/effect/turf_decal/tile/yellow{
	dir = 8
	},
/obj/effect/turf_decal/tile/yellow{
	dir = 4
	},
/obj/effect/turf_decal/tile/yellow,
/turf/open/floor/plasteel,
/area/ctf)
"o" = (
/obj/structure/table/reinforced/ctf,
/turf/open/floor/plating/beach/coastline_t{
	dir = 1
	},
/area/ctf)
"p" = (
/obj/structure/trap/ctf/blue,
/turf/open/floor/plasteel,
/area/ctf)
"s" = (
/obj/effect/turf_decal/tile/yellow{
	dir = 1
	},
/obj/effect/turf_decal/tile/yellow{
	dir = 8
	},
/obj/effect/turf_decal/tile/yellow{
	dir = 4
	},
/obj/effect/turf_decal/tile/yellow,
/obj/machinery/capture_the_flag/yellow/warfare,
/turf/open/floor/plasteel,
/area/ctf)
"v" = (
/turf/open/floor/plating/beach/coastline_t{
	dir = 1
	},
/area/ctf)
"B" = (
/obj/effect/turf_decal/tile/yellow,
/obj/effect/turf_decal/tile/yellow{
	dir = 8
	},
/obj/effect/turf_decal/tile/yellow{
	dir = 1
	},
/obj/effect/turf_decal/tile/yellow{
	dir = 4
	},
/obj/structure/table/reinforced/ctf,
/obj/item/ammo_box/magazine/fallout/r308,
/turf/open/floor/plasteel,
/area/ctf)
"D" = (
/obj/effect/turf_decal/tile/blue{
	dir = 4
	},
/obj/effect/turf_decal/tile/blue{
	dir = 8
	},
/obj/effect/turf_decal/tile/blue{
	dir = 1
	},
/obj/effect/turf_decal/tile/blue,
/obj/machinery/capture_the_flag/blue/warfare,
/turf/open/floor/plasteel,
/area/ctf)
"E" = (
/turf/closed/wall/mineral/iron,
/area/ctf)
"F" = (
/obj/machinery/door/airlock/public/glass{
	name = "hat store";
	resistance_flags = 64
	},
/turf/open/floor/plasteel,
/area/ctf)
"G" = (
/obj/structure/window/reinforced/fulltile{
	max_integrity = 5000;
	name = "hardened window";
	obj_integrity = 5000
	},
/turf/open/floor/plating,
/area/ctf)
"H" = (
/obj/structure/barricade/security/ctf,
/turf/open/floor/plating/beach/sand,
/area/ctf)
"K" = (
/obj/structure/barricade/sandbags{
	resistance_flags = 64
	},
/turf/open/floor/plating/beach/water,
/area/ctf)
"L" = (
/obj/structure/barricade/sandbags{
	resistance_flags = 64
	},
/turf/open/floor/plating/beach/sand,
/area/ctf)
"N" = (
/turf/open/floor/plating/beach/sand,
/area/ctf)
"O" = (
/obj/effect/turf_decal/tile/blue,
/obj/effect/turf_decal/tile/blue{
	dir = 1
	},
/obj/effect/turf_decal/tile/blue{
	dir = 8
	},
/obj/effect/turf_decal/tile/blue{
	dir = 4
	},
/turf/open/floor/plasteel,
/area/ctf)
"Q" = (
/turf/closed/wall/mineral/wood,
/area/ctf)
"U" = (
/obj/structure/barricade/security/ctf,
/turf/open/floor/plating/beach/water,
/area/ctf)
"V" = (
/obj/structure/trap/ctf/yellow,
/turf/open/floor/plasteel,
/area/ctf)
"W" = (
/obj/effect/turf_decal/tile/yellow,
/obj/effect/turf_decal/tile/yellow{
	dir = 8
	},
/obj/effect/turf_decal/tile/yellow{
	dir = 1
	},
/obj/effect/turf_decal/tile/yellow{
	dir = 4
	},
/turf/open/floor/plasteel,
/area/ctf)
"Y" = (
/turf/open/floor/plating/beach/water,
/area/ctf)

(1,1,1) = {"
a
a
a
a
a
a
a
a
a
a
a
a
a
a
a
a
a
a
a
a
a
a
a
a
a
a
a
a
a
a
a
a
a
a
a
a
a
a
a
a
a
a
a
a
a
a
a
a
a
a
"}
(2,1,1) = {"
a
D
m
m
m
m
a
Y
Y
Y
Y
Y
Y
Y
Y
Y
Y
Y
Y
Y
Y
Y
K
Y
Y
o
N
N
N
N
L
N
N
N
N
N
N
N
N
L
N
N
N
N
N
N
N
N
N
a
"}
(3,1,1) = {"
a
m
m
m
m
m
a
Y
K
Y
Y
Y
Y
Y
Y
Y
Y
Y
Y
Y
K
Y
K
Y
U
o
H
N
L
N
L
N
N
N
N
N
N
N
N
L
N
N
N
N
N
N
N
N
N
a
"}
(4,1,1) = {"
a
m
m
m
m
m
p
Y
K
Y
Y
Y
Y
Y
Y
Y
Y
Y
Y
Y
K
Y
K
Y
Y
o
N
N
L
N
L
N
N
N
N
N
N
N
N
L
N
N
N
N
N
N
N
N
N
a
"}
(5,1,1) = {"
a
m
m
m
m
m
a
Y
K
Y
Y
Y
Y
Y
Y
Y
Y
Y
Y
Y
K
Y
K
Y
U
o
H
N
L
N
L
N
N
N
N
N
N
N
N
E
E
E
F
E
E
E
N
N
N
a
"}
(6,1,1) = {"
a
m
m
m
m
m
a
Y
K
Y
Y
Y
Y
Y
Y
Y
Y
Y
Y
Y
K
Y
K
Y
Y
o
N
N
L
N
L
N
N
N
N
N
N
N
N
E
W
W
W
W
W
E
N
N
N
a
"}
(7,1,1) = {"
a
a
a
p
a
a
a
Y
Y
Y
Y
Y
Y
Y
Y
Y
Y
Y
Y
Y
K
Y
K
Y
U
o
H
N
L
N
L
N
N
N
N
N
N
N
N
G
W
B
B
B
W
E
N
N
N
a
"}
(8,1,1) = {"
a
Y
Y
Y
Y
Y
Y
Y
K
Y
Y
Y
Y
Y
Y
Y
Y
Y
Y
Y
K
Y
K
Y
Y
o
N
N
L
N
L
N
N
N
N
N
N
N
N
G
W
B
i
B
W
F
N
N
N
a
"}
(9,1,1) = {"
a
Y
K
K
K
K
Y
K
K
Y
Y
Y
Y
Y
Y
Y
Y
Y
Y
Y
K
Y
K
Y
U
o
H
N
L
N
L
N
N
N
N
N
N
N
N
G
W
B
B
B
W
E
N
N
N
a
"}
(10,1,1) = {"
a
Y
Y
Y
Y
Y
Y
Y
K
Y
Y
Y
Y
Y
Y
Y
Y
Y
Y
Y
K
Y
K
Y
Y
o
N
N
L
N
L
N
N
N
N
N
N
N
N
E
W
W
W
W
W
E
N
N
N
a
"}
(11,1,1) = {"
a
Y
Y
Y
Y
Y
Y
Y
K
Y
Y
Y
Y
Y
Y
Y
Y
Y
Y
Y
K
Y
K
Y
U
o
H
N
L
N
L
N
L
L
L
L
L
L
N
E
E
E
F
E
E
E
N
N
N
a
"}
(12,1,1) = {"
a
Y
Y
Y
Y
Y
Y
Y
Y
Y
Y
Y
Y
Y
Y
Y
Y
Y
Y
Y
K
Y
K
Y
Y
v
N
N
L
N
L
N
N
N
N
N
N
N
N
N
N
L
N
N
N
N
N
N
N
a
"}
(13,1,1) = {"
a
Y
Y
Y
Y
Y
Y
Y
K
Y
Y
Y
Y
Y
Y
Y
Y
Y
Y
Y
K
Y
K
Y
Y
v
N
N
L
N
L
N
N
N
N
N
N
N
N
N
N
L
N
N
N
N
N
N
N
a
"}
(14,1,1) = {"
a
Y
Y
Y
Y
Y
Y
Y
K
Y
Y
Y
Y
Y
Y
Y
Y
Y
Y
Y
K
Y
K
Y
Y
v
N
N
L
N
L
N
N
N
N
N
N
N
N
N
N
N
N
N
N
N
N
N
N
a
"}
(15,1,1) = {"
a
Y
Y
Y
Q
Q
Q
F
Q
Q
Q
Y
K
K
K
K
K
K
K
Y
K
Y
K
Y
U
o
H
N
L
N
L
N
N
N
N
N
N
N
N
N
N
L
N
N
N
N
N
N
N
a
"}
(16,1,1) = {"
a
Y
Y
Y
Q
O
O
O
O
O
Q
Y
Y
Y
Y
Y
Y
Y
Y
Y
K
Y
K
Y
Y
o
N
N
L
N
L
N
N
N
N
N
N
N
N
N
N
L
N
N
N
N
N
N
N
a
"}
(17,1,1) = {"
a
Y
Y
Y
Q
O
c
c
c
O
G
Y
Y
Y
Y
Y
Y
Y
Y
Y
K
Y
K
Y
U
o
H
N
L
N
L
N
N
N
N
N
N
N
N
N
N
L
L
N
L
L
L
L
N
a
"}
(18,1,1) = {"
a
Y
Y
Y
F
O
c
k
c
O
G
Y
Y
Y
Y
Y
Y
Y
Y
Y
K
Y
K
Y
Y
o
N
N
L
N
L
N
N
N
N
N
N
N
N
N
N
L
N
N
N
N
N
N
N
a
"}
(19,1,1) = {"
a
Y
Y
Y
Q
O
c
c
c
O
G
Y
Y
Y
Y
Y
Y
Y
Y
Y
K
Y
K
Y
U
o
H
N
L
N
L
N
N
N
N
N
N
N
N
N
N
N
N
a
a
a
V
a
a
a
"}
(20,1,1) = {"
a
Y
Y
Y
Q
O
O
O
O
O
Q
Y
Y
Y
Y
Y
Y
Y
Y
Y
K
Y
K
Y
Y
o
N
N
L
N
L
N
N
N
N
N
N
N
N
N
N
L
N
a
n
n
n
n
n
a
"}
(21,1,1) = {"
a
Y
Y
Y
Q
Q
Q
F
Q
Q
Q
Y
Y
Y
Y
Y
Y
Y
Y
Y
K
Y
K
Y
U
o
H
N
L
N
L
N
N
N
N
N
N
N
N
N
N
L
N
a
n
n
n
n
n
a
"}
(22,1,1) = {"
a
Y
Y
Y
Y
Y
Y
Y
Y
Y
K
Y
Y
Y
Y
Y
Y
Y
Y
Y
K
Y
K
Y
Y
o
N
N
L
N
L
N
N
N
N
N
N
N
N
N
N
L
N
V
n
n
n
n
n
a
"}
(23,1,1) = {"
a
Y
Y
Y
Y
Y
Y
Y
Y
Y
K
Y
Y
Y
Y
Y
Y
Y
Y
Y
K
Y
K
Y
U
o
H
N
L
N
L
N
N
N
N
N
N
N
N
N
N
L
N
a
n
n
n
n
n
a
"}
(24,1,1) = {"
a
Y
Y
Y
Y
Y
Y
Y
Y
Y
K
Y
Y
Y
Y
Y
Y
Y
Y
Y
K
Y
Y
Y
Y
o
N
N
L
N
N
N
N
N
N
N
N
N
N
N
N
N
N
a
n
n
n
n
s
a
"}
(25,1,1) = {"
a
a
a
a
a
a
a
a
a
a
a
a
a
a
a
a
a
a
a
a
a
a
a
a
a
a
a
a
a
a
a
a
a
a
a
a
a
a
a
a
a
a
a
a
a
a
a
a
a
a
"}
