//MAP CONVERTED BY dmm2tgm.py THIS HEADER COMMENT PREVENTS RECONVERSION, DO NOT REMOVE
"a" = (
/obj/effect/turf_decal/tile/dark,
/obj/effect/turf_decal/tile/dark{
	dir = 8
	},
/turf/open/floor/plasteel,
/area/tournament)
"c" = (
/obj/machinery/door/poddoor{
	id = "arena_default";
	name = "FUCK THIS DOOR FUCK YOU LET ME IN FUCK FUCK"
	},
/obj/effect/turf_decal/tile/dark{
	dir = 1
	},
/obj/effect/turf_decal/tile/dark{
	dir = 4
	},
/turf/open/floor/plasteel,
/area/tournament)
"e" = (
/obj/machinery/door/poddoor{
	id = "arena_default";
	name = "FUCK THIS DOOR FUCK YOU LET ME IN FUCK FUCK"
	},
/obj/effect/turf_decal/tile/dark,
/obj/effect/turf_decal/tile/dark{
	dir = 8
	},
/turf/open/floor/plasteel,
/area/tournament)
"g" = (
/obj/effect/turf_decal/tile/dark,
/obj/effect/turf_decal/tile/dark{
	dir = 1
	},
/obj/effect/turf_decal/tile/dark{
	dir = 8
	},
/turf/open/floor/plasteel,
/area/tournament)
"k" = (
/obj/machinery/arena_spawn/red,
/obj/effect/turf_decal/tile/dark{
	dir = 1
	},
/obj/effect/turf_decal/tile/dark{
	dir = 4
	},
/obj/effect/turf_decal/tile/dark{
	dir = 8
	},
/turf/open/floor/plasteel,
/area/tournament)
"l" = (
/obj/effect/turf_decal/tile/dark{
	dir = 1
	},
/obj/effect/turf_decal/tile/dark{
	dir = 4
	},
/turf/open/floor/plasteel,
/area/tournament)
"s" = (
/obj/effect/turf_decal/tile/dark{
	dir = 1
	},
/obj/effect/turf_decal/tile/dark{
	dir = 8
	},
/turf/open/floor/plasteel,
/area/tournament)
"t" = (
/obj/effect/baseturf_helper/dune,
/turf/closed/wall,
/area/tournament)
"v" = (
/obj/effect/turf_decal/tile/dark{
	dir = 4
	},
/obj/effect/turf_decal/tile/dark,
/turf/open/floor/plasteel,
/area/tournament)
"H" = (
/obj/machinery/arena_spawn/green,
/obj/effect/turf_decal/tile/dark,
/obj/effect/turf_decal/tile/dark{
	dir = 4
	},
/obj/effect/turf_decal/tile/dark{
	dir = 8
	},
/turf/open/floor/plasteel,
/area/tournament)
"N" = (
/turf/open/floor/plasteel,
/area/tournament)
"T" = (
/obj/machinery/door/poddoor{
	id = "arena_default";
	name = "FUCK THIS DOOR FUCK YOU LET ME IN FUCK FUCK"
	},
/obj/effect/turf_decal/tile/dark{
	dir = 4
	},
/obj/effect/turf_decal/tile/dark,
/turf/open/floor/plasteel,
/area/tournament)
"W" = (
/obj/machinery/door/poddoor{
	id = "arena_default";
	name = "FUCK THIS DOOR FUCK YOU LET ME IN FUCK FUCK"
	},
/obj/effect/turf_decal/tile/dark{
	dir = 1
	},
/obj/effect/turf_decal/tile/dark{
	dir = 8
	},
/turf/open/floor/plasteel,
/area/tournament)
"X" = (
/turf/closed/wall,
/area/tournament)
"Y" = (
/obj/effect/turf_decal/tile/dark{
	dir = 1
	},
/obj/effect/turf_decal/tile/dark{
	dir = 4
	},
/obj/effect/turf_decal/tile/dark,
/turf/open/floor/plasteel,
/area/tournament)

(1,1,1) = {"
t
X
X
X
X
X
X
X
X
X
X
X
"}
(2,1,1) = {"
X
k
W
s
s
s
s
s
s
s
g
X
"}
(3,1,1) = {"
X
c
N
N
N
N
N
N
N
N
a
X
"}
(4,1,1) = {"
X
l
N
N
N
N
N
N
N
N
a
X
"}
(5,1,1) = {"
X
l
N
N
N
N
N
N
N
N
a
X
"}
(6,1,1) = {"
X
l
N
N
N
N
N
N
N
N
a
X
"}
(7,1,1) = {"
X
l
N
N
N
N
N
N
N
N
a
X
"}
(8,1,1) = {"
X
l
N
N
N
N
N
N
N
N
a
X
"}
(9,1,1) = {"
X
l
N
N
N
N
N
N
N
N
a
X
"}
(10,1,1) = {"
X
l
N
N
N
N
N
N
N
N
e
X
"}
(11,1,1) = {"
X
Y
v
v
v
v
v
v
v
T
H
X
"}
(12,1,1) = {"
X
X
X
X
X
X
X
X
X
X
X
X
"}
