//MAP CONVERTED BY dmm2tgm.py THIS HEADER COMMENT PREVENTS RECONVERSION, DO NOT REMOVE
"a" = (
/turf/open/floor/wood/large,
/area/ctf)
"j" = (
/turf/open/floor/wood/tile,
/area/ctf)
"t" = (
/obj/machinery/arena_spawn/green,
/turf/open/floor/wood/tile,
/area/ctf)
"u" = (
/obj/machinery/arena_spawn/red,
/turf/open/floor/wood/tile,
/area/ctf)
"C" = (
/obj/structure/closet/cabinet{
	anchored = 1
	},
/obj/effect/turf_decal/box,
/turf/open/floor/wood/large,
/area/ctf)
"F" = (
/obj/effect/baseturf_helper/dune,
/turf/closed/wall/mineral/wood/nonmetal,
/area/ctf)
"H" = (
/turf/closed/wall/mineral/wood/nonmetal,
/area/ctf)
"J" = (
/turf/open/floor/wood/parquet,
/area/ctf)
"V" = (
/obj/structure/bookcase/random/adult,
/obj/machinery/door/poddoor{
	id = "arena_default";
	name = "FUCK THIS DOOR FUCK YOU LET ME IN FUCK FUCK"
	},
/turf/open/floor/wood/parquet,
/area/ctf)
"Y" = (
/obj/structure/bookcase/random/adult,
/turf/open/floor/wood/parquet,
/area/ctf)
"Z" = (
/obj/machinery/door/poddoor{
	id = "arena_default";
	name = "FUCK THIS DOOR FUCK YOU LET ME IN FUCK FUCK"
	},
/turf/open/floor/wood/tile,
/area/ctf)

(1,1,1) = {"
F
H
H
H
H
H
H
H
H
H
H
H
H
H
H
H
H
H
H
"}
(2,1,1) = {"
H
Y
Y
Y
Y
Y
Y
Y
Y
Y
Y
Y
Y
Y
Y
Y
Y
V
H
"}
(3,1,1) = {"
H
j
j
j
j
j
j
j
j
j
j
j
j
j
j
j
Z
u
H
"}
(4,1,1) = {"
H
j
J
J
J
J
J
J
J
J
J
J
J
J
J
J
J
Z
H
"}
(5,1,1) = {"
H
j
Y
C
C
C
C
C
C
Y
C
C
C
C
C
C
Y
j
H
"}
(6,1,1) = {"
H
j
J
a
a
a
a
a
a
a
a
a
a
a
a
a
J
j
H
"}
(7,1,1) = {"
H
j
Y
C
C
C
C
C
C
Y
C
C
C
C
C
C
Y
j
H
"}
(8,1,1) = {"
H
j
J
a
a
a
a
a
a
a
a
a
a
a
a
a
J
j
H
"}
(9,1,1) = {"
H
j
Y
C
C
C
C
C
C
Y
C
C
C
C
C
C
Y
j
H
"}
(10,1,1) = {"
H
j
J
a
a
a
a
a
a
a
a
a
a
a
a
a
J
j
H
"}
(11,1,1) = {"
H
j
Y
C
C
C
C
C
C
Y
C
C
C
C
C
C
Y
j
H
"}
(12,1,1) = {"
H
j
J
a
a
a
a
a
a
a
a
a
a
a
a
a
J
j
H
"}
(13,1,1) = {"
H
j
Y
C
C
C
C
C
C
Y
C
C
C
C
C
C
Y
j
H
"}
(14,1,1) = {"
H
j
J
a
a
a
a
a
a
a
a
a
a
a
a
a
J
j
H
"}
(15,1,1) = {"
H
j
Y
C
C
C
C
C
C
Y
C
C
C
C
C
C
Y
j
H
"}
(16,1,1) = {"
H
Z
J
J
J
J
J
J
J
J
J
J
J
J
J
J
J
j
H
"}
(17,1,1) = {"
H
t
Z
j
j
j
j
j
j
j
j
j
j
j
j
j
j
j
H
"}
(18,1,1) = {"
H
V
Y
Y
Y
Y
Y
Y
Y
Y
Y
Y
Y
Y
Y
Y
Y
Y
H
"}
(19,1,1) = {"
H
H
H
H
H
H
H
H
H
H
H
H
H
H
H
H
H
H
H
"}
