//MAP CONVERTED BY dmm2tgm.py THIS HEADER COMMENT PREVENTS RECONVERSION, DO NOT REMOVE
"a" = (
/obj/machinery/door/airlock/wood/glass,
/turf/open/floor/rospilovo/wood,
/area/tournament)
"d" = (
/turf/open/floor/beton,
/area/tournament)
"i" = (
/turf/closed/wall/brick,
/area/tournament)
"p" = (
/turf/open/floor/rospilovo/wood,
/area/tournament)
"w" = (
/obj/structure/rospilovo/musor_yashik/red,
/turf/open/floor/trot,
/area/tournament)
"y" = (
/obj/structure/table/rospilovo,
/turf/open/floor/rospilovo/wood,
/area/tournament)
"A" = (
/obj/machinery/arena_spawn/green,
/turf/open/floor/beton,
/area/tournament)
"B" = (
/obj/effect/baseturf_helper/dune,
/turf/closed/wall/brick,
/area/tournament)
"D" = (
/turf/open/floor/trot,
/area/tournament)
"E" = (
/obj/structure/rospilovo/okno{
	icon_state = "okno4"
	},
/turf/closed/wall/brick,
/area/tournament)
"T" = (
/obj/machinery/arena_spawn/red,
/turf/open/floor/beton,
/area/tournament)
"V" = (
/obj/structure/rospilovo/stolb,
/turf/open/floor/trot,
/area/tournament)
"W" = (
/obj/machinery/door/poddoor{
	id = "arena_default";
	name = "FUCK THIS DOOR FUCK YOU LET ME IN FUCK FUCK"
	},
/turf/open/floor/beton,
/area/tournament)

(1,1,1) = {"
B
i
i
i
E
i
i
i
i
i
E
i
i
i
i
i
E
i
i
i
i
"}
(2,1,1) = {"
i
d
d
d
d
d
d
d
d
d
d
d
d
d
d
d
d
d
W
T
i
"}
(3,1,1) = {"
i
d
d
d
d
d
d
d
d
d
d
d
d
d
d
d
d
d
d
W
i
"}
(4,1,1) = {"
i
d
d
d
d
d
d
d
d
d
d
d
d
d
d
d
d
d
d
d
i
"}
(5,1,1) = {"
i
D
V
d
d
d
V
w
D
D
D
D
D
w
V
d
d
d
V
D
i
"}
(6,1,1) = {"
i
i
w
d
d
d
w
i
E
i
a
i
E
i
w
d
d
d
w
i
i
"}
(7,1,1) = {"
i
E
D
d
d
d
D
E
p
p
p
p
p
E
D
d
d
d
D
E
i
"}
(8,1,1) = {"
i
i
D
d
d
d
D
i
p
y
p
y
p
i
D
d
d
d
D
i
i
"}
(9,1,1) = {"
i
E
D
d
d
d
D
E
p
y
p
y
p
E
D
d
d
d
D
E
i
"}
(10,1,1) = {"
i
i
D
d
d
d
D
i
p
y
p
y
p
i
D
d
d
d
D
i
i
"}
(11,1,1) = {"
i
i
D
d
d
d
D
a
p
p
p
p
p
a
D
d
d
d
D
i
i
"}
(12,1,1) = {"
i
i
D
d
d
d
D
i
p
y
p
y
p
i
D
d
d
d
D
i
i
"}
(13,1,1) = {"
i
E
D
d
d
d
D
E
p
y
p
y
p
E
D
d
d
d
D
E
i
"}
(14,1,1) = {"
i
i
D
d
d
d
D
i
p
y
p
y
p
i
D
d
d
d
D
i
i
"}
(15,1,1) = {"
i
E
D
d
d
d
D
E
p
p
p
p
p
E
D
d
d
d
D
E
i
"}
(16,1,1) = {"
i
i
w
d
d
d
w
i
E
i
a
i
i
i
w
d
d
d
w
i
i
"}
(17,1,1) = {"
i
D
V
d
d
d
V
w
D
D
D
D
D
w
V
d
d
d
V
D
i
"}
(18,1,1) = {"
i
d
d
d
d
d
d
d
d
d
d
d
d
d
d
d
d
d
d
d
i
"}
(19,1,1) = {"
i
W
d
d
d
d
d
d
d
d
d
d
d
d
d
d
d
d
d
d
i
"}
(20,1,1) = {"
i
A
W
d
d
d
d
d
d
d
d
d
d
d
d
d
d
d
d
d
i
"}
(21,1,1) = {"
i
i
i
i
E
i
i
i
i
i
E
i
i
i
i
i
E
i
i
i
i
"}
