//MAP CONVERTED BY dmm2tgm.py THIS HEADER COMMENT PREVENTS RECONVERSION, DO NOT REMOVE
"a" = (
/turf/open/floor/plating/asteroid/basalt,
/area/ctf)
"d" = (
/obj/machinery/door/poddoor{
	id = "arena_default";
	name = "FUCK THIS DOOR FUCK YOU LET ME IN FUCK FUCK"
	},
/turf/open/floor/plating/asteroid/basalt,
/area/ctf)
"f" = (
/obj/effect/baseturf_helper/dune,
/turf/closed/mineral/magmite,
/area/ctf)
"p" = (
/obj/machinery/arena_spawn/green,
/turf/open/floor/plating/asteroid/basalt,
/area/ctf)
"w" = (
/obj/machinery/arena_spawn/red,
/turf/open/floor/plating/asteroid/basalt,
/area/ctf)
"y" = (
/turf/open/lava/smooth,
/area/ctf)
"L" = (
/turf/closed/mineral/magmite,
/area/ctf)
"Y" = (
/obj/structure/glowshroom,
/turf/open/floor/plating/asteroid/basalt,
/area/ctf)

(1,1,1) = {"
f
L
L
L
L
L
L
L
L
L
L
L
L
L
L
L
L
L
L
L
L
L
L
"}
(2,1,1) = {"
L
a
a
a
a
a
a
a
a
a
a
a
a
a
a
a
a
a
a
a
d
w
L
"}
(3,1,1) = {"
L
a
a
a
a
a
a
a
a
a
Y
a
a
a
a
a
a
a
a
a
a
d
L
"}
(4,1,1) = {"
L
a
a
Y
a
a
Y
a
a
a
a
a
a
a
a
a
a
a
Y
a
a
a
L
"}
(5,1,1) = {"
L
a
a
Y
a
a
a
a
a
a
a
a
a
a
a
Y
a
a
a
a
a
a
L
"}
(6,1,1) = {"
L
a
a
a
a
a
a
a
a
a
a
a
a
a
a
a
a
a
a
a
a
a
L
"}
(7,1,1) = {"
L
a
a
a
a
a
a
a
a
a
a
a
a
a
a
a
a
a
a
a
a
a
L
"}
(8,1,1) = {"
L
a
y
y
y
y
a
y
y
a
y
a
y
a
y
y
a
y
y
y
y
a
L
"}
(9,1,1) = {"
L
y
y
a
a
y
y
y
a
a
a
a
a
a
a
y
y
y
a
a
y
y
L
"}
(10,1,1) = {"
L
y
a
a
a
a
y
a
a
a
a
a
a
Y
a
a
y
a
a
a
a
y
L
"}
(11,1,1) = {"
L
y
a
a
a
a
y
a
a
a
y
y
y
a
a
a
y
a
a
a
a
y
L
"}
(12,1,1) = {"
L
y
a
a
Y
a
y
a
a
y
a
a
a
y
a
a
y
a
Y
a
a
y
L
"}
(13,1,1) = {"
L
y
a
a
a
a
y
a
a
a
y
y
y
a
a
a
y
a
a
a
a
y
L
"}
(14,1,1) = {"
L
y
a
a
a
a
y
a
a
Y
a
a
a
a
a
a
y
a
a
a
a
y
L
"}
(15,1,1) = {"
L
y
y
a
a
y
y
y
a
a
a
a
a
a
a
y
y
y
a
a
y
y
L
"}
(16,1,1) = {"
L
a
y
y
y
y
a
y
y
a
y
a
y
a
y
y
a
y
y
y
y
a
L
"}
(17,1,1) = {"
L
a
a
a
a
a
a
a
a
a
a
a
a
a
a
a
a
a
a
a
a
a
L
"}
(18,1,1) = {"
L
a
a
a
a
a
a
a
a
a
a
Y
a
a
a
a
a
a
a
a
a
a
L
"}
(19,1,1) = {"
L
a
a
a
a
a
a
a
Y
a
a
a
a
a
a
a
Y
a
a
a
a
a
L
"}
(20,1,1) = {"
L
a
a
a
Y
a
a
a
a
a
a
a
a
a
a
a
a
a
a
a
a
a
L
"}
(21,1,1) = {"
L
d
a
a
a
a
a
a
a
a
a
a
a
a
a
a
a
a
Y
a
a
a
L
"}
(22,1,1) = {"
L
p
d
a
a
a
a
a
a
a
a
Y
a
a
a
a
a
a
a
a
a
a
L
"}
(23,1,1) = {"
L
L
L
L
L
L
L
L
L
L
L
L
L
L
L
L
L
L
L
L
L
L
L
"}
