//MAP CONVERTED BY dmm2tgm.py THIS HEADER COMMENT PREVENTS RECONVERSION, DO NOT REMOVE
"a" = (
/turf/closed/mineral/ash_rock,
/area/tournament)
"e" = (
/obj/structure/flora/grass/jungle/b,
/turf/open/floor/plating/grass/jungle,
/area/tournament)
"f" = (
/obj/structure/flora/grass/jungle,
/turf/open/floor/plating/grass/jungle,
/area/tournament)
"g" = (
/obj/structure/flora/ausbushes/brflowers,
/turf/open/floor/plating/grass/jungle,
/area/tournament)
"i" = (
/obj/structure/flora/bush,
/turf/open/floor/plating/grass/jungle,
/area/tournament)
"k" = (
/obj/structure/flora/stump,
/turf/open/floor/plating/grass/jungle,
/area/tournament)
"l" = (
/obj/structure/flora/rock/pile/largejungle,
/turf/open/floor/plating/grass/jungle,
/area/tournament)
"m" = (
/obj/machinery/door/poddoor{
	id = "arena_default";
	name = "FUCK THIS DOOR FUCK YOU LET ME IN FUCK FUCK"
	},
/turf/open/floor/plating/grass/jungle,
/area/tournament)
"n" = (
/obj/structure/flora/tree/jungle,
/turf/open/floor/plating/grass/jungle,
/area/tournament)
"o" = (
/obj/structure/flora/ausbushes/sparsegrass,
/turf/open/floor/plating/grass/jungle,
/area/tournament)
"p" = (
/obj/structure/flora/junglebush/large,
/turf/open/floor/plating/grass/jungle,
/area/tournament)
"q" = (
/obj/structure/flora/ausbushes/reedbush,
/turf/open/floor/plating/grass/jungle,
/area/tournament)
"s" = (
/obj/structure/flora/tree/jungle/small,
/turf/open/floor/plating/grass/jungle,
/area/tournament)
"t" = (
/obj/structure/flora/ausbushes/fernybush,
/turf/open/floor/plating/grass/jungle,
/area/tournament)
"w" = (
/obj/structure/flora/junglebush/b,
/obj/structure/flora/junglebush/large,
/turf/open/floor/plating/grass/jungle,
/area/tournament)
"x" = (
/obj/effect/baseturf_helper/dune,
/turf/closed/mineral/ash_rock,
/area/tournament)
"z" = (
/obj/machinery/arena_spawn/red,
/turf/open/floor/plating/grass/jungle,
/area/tournament)
"A" = (
/obj/structure/flora/ausbushes/genericbush,
/turf/open/floor/plating/grass/jungle,
/area/tournament)
"D" = (
/obj/structure/flora/ausbushes/sunnybush,
/turf/open/floor/plating/grass/jungle,
/area/tournament)
"F" = (
/obj/structure/flora/ausbushes/fullgrass,
/turf/open/floor/plating/grass/jungle,
/area/tournament)
"G" = (
/obj/structure/flora/tree/jungle/small,
/obj/structure/flora/junglebush/c,
/turf/open/floor/plating/grass/jungle,
/area/tournament)
"I" = (
/obj/structure/flora/rock/jungle,
/turf/open/floor/plating/grass/jungle,
/area/tournament)
"K" = (
/obj/structure/flora/ausbushes/ywflowers,
/turf/open/floor/plating/grass/jungle,
/area/tournament)
"L" = (
/obj/structure/flora/junglebush/b,
/turf/open/floor/plating/grass/jungle,
/area/tournament)
"M" = (
/obj/structure/flora/ausbushes/grassybush,
/turf/open/floor/plating/grass/jungle,
/area/tournament)
"N" = (
/obj/structure/flora/ausbushes/ppflowers,
/turf/open/floor/plating/grass/jungle,
/area/tournament)
"Q" = (
/obj/structure/flora/ausbushes/stalkybush,
/turf/open/floor/plating/grass/jungle,
/area/tournament)
"R" = (
/obj/structure/flora/junglebush,
/turf/open/floor/plating/grass/jungle,
/area/tournament)
"T" = (
/turf/open/floor/plating/grass/jungle,
/area/tournament)
"W" = (
/obj/structure/flora/ausbushes/pointybush,
/turf/open/floor/plating/grass/jungle,
/area/tournament)
"X" = (
/obj/machinery/arena_spawn/green,
/turf/open/floor/plating/grass/jungle,
/area/tournament)
"Y" = (
/obj/structure/flora/junglebush/c,
/turf/open/floor/plating/grass/jungle,
/area/tournament)
"Z" = (
/obj/structure/flora/biolumi,
/turf/open/floor/plating/grass/jungle,
/area/tournament)

(1,1,1) = {"
x
a
a
a
a
a
a
a
a
a
a
a
a
a
a
a
a
a
a
a
a
a
a
a
a
"}
(2,1,1) = {"
a
T
T
T
T
T
T
T
n
T
T
t
T
T
T
T
T
T
T
T
K
T
m
z
a
"}
(3,1,1) = {"
a
T
n
T
T
T
T
T
T
p
T
T
T
T
T
T
T
T
l
T
T
T
T
m
a
"}
(4,1,1) = {"
a
T
T
T
T
N
T
T
Y
T
I
T
T
T
T
n
T
T
T
T
T
T
T
T
a
"}
(5,1,1) = {"
a
T
T
Y
T
T
T
T
T
T
q
T
T
T
T
T
T
T
t
T
T
T
T
T
a
"}
(6,1,1) = {"
a
T
T
T
T
T
T
G
T
L
T
T
T
s
T
T
T
l
T
T
L
T
T
T
a
"}
(7,1,1) = {"
a
T
T
T
i
T
T
T
A
N
F
T
T
T
T
k
T
T
T
T
T
p
T
T
a
"}
(8,1,1) = {"
a
T
T
n
T
T
T
T
T
T
T
p
T
T
T
T
T
F
T
T
s
T
T
T
a
"}
(9,1,1) = {"
a
T
T
T
T
T
T
T
n
T
T
T
T
T
T
T
n
T
T
T
T
T
T
T
a
"}
(10,1,1) = {"
a
T
T
T
T
s
T
T
T
T
T
T
s
T
T
T
T
T
e
T
T
T
T
T
a
"}
(11,1,1) = {"
a
T
I
T
T
T
T
T
T
k
T
T
T
T
T
T
F
T
R
T
q
T
T
T
a
"}
(12,1,1) = {"
a
T
T
Z
T
l
T
T
p
T
M
T
l
T
T
p
T
T
T
T
T
F
I
T
a
"}
(13,1,1) = {"
a
T
T
N
T
T
T
T
T
T
T
R
T
T
o
T
T
T
T
T
T
T
T
T
a
"}
(14,1,1) = {"
a
T
Y
T
T
g
T
T
s
T
D
T
p
T
T
T
T
T
s
T
T
T
n
T
a
"}
(15,1,1) = {"
a
T
T
T
s
T
T
T
T
T
T
T
T
Y
T
s
T
T
T
T
T
T
T
T
a
"}
(16,1,1) = {"
a
T
T
T
w
W
T
T
T
T
n
T
T
T
T
T
T
t
T
T
T
T
T
T
a
"}
(17,1,1) = {"
a
T
T
T
T
T
T
T
T
T
T
Q
T
l
T
T
T
T
s
T
T
T
T
T
a
"}
(18,1,1) = {"
a
T
T
T
T
I
T
M
T
T
T
T
T
T
T
T
T
T
T
T
k
T
l
T
a
"}
(19,1,1) = {"
a
T
T
n
T
T
k
T
T
T
s
T
T
T
T
p
T
T
T
T
T
T
T
T
a
"}
(20,1,1) = {"
a
T
T
T
T
T
L
T
T
T
T
T
T
n
T
T
T
T
T
T
Y
T
T
T
a
"}
(21,1,1) = {"
a
T
T
Y
T
T
K
T
T
T
T
T
T
T
T
T
T
t
T
T
T
T
T
T
a
"}
(22,1,1) = {"
a
T
T
T
l
T
K
T
T
s
f
T
T
T
T
Y
T
T
T
T
T
T
T
T
a
"}
(23,1,1) = {"
a
m
T
T
T
T
T
T
T
T
T
T
T
T
T
T
T
T
T
T
T
T
n
T
a
"}
(24,1,1) = {"
a
X
m
T
T
T
T
T
T
T
T
K
T
T
T
T
n
T
T
T
T
T
T
T
a
"}
(25,1,1) = {"
a
a
a
a
a
a
a
a
a
a
a
a
a
a
a
a
a
a
a
a
a
a
a
a
a
"}
