//MAP CONVERTED BY dmm2tgm.py THIS HEADER COMMENT PREVENTS RECONVERSION, DO NOT REMOVE
"a" = (
/turf/open/floor/plasteel/tg/dark/small,
/area/tournament)
"d" = (
/obj/effect/turf_decal/tile/dark_blue{
	dir = 1
	},
/obj/effect/turf_decal/tile/dark_blue{
	dir = 4
	},
/turf/open/floor/plasteel/tg/dark/textured,
/area/tournament)
"g" = (
/obj/effect/turf_decal/tile/dark_blue/anticorner/contrasted,
/turf/open/floor/plasteel/tg/dark/textured,
/area/tournament)
"h" = (
/obj/effect/baseturf_helper/dune,
/turf/closed/indestructible/iridium,
/area/tournament)
"j" = (
/obj/machinery/arena_spawn/red,
/obj/effect/turf_decal/tile/dark_red/opposingcorners,
/turf/open/floor/plasteel/tg/dark/textured,
/area/tournament)
"l" = (
/obj/effect/turf_decal/tile/dark_blue/anticorner/contrasted{
	dir = 8
	},
/turf/open/floor/plasteel/tg/dark/textured,
/area/tournament)
"m" = (
/turf/open/floor/plasteel/tg/dark/textured,
/area/tournament)
"t" = (
/obj/machinery/arena_spawn/green,
/obj/effect/turf_decal/tile/green/opposingcorners,
/turf/open/floor/plasteel/tg/dark/textured,
/area/tournament)
"u" = (
/turf/closed/indestructible/iridium,
/area/tournament)
"A" = (
/obj/effect/turf_decal/tile/green/opposingcorners,
/turf/open/floor/plasteel/tg/dark/textured,
/area/tournament)
"G" = (
/obj/effect/turf_decal/tile/dark_blue/anticorner/contrasted{
	dir = 1
	},
/turf/open/floor/plasteel/tg/dark/textured,
/area/tournament)
"J" = (
/obj/machinery/door/poddoor{
	id = "arena_default";
	name = "FUCK THIS DOOR FUCK YOU LET ME IN FUCK FUCK"
	},
/turf/open/floor/plasteel/tg/dark/textured_large,
/area/tournament)
"K" = (
/obj/effect/mapping_helpers/turf_rotation,
/turf/open/floor/plasteel/tg/dark/textured_large,
/area/tournament)
"M" = (
/obj/effect/turf_decal/tile/dark_red/opposingcorners,
/turf/open/floor/plasteel/tg/dark/textured,
/area/tournament)
"R" = (
/obj/effect/turf_decal/tile/dark_blue,
/obj/effect/turf_decal/tile/dark_blue{
	dir = 4
	},
/turf/open/floor/plasteel/tg/dark/textured,
/area/tournament)
"S" = (
/obj/effect/mapping_helpers/turf_rotation,
/turf/open/floor/plasteel/tg/dark/small,
/area/tournament)
"U" = (
/obj/effect/turf_decal/tile/dark_blue/anticorner/contrasted{
	dir = 4
	},
/turf/open/floor/plasteel/tg/dark/textured,
/area/tournament)
"W" = (
/obj/effect/turf_decal/tile/dark_blue,
/obj/effect/turf_decal/tile/dark_blue{
	dir = 8
	},
/turf/open/floor/plasteel/tg/dark/textured,
/area/tournament)
"Y" = (
/obj/effect/turf_decal/tile/dark_blue{
	dir = 1
	},
/obj/effect/turf_decal/tile/dark_blue{
	dir = 8
	},
/turf/open/floor/plasteel/tg/dark/textured,
/area/tournament)

(1,1,1) = {"
h
u
u
u
u
u
u
u
"}
(2,1,1) = {"
u
a
a
a
a
a
a
u
"}
(3,1,1) = {"
u
a
j
M
M
M
a
u
"}
(4,1,1) = {"
u
a
M
M
M
M
a
u
"}
(5,1,1) = {"
u
a
M
M
M
M
a
u
"}
(6,1,1) = {"
u
a
M
M
M
M
a
u
"}
(7,1,1) = {"
u
u
J
J
J
J
u
u
"}
(8,1,1) = {"
u
S
K
K
K
K
S
u
"}
(9,1,1) = {"
u
S
K
K
K
K
S
u
"}
(10,1,1) = {"
u
G
Y
Y
Y
Y
l
u
"}
(11,1,1) = {"
u
d
m
m
m
m
W
u
"}
(12,1,1) = {"
u
d
m
m
m
m
W
u
"}
(13,1,1) = {"
u
d
m
m
m
m
W
u
"}
(14,1,1) = {"
u
d
m
m
m
m
W
u
"}
(15,1,1) = {"
u
U
R
R
R
R
g
u
"}
(16,1,1) = {"
u
S
K
K
K
K
S
u
"}
(17,1,1) = {"
u
S
K
K
K
K
S
u
"}
(18,1,1) = {"
u
u
J
J
J
J
u
u
"}
(19,1,1) = {"
u
a
A
A
A
A
a
u
"}
(20,1,1) = {"
u
a
A
A
A
A
a
u
"}
(21,1,1) = {"
u
a
A
A
A
A
a
u
"}
(22,1,1) = {"
u
a
A
A
A
t
a
u
"}
(23,1,1) = {"
u
a
a
a
a
a
a
u
"}
(24,1,1) = {"
u
u
u
u
u
u
u
u
"}
