//MAP CONVERTED BY dmm2tgm.py THIS HEADER COMMENT PREVENTS RECONVERSION, DO NOT REMOVE
"a" = (
/obj/effect/mapping_helpers/turf_rotation{
	current_turf_type = /turf/open/indestructible/backrooms
	},
/turf/closed/indestructible/backrooms,
/area/backrooms)
"v" = (
/obj/machinery/arena_spawn/green,
/turf/open/indestructible/backrooms,
/area/tournament)
"D" = (
/turf/closed/indestructible/backrooms,
/area/backrooms)
"M" = (
/turf/open/indestructible/backrooms,
/area/tournament)
"U" = (
/obj/machinery/arena_spawn/red,
/turf/open/indestructible/backrooms,
/area/tournament)
"Y" = (
/obj/effect/baseturf_helper/dune,
/turf/closed/indestructible/backrooms,
/area/backrooms)

(1,1,1) = {"
Y
D
D
D
D
D
D
D
D
D
D
D
D
D
D
D
D
D
D
D
D
D
D
D
"}
(2,1,1) = {"
D
a
a
a
a
a
a
a
a
a
a
a
a
a
a
a
a
a
a
a
M
M
M
D
"}
(3,1,1) = {"
D
a
a
a
a
a
a
a
a
a
a
a
a
a
a
a
a
a
a
a
M
v
M
D
"}
(4,1,1) = {"
D
a
a
a
a
a
a
a
a
a
a
a
a
a
a
a
a
a
a
a
M
M
M
D
"}
(5,1,1) = {"
D
a
a
a
D
D
a
a
a
a
a
a
a
a
a
a
a
a
D
D
a
a
a
D
"}
(6,1,1) = {"
D
a
a
a
D
a
a
a
a
a
a
a
a
a
a
a
a
a
a
D
a
a
a
D
"}
(7,1,1) = {"
D
a
a
a
a
a
a
a
a
a
a
a
a
a
a
a
a
a
a
a
a
a
a
D
"}
(8,1,1) = {"
D
a
a
a
a
a
a
a
a
a
a
a
a
a
a
a
a
a
a
a
a
a
a
D
"}
(9,1,1) = {"
D
a
a
a
a
a
a
a
a
a
a
a
a
a
a
a
a
a
a
a
a
a
a
D
"}
(10,1,1) = {"
D
a
a
a
a
a
a
a
a
a
a
a
a
a
a
a
a
a
a
a
a
a
a
D
"}
(11,1,1) = {"
D
a
a
a
a
a
a
a
a
a
a
a
a
a
a
a
a
a
a
a
a
a
a
D
"}
(12,1,1) = {"
D
a
a
a
a
a
a
a
a
a
a
a
a
a
a
a
a
a
a
a
a
a
a
D
"}
(13,1,1) = {"
D
a
a
a
a
a
a
a
a
a
a
a
a
a
a
a
a
a
a
a
a
a
a
D
"}
(14,1,1) = {"
D
a
a
a
a
a
a
a
a
a
a
a
a
a
a
a
a
a
a
a
a
a
a
D
"}
(15,1,1) = {"
D
a
a
a
a
a
a
a
a
a
a
a
a
a
a
a
a
a
a
a
a
a
a
D
"}
(16,1,1) = {"
D
a
a
a
a
a
a
a
a
a
a
a
a
a
a
a
a
a
a
a
a
a
a
D
"}
(17,1,1) = {"
D
a
a
a
a
a
a
a
a
a
a
a
a
a
a
a
a
a
a
a
a
a
a
D
"}
(18,1,1) = {"
D
a
a
a
a
a
a
a
a
a
a
a
a
a
a
a
a
a
a
a
a
a
a
D
"}
(19,1,1) = {"
D
a
a
a
D
a
a
a
a
a
a
a
a
a
a
a
a
a
a
D
a
a
a
D
"}
(20,1,1) = {"
D
a
a
a
D
D
a
a
a
a
a
a
a
a
a
a
a
a
D
D
a
a
a
D
"}
(21,1,1) = {"
D
M
M
M
a
a
a
a
a
a
a
a
a
a
a
a
a
a
a
a
a
a
a
D
"}
(22,1,1) = {"
D
M
U
M
a
a
a
a
a
a
a
a
a
a
a
a
a
a
a
a
a
a
a
D
"}
(23,1,1) = {"
D
M
M
M
a
a
a
a
a
a
a
a
a
a
a
a
a
a
a
a
a
a
a
D
"}
(24,1,1) = {"
D
D
D
D
D
D
D
D
D
D
D
D
D
D
D
D
D
D
D
D
D
D
D
D
"}
