//MAP CONVERTED BY dmm2tgm.py THIS HEADER COMMENT PREVENTS RECONVERSION, DO NOT REMOVE
"ay" = (
/obj/structure/barricade/wooden/crude/snow,
/obj/machinery/door/airlock/public/glass{
	max_integrity = 3000;
	normal_integrity = 3000
	},
/turf/open/floor/plasteel/dark,
/area/tournament)
"az" = (
/obj/machinery/arena_spawn/red,
/turf/open/floor/plasteel/dark,
/area/tournament)
"bU" = (
/obj/structure/fence{
	dir = 4
	},
/turf/closed/wall/ice,
/area/tournament)
"ct" = (
/obj/effect/spawner/structure/window/ice{
	max_integrity = 5000
	},
/obj/structure/snowflakes,
/obj/machinery/door/poddoor{
	id = "arena_default";
	name = "FUCK THIS DOOR FUCK YOU LET ME IN FUCK FUCK"
	},
/turf/open/floor/plating/snowed,
/area/tournament)
"cQ" = (
/turf/open/chasm/icemoon,
/area/tournament)
"ep" = (
/obj/machinery/arena_spawn/green,
/turf/open/floor/plasteel/dark,
/area/tournament)
"fi" = (
/obj/structure/railing/corner,
/obj/structure/deployable_barricade/snow{
	dir = 4
	},
/turf/open/floor/plating/snowed/safe,
/area/tournament)
"fw" = (
/obj/structure/rack,
/obj/item/gun/ballistic/shotgun/fallout/cowboy{
	pixel_y = 3
	},
/obj/item/gun/ballistic/shotgun/fallout/huntingshot{
	pixel_y = -5
	},
/turf/open/floor/plasteel/dark,
/area/tournament)
"gA" = (
/obj/structure/railing/corner,
/turf/open/floor/grass/snow/safe,
/area/tournament)
"gK" = (
/obj/structure/deployable_barricade/snow{
	dir = 4
	},
/turf/open/floor/grass/snow/safe,
/area/tournament)
"gS" = (
/obj/structure/railing/corner{
	dir = 1
	},
/turf/open/floor/grass/snow/safe,
/area/tournament)
"hw" = (
/obj/structure/deployable_barricade/snow{
	dir = 8
	},
/turf/open/floor/plating/snowed/smoothed/safe,
/area/tournament)
"hF" = (
/obj/structure/barricade/wooden/snowed,
/obj/structure/barricade/wooden/crude/snow,
/turf/open/floor/grass/snow/safe,
/area/tournament)
"jD" = (
/obj/structure/table,
/obj/machinery/recharger{
	pixel_x = -5
	},
/obj/machinery/recharger{
	pixel_x = 5
	},
/turf/open/floor/plasteel/dark,
/area/tournament)
"lq" = (
/obj/structure/railing/corner{
	dir = 4
	},
/turf/open/floor/grass/snow/safe,
/area/tournament)
"mC" = (
/obj/structure/barricade/wooden/snowed,
/turf/open/floor/grass/snow/safe,
/area/tournament)
"nr" = (
/turf/open/floor/plating/snowed/safe,
/area/tournament)
"nP" = (
/obj/structure/rack,
/obj/item/clothing/head/helmet{
	pixel_x = -4
	},
/obj/item/clothing/head/helmet{
	pixel_x = 3
	},
/turf/open/floor/plasteel/dark,
/area/tournament)
"pA" = (
/obj/structure/railing{
	dir = 4
	},
/turf/open/floor/grass/snow/safe,
/area/tournament)
"ti" = (
/obj/structure/flora/stump,
/turf/open/floor/grass/snow/safe,
/area/tournament)
"tY" = (
/obj/structure/rack,
/obj/item/stack/sheet/armor_plate/ceramic/three{
	pixel_x = -3
	},
/obj/item/stack/sheet/armor_plate/ablative/three{
	pixel_x = 3
	},
/obj/item/full_armor_upgrade,
/obj/item/full_armor_upgrade,
/turf/open/floor/plasteel/dark,
/area/tournament)
"vm" = (
/obj/structure/snowflakes,
/obj/effect/spawner/structure/window/ice{
	max_integrity = 5000
	},
/obj/machinery/door/poddoor{
	id = "arena_default";
	name = "FUCK THIS DOOR FUCK YOU LET ME IN FUCK FUCK"
	},
/turf/open/floor/plating/snowed,
/area/tournament)
"wX" = (
/obj/structure/rack,
/obj/item/melee/baseball_bat/ablative,
/obj/item/forcefield_projector,
/turf/open/floor/plasteel/dark,
/area/tournament)
"yJ" = (
/turf/open/floor/plasteel/dark,
/area/tournament)
"Ac" = (
/obj/structure/railing/corner{
	dir = 8
	},
/obj/structure/deployable_barricade/snow{
	dir = 8
	},
/turf/open/floor/plating/snowed/safe,
/area/tournament)
"Be" = (
/obj/effect/spawner/structure/window/ice,
/obj/structure/snowflakes,
/obj/machinery/door/poddoor{
	id = "arena_default";
	name = "FUCK THIS DOOR FUCK YOU LET ME IN FUCK FUCK"
	},
/turf/open/floor/plating/snowed,
/area/tournament)
"Bs" = (
/obj/structure/railing/corner{
	dir = 4
	},
/obj/structure/deployable_barricade/snow{
	dir = 4
	},
/turf/open/floor/plating/snowed/safe,
/area/tournament)
"Fm" = (
/obj/structure/railing,
/turf/open/floor/plating/snowed/safe,
/area/tournament)
"Fn" = (
/turf/open/floor/grass/snow/safe,
/area/tournament)
"Hl" = (
/obj/structure/rack,
/obj/item/gun/energy/lasercannon{
	pixel_y = 3
	},
/obj/item/gun/energy/laser/hellgun{
	pixel_y = -5
	},
/turf/open/floor/plasteel/dark,
/area/tournament)
"Hs" = (
/obj/structure/railing{
	dir = 8
	},
/turf/open/floor/grass/snow/safe,
/area/tournament)
"Iy" = (
/obj/structure/rack,
/obj/item/storage/belt/shotgun/bullet{
	pixel_x = 10;
	pixel_y = 2
	},
/obj/item/storage/belt/shotgun/buckshot{
	pixel_x = -7;
	pixel_y = -5
	},
/obj/item/storage/belt/shotgun/buckshot{
	pixel_x = 10;
	pixel_y = -5
	},
/obj/item/storage/belt/shotgun/bullet{
	pixel_x = -7;
	pixel_y = 2
	},
/turf/open/floor/plasteel/dark,
/area/tournament)
"IZ" = (
/obj/structure/deployable_barricade/snow{
	dir = 4
	},
/turf/open/floor/plating/snowed/smoothed/safe,
/area/tournament)
"Lu" = (
/obj/structure/flora/grass/both,
/turf/open/floor/grass/snow/safe,
/area/tournament)
"LQ" = (
/obj/structure/flora/bush,
/turf/open/floor/grass/snow/safe,
/area/tournament)
"LT" = (
/obj/machinery/door/poddoor{
	id = "arena_default";
	name = "FUCK THIS DOOR FUCK YOU LET ME IN FUCK FUCK"
	},
/obj/machinery/door/airlock/public/glass{
	max_integrity = 3000;
	normal_integrity = 3000
	},
/turf/open/floor/plasteel/dark,
/area/tournament)
"NL" = (
/obj/structure/statue/snow/snowman,
/obj/item/clothing/head/bowler{
	pixel_y = 14
	},
/turf/open/floor/grass/snow/safe,
/area/tournament)
"NV" = (
/obj/structure/deployable_barricade/snow{
	dir = 8
	},
/obj/structure/railing/corner{
	dir = 1
	},
/turf/open/floor/plating/snowed/safe,
/area/tournament)
"OF" = (
/turf/open/floor/plating/snowed/smoothed/safe,
/area/tournament)
"PN" = (
/obj/structure/deployable_barricade/snow{
	dir = 8
	},
/turf/open/floor/grass/snow/safe,
/area/tournament)
"Qc" = (
/obj/effect/baseturf_helper/dune,
/turf/closed/wall/ice,
/area/tournament)
"QT" = (
/obj/structure/rack,
/obj/item/clothing/suit/armor/vest{
	pixel_x = -3
	},
/obj/item/clothing/suit/armor/vest{
	pixel_x = 5
	},
/turf/open/floor/plasteel/dark,
/area/tournament)
"Tn" = (
/turf/closed/wall/ice,
/area/tournament)
"Wa" = (
/obj/structure/statue/snow/snowlegion,
/turf/open/floor/grass/snow/safe,
/area/tournament)
"Xi" = (
/obj/structure/railing/corner{
	dir = 8
	},
/turf/open/floor/grass/snow/safe,
/area/tournament)
"Xm" = (
/obj/structure/railing{
	dir = 4
	},
/obj/structure/flora/grass/both,
/turf/open/floor/grass/snow/safe,
/area/tournament)
"YS" = (
/obj/structure/railing{
	dir = 1
	},
/turf/open/floor/plating/snowed/safe,
/area/tournament)

(1,1,1) = {"
Qc
Tn
Tn
Tn
Tn
Tn
Tn
Tn
Tn
Tn
Tn
Tn
"}
(2,1,1) = {"
Tn
tY
yJ
az
yJ
QT
nP
yJ
az
yJ
wX
Tn
"}
(3,1,1) = {"
Tn
fw
yJ
yJ
yJ
yJ
yJ
yJ
yJ
yJ
Hl
Tn
"}
(4,1,1) = {"
Tn
yJ
yJ
Tn
Tn
vm
vm
Tn
Tn
yJ
yJ
Tn
"}
(5,1,1) = {"
Tn
yJ
yJ
LT
nr
nr
nr
nr
ay
yJ
yJ
Tn
"}
(6,1,1) = {"
Tn
Iy
yJ
ay
nr
nr
nr
nr
LT
yJ
jD
Tn
"}
(7,1,1) = {"
Tn
Be
Be
Tn
nr
nr
nr
OF
Tn
Be
Be
Tn
"}
(8,1,1) = {"
bU
Fn
Fn
LQ
Fn
OF
nr
Fn
Fn
OF
Fn
bU
"}
(9,1,1) = {"
bU
Fn
mC
Fn
IZ
hF
hF
gK
Fn
mC
Lu
bU
"}
(10,1,1) = {"
bU
Lu
Fn
Fn
Fn
Fn
NL
Fn
Fn
Fn
Fn
bU
"}
(11,1,1) = {"
bU
pA
Tn
Bs
gA
Xm
pA
lq
fi
Tn
pA
bU
"}
(12,1,1) = {"
bU
cQ
cQ
YS
Fm
cQ
cQ
YS
Fm
cQ
cQ
bU
"}
(13,1,1) = {"
bU
cQ
cQ
YS
Fm
cQ
cQ
YS
Fm
cQ
cQ
bU
"}
(14,1,1) = {"
bU
cQ
cQ
YS
Fm
cQ
cQ
YS
Fm
cQ
cQ
bU
"}
(15,1,1) = {"
bU
Hs
Tn
NV
Xi
Hs
Hs
gS
Ac
Tn
Hs
bU
"}
(16,1,1) = {"
bU
Lu
Fn
Fn
Fn
Wa
Lu
Fn
Fn
Fn
Fn
bU
"}
(17,1,1) = {"
bU
Fn
mC
Fn
PN
hF
hF
hw
Fn
mC
Fn
bU
"}
(18,1,1) = {"
bU
Fn
OF
Fn
Fn
nr
OF
Fn
ti
Fn
Lu
bU
"}
(19,1,1) = {"
Tn
Be
Be
Tn
OF
nr
nr
nr
Tn
Be
Be
Tn
"}
(20,1,1) = {"
Tn
Iy
yJ
ay
nr
nr
nr
nr
LT
yJ
jD
Tn
"}
(21,1,1) = {"
Tn
yJ
yJ
LT
nr
nr
nr
nr
ay
yJ
yJ
Tn
"}
(22,1,1) = {"
Tn
yJ
yJ
Tn
Tn
vm
ct
Tn
Tn
yJ
yJ
Tn
"}
(23,1,1) = {"
Tn
fw
yJ
yJ
yJ
yJ
yJ
yJ
yJ
yJ
Hl
Tn
"}
(24,1,1) = {"
Tn
tY
yJ
ep
yJ
QT
nP
yJ
ep
yJ
wX
Tn
"}
(25,1,1) = {"
Tn
Tn
Tn
Tn
Tn
Tn
Tn
Tn
Tn
Tn
Tn
Tn
"}
