//MAP CONVERTED BY dmm2tgm.py THIS HEADER COMMENT PREVENTS RECONVERSION, DO NOT REMOVE
"a" = (
/turf/open/space/basic,
/area/space)
"b" = (
/turf/open/floor/plasteel/stairs{
	dir = 4
	},
/area/space)
"d" = (
/turf/open/floor/plasteel/stairs{
	dir = 8
	},
/area/space)
"f" = (
/turf/closed/indestructible/cult,
/area/space)
"g" = (
/turf/open/indestructible/labfloor,
/area/space)
"j" = (
/obj/structure/closet/crate/trashcart/filled{
	anchorable = 0;
	anchored = 1
	},
/obj/structure/trash_pile,
/obj/structure/trash_pile,
/turf/open/floor/trot,
/area/space)
"k" = (
/obj/structure/trash_pile,
/turf/open/floor/grass,
/area/space)
"n" = (
/turf/open/floor/plasteel/stairs,
/area/space)
"p" = (
/turf/open/floor/asphalt,
/area/space)
"r" = (
/turf/closed/indestructible/riveted,
/area/space)
"x" = (
/obj/effect/mob_spawn/human/corpse/assistant/brainrot_infection,
/turf/open/indestructible/labfloor,
/area/space)
"A" = (
/turf/open/genturf,
/area/space)
"B" = (
/turf/closed/indestructible/iron,
/area/space)
"C" = (
/obj/structure/rack,
/obj/item/newspaper{
	pixel_x = 2;
	pixel_y = 2
	},
/obj/item/newspaper,
/obj/item/newspaper{
	pixel_x = -2;
	pixel_y = -2
	},
/turf/open/indestructible/labfloor,
/area/space)
"E" = (
/obj/structure/trash_pile,
/turf/open/floor/trot,
/area/space)
"G" = (
/turf/open/floor/trot,
/area/space)
"H" = (
/obj/structure/trash_pile,
/obj/structure/trash_pile,
/obj/structure/trash_pile,
/turf/open/floor/trot,
/area/space)
"I" = (
/turf/closed/indestructible/fakeglass,
/area/space)
"K" = (
/obj/structure/trash_pile,
/obj/structure/trash_pile,
/turf/open/floor/grass,
/area/space)
"P" = (
/obj/structure/closet/crate/trashcart/filled{
	anchorable = 0;
	anchored = 1
	},
/turf/open/floor/trot,
/area/space)
"R" = (
/turf/open/floor/grass,
/area/space)
"S" = (
/turf/open/floor/plasteel/stairs{
	dir = 1
	},
/area/space)
"U" = (
/turf/closed/indestructible/fakedoor,
/area/space)
"V" = (
/obj/structure/trash_pile,
/obj/structure/trash_pile,
/obj/structure/trash_pile,
/obj/structure/trash_pile,
/turf/open/floor/trot,
/area/space)

(1,1,1) = {"
a
a
a
a
a
a
a
a
a
a
a
a
a
a
a
a
a
a
a
a
"}
(2,1,1) = {"
a
B
B
B
B
B
B
B
B
B
B
B
B
B
B
B
B
B
B
a
"}
(3,1,1) = {"
a
B
A
R
R
R
b
R
R
R
b
R
R
R
b
R
R
A
B
a
"}
(4,1,1) = {"
a
B
R
R
R
R
R
R
R
R
R
R
R
R
R
R
R
A
B
a
"}
(5,1,1) = {"
a
B
k
R
G
G
G
G
G
G
G
G
G
G
G
G
R
R
B
a
"}
(6,1,1) = {"
a
B
K
k
G
G
G
G
G
G
G
G
G
G
G
G
R
S
B
a
"}
(7,1,1) = {"
a
B
k
R
G
G
R
R
R
R
R
R
R
R
G
G
R
R
B
a
"}
(8,1,1) = {"
a
B
R
R
G
G
R
R
R
R
R
R
R
R
G
G
R
R
B
a
"}
(9,1,1) = {"
a
B
k
R
G
G
R
R
R
A
A
R
R
R
G
G
R
R
B
a
"}
(10,1,1) = {"
a
B
K
k
G
G
R
R
R
A
A
R
R
R
G
G
R
S
B
a
"}
(11,1,1) = {"
a
B
k
R
G
G
R
R
R
R
R
R
R
R
G
G
R
R
B
a
"}
(12,1,1) = {"
a
B
R
R
G
G
R
R
R
R
R
R
R
R
G
G
R
R
B
a
"}
(13,1,1) = {"
a
B
n
R
G
G
G
G
G
G
G
G
G
G
G
G
R
R
B
a
"}
(14,1,1) = {"
a
B
A
R
G
G
G
G
G
G
G
G
G
G
G
G
R
S
B
a
"}
(15,1,1) = {"
a
B
R
R
R
R
d
R
R
G
G
R
R
d
R
R
A
A
B
a
"}
(16,1,1) = {"
a
B
B
B
B
B
B
B
B
G
A
B
B
B
B
B
B
B
B
a
"}
(17,1,1) = {"
a
a
a
a
a
a
a
a
B
G
G
B
a
a
a
a
a
a
a
a
"}
(18,1,1) = {"
a
a
a
a
a
a
a
a
B
A
G
B
a
a
a
a
a
a
a
a
"}
(19,1,1) = {"
a
a
a
a
a
a
a
a
B
G
G
B
a
a
a
a
a
a
a
a
"}
(20,1,1) = {"
a
a
a
a
a
a
a
a
B
G
A
B
a
a
a
a
a
a
a
a
"}
(21,1,1) = {"
B
B
B
B
B
B
B
B
B
G
G
B
B
B
B
B
B
B
B
B
"}
(22,1,1) = {"
f
G
G
G
G
G
G
G
G
G
G
G
G
G
G
G
G
G
G
f
"}
(23,1,1) = {"
f
G
G
G
G
G
G
G
G
G
G
G
G
G
G
G
G
G
G
f
"}
(24,1,1) = {"
f
G
G
r
r
U
r
r
G
G
G
G
G
R
R
R
R
G
G
f
"}
(25,1,1) = {"
f
G
G
r
g
x
C
r
G
G
G
G
G
R
R
R
R
G
G
f
"}
(26,1,1) = {"
f
G
G
r
r
I
r
r
G
G
G
G
G
R
R
R
R
G
G
f
"}
(27,1,1) = {"
f
G
G
G
G
G
G
G
G
G
G
G
G
G
G
G
G
G
G
f
"}
(28,1,1) = {"
f
p
p
p
p
p
p
p
p
p
p
p
p
p
p
p
p
p
p
f
"}
(29,1,1) = {"
f
p
p
p
p
p
p
p
p
p
p
p
p
p
p
p
p
p
p
f
"}
(30,1,1) = {"
f
p
p
p
p
p
p
p
p
p
p
p
p
p
p
p
p
p
p
f
"}
(31,1,1) = {"
f
p
p
p
p
p
p
p
p
p
p
p
p
p
p
p
p
p
p
f
"}
(32,1,1) = {"
f
p
p
p
p
p
p
p
p
p
p
p
p
p
p
p
p
p
p
f
"}
(33,1,1) = {"
f
p
p
p
p
p
p
p
p
p
p
p
p
p
p
p
p
p
p
f
"}
(34,1,1) = {"
f
G
G
G
G
G
G
G
G
G
G
G
G
G
G
G
E
E
G
f
"}
(35,1,1) = {"
f
G
G
R
R
R
R
G
G
G
G
G
G
P
E
j
j
j
E
f
"}
(36,1,1) = {"
f
G
G
R
R
R
R
G
G
G
G
G
G
G
G
H
H
V
E
f
"}
(37,1,1) = {"
f
G
G
R
R
R
R
G
G
G
G
G
G
G
P
G
j
P
E
f
"}
(38,1,1) = {"
f
G
G
G
G
G
G
G
G
G
G
G
G
G
G
G
G
E
G
f
"}
(39,1,1) = {"
f
G
G
G
G
G
G
G
G
G
G
G
G
G
G
G
G
G
G
f
"}
(40,1,1) = {"
B
B
B
B
B
B
B
B
B
G
G
B
B
B
B
B
B
B
B
B
"}
(41,1,1) = {"
a
a
a
a
a
a
a
a
B
G
A
B
a
a
a
a
a
a
a
a
"}
(42,1,1) = {"
a
a
a
a
a
a
a
a
B
G
G
B
a
a
a
a
a
a
a
a
"}
(43,1,1) = {"
a
a
a
a
a
a
a
a
B
A
G
B
a
a
a
a
a
a
a
a
"}
(44,1,1) = {"
a
a
a
a
a
a
a
a
B
G
G
B
a
a
a
a
a
a
a
a
"}
(45,1,1) = {"
a
B
B
B
B
B
B
B
B
G
A
B
B
B
B
B
B
B
B
a
"}
(46,1,1) = {"
a
B
R
R
R
R
d
R
R
G
G
R
R
d
R
R
A
A
B
a
"}
(47,1,1) = {"
a
B
R
R
G
G
G
G
G
G
G
G
G
G
G
G
R
S
B
a
"}
(48,1,1) = {"
a
B
n
R
G
G
G
G
G
G
G
G
G
G
G
G
R
R
B
a
"}
(49,1,1) = {"
a
B
R
R
G
G
R
R
R
R
R
R
R
R
G
G
R
R
B
a
"}
(50,1,1) = {"
a
B
R
R
G
G
R
R
R
R
R
R
R
R
G
G
R
R
B
a
"}
(51,1,1) = {"
a
B
n
R
G
G
R
R
R
A
A
R
R
R
G
G
R
S
B
a
"}
(52,1,1) = {"
a
B
R
R
G
G
R
R
R
A
A
R
R
R
G
G
R
R
B
a
"}
(53,1,1) = {"
a
B
R
R
G
G
R
R
R
R
R
R
R
R
G
G
R
R
B
a
"}
(54,1,1) = {"
a
B
R
R
G
G
R
R
R
R
R
R
R
R
G
G
R
R
B
a
"}
(55,1,1) = {"
a
B
n
R
G
G
G
G
G
G
G
G
G
G
G
G
R
S
B
a
"}
(56,1,1) = {"
a
B
R
R
G
G
G
G
G
G
G
G
G
G
G
G
R
R
B
a
"}
(57,1,1) = {"
a
B
R
R
R
R
R
R
R
R
R
R
R
R
R
R
R
A
B
a
"}
(58,1,1) = {"
a
B
A
R
R
R
b
R
R
R
b
R
R
R
b
R
R
A
B
a
"}
(59,1,1) = {"
a
B
B
B
B
B
B
B
B
B
B
B
B
B
B
B
B
B
B
a
"}
(60,1,1) = {"
a
a
a
a
a
a
a
a
a
a
a
a
a
a
a
a
a
a
a
a
"}
