"a" = (/obj/effect/turf_decal/stripes/line{dir = 10},/obj/effect/landmark/stationroom/maintenance,/turf/open/space/openspace,/area/space)
"m" = (/obj/effect/turf_decal/stripes/line{dir = 9},/turf/open/space/openspace,/area/space)
"n" = (/turf/open/space/openspace,/area/space)
"J" = (/obj/effect/turf_decal/stripes/line{dir = 6},/turf/open/space/openspace,/area/space)
"T" = (/obj/effect/turf_decal/stripes/line{dir = 5},/turf/open/space/openspace,/area/space)

(1,1,1) = {"
mnT
nnn
nnn
nnn
anJ
"}
