"a" = (/obj/effect/turf_decal/stripes/line{dir = 10},/obj/effect/landmark/stationroom/maintenance,/turf/open/space/openspace,/area/space)
"n" = (/obj/effect/turf_decal/stripes/line{dir = 9},/turf/open/space/openspace,/area/space)
"v" = (/turf/open/space/openspace,/area/space)
"Y" = (/obj/effect/turf_decal/stripes/line{dir = 6},/turf/open/space/openspace,/area/space)
"Z" = (/obj/effect/turf_decal/stripes/line{dir = 5},/turf/open/space/openspace,/area/space)

(1,1,1) = {"
nvZ
vvv
avY
"}
